ID,arrival_time,length,cpus,length_class,resource_class,carbon_cost,dollar_cost,start_time,waiting_time,exit_time,reason
0,0,3600,1,0-2,1,0.09614000000000002,0.0624,0,0,3600,completed
1,68,1000,1,0-2,1,0.02670555555555556,0.017333333333333333,68,0,1068,completed
2,463,1570,3,0-2,3-4,0.12578316666666664,0.08163999999999999,463,0,2033,completed
3,838,1949,1,0-2,1,0.05204912777777779,0.03378266666666666,838,0,2787,completed
4,1986,666,1,0-2,1,0.0177859,0.011543999999999999,1986,0,2652,completed
6,2619,628,2,0-2,2,0.03354217777777777,0.021770666666666664,2619,0,3247,completed
5,2619,628,2,0-2,2,0.03354217777777777,0.021770666666666664,2619,0,3247,completed
7,2939,43861,1,12-24,1,1.0546523722222223,0.7602573333333333,2939,0,46800,completed
8,3009,13245,1,2-6,1,0.3782738333333333,0.22957999999999998,3009,0,16254,completed
9,4052,2063,3,0-2,3-4,0.17042099166666663,0.107276,4052,0,6115,completed
12,6422,5520,1,0-2,1,0.15650187777777774,0.09567999999999999,6422,0,11942,completed
25,15673,45527,2,12-24,2,2.759735294444445,1.5782693333333333,15673,0,61200,completed
8,3009,28800,1,6-12,1,0.62,0.4992,18000,14991,46800,completed
36,23562,23238,1,6-12,1,0.45389605,0.402792,23562,0,46800,completed
0,0,2702,1,0-2,1,0.05217862222222222,0.04683466666666666,25200,25200,27902,completed
3,838,21600,1,6-12,1,0.40689000000000003,0.37439999999999996,25200,24362,46800,completed
9,4052,21600,3,6-12,3-4,1.22067,1.1232,25200,21148,46800,completed
10,4791,1750,2,0-2,2,0.06758888888888888,0.06066666666666666,25200,20409,26950,completed
11,5796,1404,1,0-2,1,0.0271128,0.024336,25200,19404,26604,completed
12,6422,21600,1,6-12,1,0.40689000000000003,0.37439999999999996,25200,18778,46800,completed
21,12778,2541,1,0-2,1,0.04906953333333333,0.044044,25200,12422,27741,completed
41,27704,19096,1,6-12,1,0.3585349777777778,0.3309973333333333,27704,0,46800,completed
11,5796,1421,1,0-2,1,0.02213996944444445,0.024630666666666665,28800,23004,30221,completed
13,6947,12173,2,2-6,2,0.41606519444444445,0.4219973333333333,28800,21853,40973,completed
14,7578,2040,1,0-2,1,0.031784333333333345,0.035359999999999996,28800,21222,30840,completed
16,8628,1112,1,0-2,1,0.01732557777777778,0.019274666666666666,28800,20172,29912,completed
15,8628,1112,1,0-2,1,0.01732557777777778,0.019274666666666666,28800,20172,29912,completed
17,9988,8335,1,2-6,1,0.13811970833333334,0.14447333333333331,28800,18812,37135,completed
18,10481,418,1,0-2,1,0.006512672222222224,0.007245333333333333,28800,18319,29218,completed
19,11269,2474,1,0-2,1,0.03854629444444446,0.042882666666666666,28800,17531,31274,completed
20,11498,562,1,0-2,1,0.008756272222222226,0.009741333333333333,28800,17302,29362,completed
21,12778,14400,1,2-6,1,0.24883000000000002,0.2496,28800,16022,43200,completed
22,13300,489,1,0-2,1,0.007618891666666669,0.008476,28800,15500,29289,completed
23,14435,916,4,0-2,3-4,0.057087155555555574,0.06350933333333333,28800,14365,29716,completed
24,15275,327,1,0-2,1,0.005094841666666669,0.005667999999999999,28800,13525,29127,completed
26,15892,374,1,0-2,1,0.005827127777777779,0.006482666666666666,28800,12908,29174,completed
27,15895,342,1,0-2,1,0.005328550000000001,0.005927999999999999,28800,12905,29142,completed
28,16421,12364,1,2-6,1,0.21153161111111113,0.21430933333333332,28800,12379,41164,completed
29,16456,476,2,0-2,2,0.014832688888888893,0.016501333333333333,28800,12344,29276,completed
30,16747,3522,1,0-2,1,0.054874716666666684,0.061048,28800,12053,32322,completed
31,17435,1425,3,0-2,3-4,0.06660687500000001,0.0741,28800,11365,30225,completed
32,17525,11077,1,2-6,1,0.18795448611111112,0.19200133333333333,28800,11275,39877,completed
33,21343,306,1,0-2,1,0.004767650000000002,0.005304,28800,7457,29106,completed
34,22329,3545,1,0-2,1,0.05523306944444446,0.06144666666666666,28800,6471,32345,completed
35,22719,12740,1,2-6,1,0.21841972222222222,0.22082666666666664,28800,6081,41540,completed
37,24505,2356,2,0-2,2,0.0734155777777778,0.08167466666666666,28800,4295,31156,completed
38,26860,591,2,0-2,2,0.018416216666666672,0.020488,28800,1940,29391,completed
39,26860,591,2,0-2,2,0.018416216666666672,0.020488,28800,1940,29391,completed
40,26878,337,4,0-2,3-4,0.021002588888888896,0.02336533333333333,28800,1922,29137,completed
42,31213,2135,1,0-2,1,0.03466805277777778,0.03700666666666667,31213,0,33348,completed
43,33121,1602,2,0-2,2,0.0546638,0.055535999999999995,33121,0,34723,completed
44,33231,3539,1,0-2,1,0.06122413333333333,0.06134266666666666,33231,0,36770,completed
45,33334,11933,1,2-6,1,0.2276416388888889,0.20683866666666664,33334,0,45267,completed
46,33381,13419,1,2-6,1,0.26454305000000006,0.232596,33381,0,46800,completed
47,33499,338,2,0-2,2,0.01153331111111111,0.011717333333333333,33499,0,33837,completed
48,34097,12703,1,2-6,1,0.25232729444444446,0.22018533333333332,34097,0,46800,completed
49,34607,386,1,0-2,1,0.006585588888888888,0.006690666666666666,34607,0,34993,completed
50,37374,20226,4,6-12,3-4,2.5804018,1.4023359999999998,37374,0,57600,completed
51,37439,1484,1,0-2,1,0.026946966666666676,0.025722666666666665,37439,0,38923,completed
52,38457,443,3,0-2,3-4,0.024132425000000006,0.023035999999999997,38457,0,38900,completed
53,39395,7405,1,2-6,1,0.15821245833333336,0.12835333333333332,39395,0,46800,completed
54,39956,386,1,0-2,1,0.007071305555555557,0.006690666666666666,39956,0,40342,completed
55,40299,13701,1,2-6,1,0.4174647083333333,0.23748399999999997,40299,0,54000,completed
56,40576,13051,1,2-6,1,0.3968796388888889,0.22621733333333333,40576,0,53627,completed
57,40698,6102,1,0-2,1,0.13437525,0.10576799999999999,40698,0,46800,completed
58,40788,9612,1,2-6,1,0.2588065,0.16660799999999998,40788,0,50400,completed
59,40853,345,1,0-2,1,0.006320208333333335,0.005979999999999999,40853,0,41198,completed
60,41076,1274,1,0-2,1,0.023338972222222226,0.022082666666666664,41076,0,42350,completed
61,41149,5651,1,0-2,1,0.12611318055555557,0.09795066666666666,41149,0,46800,completed
62,41385,12615,1,2-6,1,0.39756979166666667,0.21866,41385,0,54000,completed
63,41524,12476,1,2-6,1,0.3950233888888889,0.21625066666666665,41524,0,54000,completed
64,43402,6956,1,0-2,1,0.20818098888888892,0.12057066666666666,43402,0,50358,completed
65,43955,2845,1,0-2,1,0.06997119444444444,0.04931333333333333,43955,0,46800,completed
66,45189,8811,1,2-6,1,0.31540165000000003,0.152724,45189,0,54000,completed
67,45246,3931,1,0-2,1,0.1214675888888889,0.06813733333333333,45246,0,49177,completed
68,46122,11478,1,2-6,1,0.4668650333333334,0.198952,46122,0,57600,completed
69,46438,1642,1,0-2,1,0.05373163333333335,0.02846133333333333,46438,0,48080,completed
70,46587,11013,1,2-6,1,0.4554286166666668,0.19089199999999998,46587,0,57600,completed
71,46670,10930,1,2-6,1,0.4533872777777779,0.18945333333333333,46670,0,57600,completed
72,46833,3781,1,0-2,1,0.1338231,0.06553733333333332,46833,0,50614,completed
73,47307,6693,1,0-2,1,0.2580237333333334,0.11601199999999999,47307,0,54000,completed
74,47430,658,1,0-2,1,0.023044622222222227,0.011405333333333333,47430,0,48088,completed
75,47446,6681,1,0-2,1,0.2593084416666668,0.11580399999999999,47446,0,54127,completed
76,47919,427,1,0-2,1,0.014954488888888893,0.007401333333333333,47919,0,48346,completed
77,47927,345,1,0-2,1,0.01208266666666667,0.005979999999999999,47927,0,48272,completed
78,48071,589,1,0-2,1,0.020628088888888896,0.010209333333333332,48071,0,48660,completed
79,48327,3338,1,0-2,1,0.12520398333333338,0.05785866666666666,48327,0,51665,completed
80,48353,5848,3,0-2,3-4,0.6933851416666668,0.304096,48353,0,54201,completed
81,48968,5032,1,0-2,1,0.19985182222222225,0.08722133333333333,48968,0,54000,completed
82,49204,4796,1,0-2,1,0.19158657777777777,0.08313066666666666,49204,0,54000,completed
83,50938,6662,1,0-2,1,0.30173816666666675,0.11547466666666666,50938,0,57600,completed
85,51939,5661,2,0-2,2,0.5202265000000001,0.19624799999999998,51939,0,57600,completed
86,51982,5618,1,0-2,1,0.2583251666666667,0.09737866666666666,51982,0,57600,completed
87,52289,5311,1,0-2,1,0.24555908333333337,0.09205733333333332,52289,0,57600,completed
88,52387,8813,1,2-6,1,0.4785139166666667,0.15275866666666665,52387,0,61200,completed
89,55519,1512,1,0-2,1,0.07325220000000002,0.026208,55519,0,57031,completed
90,56068,875,1,0-2,1,0.04239131944444445,0.015166666666666665,56068,0,56943,completed
91,57022,397,1,0-2,1,0.019233547222222227,0.006881333333333333,57022,0,57419,completed
92,57178,422,1,0-2,1,0.020444727777777782,0.007314666666666666,57178,0,57600,completed
25,15673,14400,2,2-6,2,1.71986,0.4992,64800,49127,79200,completed
88,52387,14400,1,2-6,1,0.85993,0.2496,64800,12413,79200,completed
86,51982,1306,1,0-2,1,0.08146175000000003,0.022637333333333332,68400,16418,69706,completed
50,37374,4615,4,0-2,3-4,0.9754595555555556,0.31997333333333333,72000,34626,76615,completed
68,46122,3600,1,0-2,1,0.18706999999999996,0.0624,72000,25878,75600,completed
70,46587,4566,1,0-2,1,0.24112306666666666,0.07914399999999999,72000,25413,76566,completed
71,46670,6948,1,0-2,1,0.3744092,0.120432,72000,25330,78948,completed
83,50938,3600,1,0-2,1,0.18706999999999996,0.0624,72000,21062,75600,completed
85,51939,931,2,0-2,2,0.09675676111111109,0.03227466666666667,72000,20061,72931,completed
86,51982,7200,1,0-2,1,0.38850999999999997,0.1248,72000,20018,79200,completed
87,52289,1281,1,0-2,1,0.06656574166666668,0.022203999999999998,72000,19711,73281,completed
92,57178,1907,1,0-2,1,0.09909513611111109,0.03305466666666666,72000,14822,73907,completed
93,59105,458,1,0-2,1,0.023799461111111107,0.007938666666666667,72000,12895,72458,completed
94,59278,341,1,0-2,1,0.017719686111111112,0.0059106666666666665,72000,12722,72341,completed
95,59302,6895,3,0-2,3-4,1.1143306666666668,0.35853999999999997,72000,12698,78895,completed
96,59761,1386,1,0-2,1,0.07202195,0.024024,72000,12239,73386,completed
97,59895,314,1,0-2,1,0.016316661111111113,0.005442666666666666,72000,12105,72314,completed
99,62387,1100,1,0-2,1,0.057160277777777775,0.019066666666666666,72000,9613,73100,completed
104,63321,105,1,0-2,1,0.005456208333333333,0.0018199999999999998,72000,8679,72105,completed
110,64777,6944,3,0-2,3-4,1.1225561333333336,0.36108799999999996,72000,7223,78944,completed
111,66212,949,1,0-2,1,0.049313730555555546,0.016449333333333333,72000,5788,72949,completed
112,67986,6830,3,0-2,3-4,1.1034193333333335,0.35516,72000,4014,78830,completed
114,69118,306,1,0-2,1,0.015900950000000004,0.005304,72000,2882,72306,completed
116,71361,2357,2,0-2,2,0.2449577722222222,0.08170933333333333,72000,639,74357,completed
117,71815,4851,1,0-2,1,0.25707040000000003,0.08408399999999999,72000,185,76851,completed
118,71852,337,1,0-2,1,0.01751183055555556,0.005841333333333333,72000,148,72337,completed
119,72628,483,1,0-2,1,0.02509855833333333,0.008372,72628,0,73111,completed
121,74115,407,3,0-2,3-4,0.06344790833333336,0.021164,74115,0,74522,completed
123,75085,493,1,0-2,1,0.02561819722222222,0.008545333333333334,75085,0,75578,completed
124,75341,3859,1,0-2,1,0.21489864722222224,0.06688933333333333,75341,0,79200,completed
126,76317,625,1,0-2,1,0.034972222222222224,0.010833333333333332,76317,0,76942,completed
127,76692,527,1,0-2,1,0.029488577777777775,0.009134666666666666,76692,0,77219,completed
132,78832,336,1,0-2,1,0.018801066666666665,0.005823999999999999,78832,0,79168,completed
25,15673,3600,2,0-2,2,0.5067,0.1248,82800,67127,86400,completed
88,52387,3600,1,0-2,1,0.25335,0.0624,82800,30413,86400,completed
124,75341,2791,1,0-2,1,0.196416625,0.04837733333333333,82800,7459,85591,completed
133,79367,3433,1,0-2,1,0.241597375,0.05950533333333333,82800,3433,86233,completed
134,80504,4420,1,0-2,1,0.31287972222222227,0.07661333333333332,82800,2296,87220,completed
136,81654,521,1,0-2,1,0.036665375,0.009030666666666666,82800,1146,83321,completed
137,81860,2075,1,0-2,1,0.14602812499999998,0.03596666666666667,82800,940,84875,completed
138,83339,1461,1,0-2,1,0.10281787500000002,0.025324,83339,0,84800,completed
139,84591,458,1,0-2,1,0.032231749999999997,0.007938666666666667,84591,0,85049,completed
140,84596,1804,1,0-2,1,0.1269565,0.03126933333333333,84596,0,86400,completed
142,84816,303,1,0-2,1,0.021323625000000002,0.005252,84816,0,85119,completed
140,84596,1302,1,0-2,1,0.09338595000000002,0.022567999999999998,108000,23404,109302,completed
143,86690,3310,1,0-2,1,0.23740975000000003,0.05737333333333333,108000,21310,111310,completed
144,86691,3309,1,0-2,1,0.23733802500000006,0.057356,108000,21309,111309,completed
145,86692,3308,1,0-2,1,0.23726630000000004,0.05733866666666666,108000,21308,111308,completed
147,88414,1586,3,0-2,3-4,0.3412675500000001,0.08247199999999999,108000,19586,109586,completed
148,88519,1481,1,0-2,1,0.10622472500000002,0.025670666666666665,108000,19481,109481,completed
151,89441,346,1,0-2,1,0.024816850000000005,0.005997333333333333,108000,18559,108346,completed
152,89651,314,1,0-2,1,0.022521650000000004,0.005442666666666666,108000,18349,108314,completed
25,15673,32400,2,12-24,2,2.4123200000000002,1.1232,111600,95927,144000,completed
50,37374,32400,4,12-24,3-4,4.8246400000000005,2.2464,111600,74226,144000,completed
68,46122,2922,1,0-2,1,0.15619713333333335,0.050648,111600,65478,114522,completed
70,46587,32400,1,12-24,1,1.2061600000000001,0.5616,111600,65013,144000,completed
71,46670,32400,1,12-24,1,1.2061600000000001,0.5616,111600,64930,144000,completed
83,50938,2528,1,0-2,1,0.13513564444444445,0.043818666666666665,111600,60662,114128,completed
86,51982,32400,1,12-24,1,1.2061600000000001,0.5616,111600,59618,144000,completed
88,52387,32400,1,12-24,1,1.2061600000000001,0.5616,111600,59213,144000,completed
133,79367,32400,1,12-24,1,1.2061600000000001,0.5616,111600,32233,144000,completed
141,84649,1751,2,0-2,2,0.18720135555555556,0.06070133333333333,111600,26951,113351,completed
143,86690,2568,1,0-2,1,0.1372738666666667,0.044511999999999996,111600,24910,114168,completed
144,86691,2507,1,0-2,1,0.13401307777777777,0.04345466666666666,111600,24909,114107,completed
145,86692,2533,1,0-2,1,0.13540292222222222,0.04390533333333333,111600,24908,114133,completed
147,88414,2720,3,0-2,3-4,0.4361973333333333,0.14143999999999998,111600,23186,114320,completed
148,88519,411,1,0-2,1,0.021970233333333332,0.007123999999999999,111600,23081,112011,completed
155,90727,2873,1,0-2,1,0.15357781111111113,0.049798666666666665,111600,20873,114473,completed
154,90727,2873,1,0-2,1,0.15357781111111113,0.049798666666666665,111600,20873,114473,completed
153,90727,2873,1,0-2,1,0.15357781111111113,0.049798666666666665,111600,20873,114473,completed
156,90728,2872,1,0-2,1,0.15352435555555555,0.04978133333333333,111600,20872,114472,completed
158,90728,2872,1,0-2,1,0.15352435555555555,0.04978133333333333,111600,20872,114472,completed
159,90729,1794,1,0-2,1,0.09589926666666668,0.031096,111600,20871,113394,completed
164,91113,2487,1,0-2,1,0.13294396666666666,0.043108,111600,20487,114087,completed
167,91787,1813,1,0-2,1,0.09691492222222223,0.03142533333333333,111600,19813,113413,completed
168,92356,1244,2,0-2,2,0.13299742222222222,0.04312533333333333,111600,19244,112844,completed
169,92542,969,4,0-2,3-4,0.20719373333333335,0.067184,111600,19058,112569,completed
68,46122,28800,1,6-12,1,1.01372,0.4992,115200,69078,144000,completed
73,47307,1173,1,0-2,1,0.05198996666666668,0.020332,115200,67893,116373,completed
75,47446,28800,1,6-12,1,1.01372,0.4992,115200,67754,144000,completed
82,49204,1783,1,0-2,1,0.07902652222222226,0.03090533333333333,115200,65996,116983,completed
83,50938,28800,1,6-12,1,1.01372,0.4992,115200,64262,144000,completed
87,52289,28800,1,6-12,1,1.01372,0.4992,115200,62911,144000,completed
104,63321,28800,1,6-12,1,1.01372,0.4992,115200,51879,144000,completed
141,84649,28800,2,6-12,2,2.02744,0.9984,115200,30551,144000,completed
155,90727,3740,1,0-2,1,0.16488077777777782,0.06482666666666666,115200,24473,118940,completed
153,90727,3723,1,0-2,1,0.1642346833333334,0.06453199999999999,115200,24473,118923,completed
154,90727,3864,1,0-2,1,0.16959346666666672,0.066976,115200,24473,119064,completed
158,90728,2341,1,0-2,1,0.10375832222222225,0.04057733333333333,115200,24472,117541,completed
156,90728,1877,1,0-2,1,0.08319281111111114,0.03253466666666666,115200,24472,117077,completed
164,91113,420,1,0-2,1,0.018615333333333338,0.007279999999999999,115200,24087,115620,completed
167,91787,5320,1,0-2,1,0.2249295555555556,0.09221333333333333,115200,23413,120520,completed
168,92356,627,2,0-2,2,0.05558006666666668,0.021736,115200,22844,115827,completed
170,93264,3502,3,0-2,3-4,0.46564926666666684,0.182104,115200,21936,118702,completed
171,94444,788,4,0-2,3-4,0.1397036444444445,0.054634666666666665,115200,20756,115988,completed
172,94548,978,1,0-2,1,0.04334713333333335,0.016952,115200,20652,116178,completed
173,95099,1637,1,0-2,1,0.0725554777777778,0.028374666666666666,115200,20101,116837,completed
174,95316,358,1,0-2,1,0.01586735555555556,0.006205333333333333,115200,19884,115558,completed
175,95643,1557,4,0-2,3-4,0.2760388000000001,0.10795199999999999,115200,19557,116757,completed
176,95758,784,4,0-2,3-4,0.13899448888888893,0.05435733333333333,115200,19442,115984,completed
177,95766,324,1,0-2,1,0.014360400000000004,0.0056159999999999995,115200,19434,115524,completed
178,96563,637,2,0-2,2,0.05646651111111113,0.022082666666666664,115200,18637,115837,completed
185,100180,28800,1,6-12,1,1.01372,0.4992,115200,15020,144000,completed
192,104185,28800,1,6-12,1,1.01372,0.4992,115200,11015,144000,completed
193,105195,28800,2,6-12,2,2.02744,0.9984,115200,10005,144000,completed
55,40299,23054,1,6-12,1,0.7616912444444444,0.39960266666666666,118800,78501,141854,completed
56,40576,21600,1,6-12,1,0.69904,0.37439999999999996,118800,78224,140400,completed
58,40788,3291,1,0-2,1,0.12507628333333337,0.057044,118800,78012,122091,completed
62,41385,23108,1,6-12,1,0.7640180444444444,0.40053866666666665,118800,77415,141908,completed
63,41524,23956,1,6-12,1,0.8005574222222221,0.4152373333333333,118800,77276,142756,completed
66,45189,22433,1,6-12,1,0.7349330444444444,0.38883866666666667,118800,73611,141233,completed
73,47307,25200,1,6-12,1,0.8541599999999999,0.43679999999999997,118800,71493,144000,completed
79,48327,21600,1,6-12,1,0.69904,0.37439999999999996,118800,70473,140400,completed
81,48968,24036,1,6-12,1,0.8040045333333332,0.416624,118800,69832,142836,completed
82,49204,25200,1,6-12,1,0.8541599999999999,0.43679999999999997,118800,69596,144000,completed
100,62697,840,1,0-2,1,0.03192466666666667,0.014559999999999998,118800,56103,119640,completed
105,64259,23764,1,6-12,1,0.7922843555555554,0.4119093333333333,118800,54541,142564,completed
106,64259,23715,1,6-12,1,0.790173,0.41106,118800,54541,142515,completed
107,64262,23864,1,6-12,1,0.7965932444444443,0.41364266666666666,118800,54538,142664,completed
108,64285,24045,1,6-12,1,0.8043923333333333,0.41678,118800,54515,142845,completed
115,71226,3358,2,0-2,2,0.25524531111111115,0.11641066666666666,118800,47574,122158,completed
120,72728,24731,1,6-12,1,0.8339513111111111,0.42867066666666664,118800,46072,143531,completed
125,75640,638,2,0-2,2,0.048495088888888885,0.022117333333333333,118800,43160,119438,completed
131,78654,421,1,0-2,1,0.01600033888888889,0.007297333333333333,118800,40146,119221,completed
170,93264,25200,3,6-12,3-4,2.56248,1.3104,118800,25536,144000,completed
175,95643,2847,4,0-2,3-4,0.4328072666666667,0.19739199999999998,118800,23157,121647,completed
178,96563,513,2,0-2,2,0.038993700000000006,0.017783999999999998,118800,22237,119313,completed
179,97903,1276,4,0-2,3-4,0.19398035555555557,0.08846933333333333,118800,20897,120076,completed
180,98586,400,1,0-2,1,0.015202222222222225,0.006933333333333333,118800,20214,119200,completed
181,98684,880,1,0-2,1,0.0334448888888889,0.015253333333333332,118800,20116,119680,completed
182,99503,1297,1,0-2,1,0.04929320555555555,0.022481333333333332,118800,19297,120097,completed
183,99810,990,1,0-2,1,0.037625500000000006,0.017159999999999998,118800,18990,119790,completed
184,99980,516,1,0-2,1,0.01961086666666667,0.008943999999999999,118800,18820,119316,completed
186,100746,54,1,0-2,1,0.0020522999999999995,0.000936,118800,18054,118854,completed
58,40788,18000,1,6-12,1,0.5622199999999999,0.312,122400,81612,140400,completed
64,43402,18000,1,6-12,1,0.5622199999999999,0.312,122400,78998,140400,completed
67,45246,18000,1,6-12,1,0.5622199999999999,0.312,122400,77154,140400,completed
84,51740,372,1,0-2,1,0.012602533333333332,0.006448,122400,70660,122772,completed
100,62697,18000,1,6-12,1,0.5622199999999999,0.312,122400,59703,140400,completed
101,62697,1976,1,0-2,1,0.06694248888888887,0.034250666666666665,122400,59703,124376,completed
109,64385,1271,1,0-2,1,0.043058655555555554,0.022030666666666664,122400,58015,123671,completed
115,71226,18000,2,6-12,2,1.1244399999999999,0.624,122400,51174,140400,completed
125,75640,18000,2,6-12,2,1.1244399999999999,0.624,122400,46760,140400,completed
130,78621,2026,1,0-2,1,0.06863637777777776,0.035117333333333334,122400,43779,124426,completed
131,78654,18000,1,6-12,1,0.5622199999999999,0.312,122400,43746,140400,completed
182,99503,581,1,0-2,1,0.019682988888888888,0.010070666666666665,122400,22897,122981,completed
183,99810,953,1,0-2,1,0.03228552222222221,0.016518666666666664,122400,22590,123353,completed
186,100746,2146,1,0-2,1,0.0727017111111111,0.03719733333333333,122400,21654,124546,completed
187,100869,1307,1,0-2,1,0.04427825555555555,0.022654666666666667,122400,21531,123707,completed
188,102638,466,1,0-2,1,0.01578704444444444,0.008077333333333332,122400,19762,122866,completed
189,102692,1708,1,0-2,1,0.057863244444444434,0.02960533333333333,122400,19708,124108,completed
7,2939,11102,1,2-6,1,0.3297953222222222,0.19243466666666664,126000,123061,137102,completed
8,3009,10800,1,2-6,1,0.31967999999999996,0.18719999999999998,126000,122991,136800,completed
46,33381,1178,1,0-2,1,0.035670494444444444,0.020418666666666665,126000,92619,127178,completed
53,39395,14232,1,2-6,1,0.4346329333333333,0.246688,126000,86605,140232,completed
65,43955,364,1,0-2,1,0.011022122222222222,0.006309333333333333,126000,82045,126364,completed
84,51740,14400,1,2-6,1,0.44026,0.2496,126000,74260,140400,completed
98,60272,13308,1,2-6,1,0.4036840666666667,0.230672,126000,65728,139308,completed
101,62697,14400,1,2-6,1,0.44026,0.2496,126000,63303,140400,completed
103,62745,1450,1,0-2,1,0.04390680555555555,0.02513333333333333,126000,63255,127450,completed
102,62745,1450,1,0-2,1,0.04390680555555555,0.02513333333333333,126000,63255,127450,completed
109,64385,14400,1,2-6,1,0.44026,0.2496,126000,61615,140400,completed
113,68977,566,1,0-2,1,0.017138794444444445,0.009810666666666665,126000,57023,126566,completed
122,74152,2175,1,0-2,1,0.06586020833333335,0.0377,126000,51848,128175,completed
128,77811,1503,1,0-2,1,0.045511675,0.026052,126000,48189,127503,completed
129,77827,2435,1,0-2,1,0.07373315277777778,0.04220666666666666,126000,48173,128435,completed
130,78621,14400,1,2-6,1,0.44026,0.2496,126000,47379,140400,completed
135,81174,12475,1,2-6,1,0.3757831944444444,0.21623333333333333,126000,44826,138475,completed
146,88055,13405,1,2-6,1,0.40693302777777773,0.23235333333333333,126000,37945,139405,completed
149,88975,393,1,0-2,1,0.011900258333333334,0.0068119999999999995,126000,37025,126393,completed
150,89356,14065,1,2-6,1,0.4290393611111111,0.2437933333333333,126000,36644,140065,completed
157,90728,197,1,0-2,1,0.005965269444444445,0.0034146666666666665,126000,35272,126197,completed
161,90731,1015,1,0-2,1,0.030734763888888884,0.017593333333333332,126000,35269,127015,completed
160,90731,1234,1,0-2,1,0.03736620555555556,0.021389333333333333,126000,35269,127234,completed
162,90861,2112,1,0-2,1,0.06395253333333334,0.036607999999999995,126000,35139,128112,completed
163,90890,2772,1,0-2,1,0.0839377,0.048048,126000,35110,128772,completed
165,91366,4,1,0-2,1,0.00012112222222222223,6.933333333333333e-05,126000,34634,126004,completed
166,91546,1596,1,0-2,1,0.04832776666666666,0.027663999999999998,126000,34454,127596,completed
189,102692,2713,1,0-2,1,0.08215114722222222,0.04702533333333333,126000,23308,128713,completed
190,102715,458,1,0-2,1,0.013868494444444442,0.007938666666666667,126000,23285,126458,completed
191,102831,131,1,0-2,1,0.003966752777777778,0.0022706666666666665,126000,23169,126131,completed
194,107422,346,1,0-2,1,0.010477072222222224,0.005997333333333333,126000,18578,126346,completed
195,107817,183,1,0-2,1,0.005541341666666668,0.003172,126000,18183,126183,completed
196,107957,43,1,0-2,1,0.0013020638888888887,0.0007453333333333333,126000,18043,126043,completed
36,23562,6458,1,0-2,1,0.18883252777777776,0.11193866666666666,129600,106038,136058,completed
41,27704,1372,1,0-2,1,0.03990995555555555,0.02378133333333333,129600,101896,130972,completed
46,33381,7200,1,0-2,1,0.21067,0.1248,129600,96219,136800,completed
48,34097,6037,1,0-2,1,0.1764422638888889,0.10464133333333332,129600,95503,135637,completed
57,40698,6692,1,0-2,1,0.19571927777777776,0.11599466666666666,129600,88902,136292,completed
61,41149,5958,1,0-2,1,0.17411725,0.10327199999999999,129600,88451,135558,completed
65,43955,7200,1,0-2,1,0.21067,0.1248,129600,85645,136800,completed
102,62745,7200,1,0-2,1,0.21067,0.1248,129600,66855,136800,completed
103,62745,7200,1,0-2,1,0.21067,0.1248,129600,66855,136800,completed
113,68977,7200,1,0-2,1,0.21067,0.1248,129600,60623,136800,completed
122,74152,7200,1,0-2,1,0.21067,0.1248,129600,55448,136800,completed
128,77811,7200,1,0-2,1,0.21067,0.1248,129600,51789,136800,completed
129,77827,7200,1,0-2,1,0.21067,0.1248,129600,51773,136800,completed
149,88975,7200,1,0-2,1,0.21067,0.1248,129600,40625,136800,completed
157,90728,7200,1,0-2,1,0.21067,0.1248,129600,38872,136800,completed
160,90731,7200,1,0-2,1,0.21067,0.1248,129600,38869,136800,completed
161,90731,7200,1,0-2,1,0.21067,0.1248,129600,38869,136800,completed
162,90861,7200,1,0-2,1,0.21067,0.1248,129600,38739,136800,completed
163,90890,7200,1,0-2,1,0.21067,0.1248,129600,38710,136800,completed
165,91366,7200,1,0-2,1,0.21067,0.1248,129600,38234,136800,completed
166,91546,7200,1,0-2,1,0.21067,0.1248,129600,38054,136800,completed
190,102715,7200,1,0-2,1,0.21067,0.1248,129600,26885,136800,completed
191,102831,7200,1,0-2,1,0.21067,0.1248,129600,26769,136800,completed
195,107817,3542,1,0-2,1,0.10303284444444444,0.06139466666666666,129600,21783,133142,completed
196,107957,3011,1,0-2,1,0.08758664444444444,0.05219066666666666,129600,21643,132611,completed
197,108189,3922,1,0-2,1,0.1141966388888889,0.06798133333333332,129600,21411,133522,completed
198,108368,3911,1,0-2,1,0.11387290277777778,0.06779066666666667,129600,21232,133511,completed
199,108892,5727,1,0-2,1,0.16731879166666666,0.099268,129600,20708,135327,completed
25,15673,3600,2,0-2,2,0.5108000000000001,0.1248,194400,178727,198000,completed
88,52387,3600,1,0-2,1,0.25540000000000007,0.0624,194400,142013,198000,completed
25,15673,73329,2,24-48,2,6.52704415,2.5420719999999997,201600,185927,274929,completed
88,52387,224,1,0-2,1,0.011819733333333332,0.003882666666666666,201600,149213,201824,completed
133,79367,75632,1,24-48,1,3.3686750666666665,1.3109546666666665,201600,122233,277232,completed
141,84649,1561,2,0-2,2,0.16473753333333332,0.054114666666666665,201600,116951,203161,completed
170,93264,18000,3,6-12,3-4,2.08296,0.9359999999999999,205200,111936,223200,completed
185,100180,22220,1,6-12,1,0.8908787777777778,0.38514666666666664,205200,105020,227420,completed
192,104185,18215,1,6-12,1,0.7043270555555555,0.31572666666666666,205200,101015,223415,completed
193,105195,25200,2,6-12,2,2.06052,0.8735999999999999,205200,100005,230400,completed
193,105195,20805,2,6-12,2,1.9244411666666668,0.72124,234000,128805,254805,completed
185,100180,4069,1,0-2,1,0.17229162222222222,0.07052933333333333,237600,137420,241669,completed
192,104185,7667,1,2-6,1,0.33392779444444437,0.13289466666666666,237600,133415,245267,completed
193,105195,57600,2,12-24,2,4.12774,1.9968,255600,150405,313200,completed
193,105195,23940,2,6-12,2,1.2440600000000002,0.82992,324000,218805,347940,completed
-1,0,0,0,0,0,0.0,0.0,0,0,0,0
