ID,arrival_time,length,cpus,length_class,resource_class,carbon_cost,dollar_cost,start_time,waiting_time,exit_time,reason
0,0,3600,1,0-2,1,0.09614000000000002,0.0624,0,0,3600,completed
1,68,1000,1,0-2,1,0.02670555555555556,0.017333333333333333,68,0,1068,completed
2,463,1570,3,0-2,3-4,0.12578316666666664,0.08163999999999999,463,0,2033,completed
3,838,2762,1,6-12,1,0.07376074444444444,0.04787466666666666,838,0,3600,completed
4,1986,666,1,0-2,1,0.0177859,0.011543999999999999,1986,0,2652,completed
6,2619,628,2,0-2,2,0.03354217777777777,0.021770666666666664,2619,0,3247,completed
5,2619,628,2,0-2,2,0.03354217777777777,0.021770666666666664,2619,0,3247,completed
7,2939,4261,1,12-24,1,0.11678237222222224,0.07385733333333333,2939,0,7200,completed
8,3009,4191,1,12-24,1,0.11491298333333334,0.072644,3009,0,7200,completed
9,4052,3148,3,6-12,3-4,0.26005103333333335,0.16369599999999998,4052,0,7200,completed
10,4791,1750,2,0-2,2,0.09637638888888891,0.06066666666666666,4791,0,6541,completed
11,5796,1404,1,0-2,1,0.0386607,0.024336,5796,0,7200,completed
12,6422,778,1,6-12,1,0.021423094444444447,0.013485333333333332,6422,0,7200,completed
13,6947,3853,2,2-6,2,0.21867327222222216,0.13357066666666667,6947,0,10800,completed
14,7578,2040,1,0-2,1,0.058009666666666654,0.035359999999999996,7578,0,9618,completed
15,8628,1112,1,0-2,1,0.03162095555555555,0.019274666666666666,8628,0,9740,completed
16,8628,1112,1,0-2,1,0.03162095555555555,0.019274666666666666,8628,0,9740,completed
17,9988,812,1,2-6,1,0.023090122222222214,0.014074666666666666,9988,0,10800,completed
18,10481,418,1,0-2,1,0.011906644444444442,0.007245333333333333,10481,0,10899,completed
19,11269,2474,1,0-2,1,0.07085948333333332,0.042882666666666666,11269,0,13743,completed
20,11498,562,1,0-2,1,0.016096616666666664,0.009741333333333333,11498,0,12060,completed
21,12778,1622,1,6-12,1,0.046456783333333335,0.028114666666666666,12778,0,14400,completed
22,13300,489,1,0-2,1,0.014005775000000002,0.008476,13300,0,13789,completed
33,21343,306,1,0-2,1,0.00924466388888889,0.005304,21343,0,21649,completed
23,14435,916,4,0-2,3-4,0.10514662222222224,0.06350933333333333,21600,7165,22516,completed
24,15275,327,1,0-2,1,0.009383991666666668,0.005667999999999999,21600,6325,21927,completed
25,15673,25200,2,48+,2,1.0204,0.8735999999999999,21600,5927,46800,completed
26,15892,374,1,0-2,1,0.010732761111111114,0.006482666666666666,21600,5708,21974,completed
27,15895,342,1,0-2,1,0.009814450000000002,0.005927999999999999,21600,5705,21942,completed
28,16421,12364,1,2-6,1,0.2556035777777778,0.21430933333333332,21600,5179,33964,completed
29,16456,476,2,0-2,2,0.02731975555555556,0.016501333333333333,21600,5144,22076,completed
30,16747,3522,1,0-2,1,0.1010716166666667,0.061048,21600,4853,25122,completed
31,17435,1425,3,0-2,3-4,0.12268062500000003,0.0741,21600,4165,23025,completed
32,17525,11077,1,2-6,1,0.23364592777777782,0.19200133333333333,21600,4075,32677,completed
34,22329,3545,1,0-2,1,0.0954054138888889,0.06144666666666666,22329,0,25874,completed
35,22719,12740,1,2-6,1,0.24899774722222226,0.22082666666666664,22719,0,35459,completed
36,23562,23238,1,12-24,1,0.45389605,0.402792,23562,0,46800,completed
37,24505,2356,2,0-2,2,0.10404065000000001,0.08167466666666666,24505,0,26861,completed
0,0,2702,1,0-2,1,0.05217862222222222,0.04683466666666666,25200,25200,27902,completed
3,838,20787,1,6-12,1,0.3868947166666667,0.36030799999999996,25200,24362,45987,completed
7,2939,21600,1,12-24,1,0.40689000000000003,0.37439999999999996,25200,22261,46800,completed
8,3009,21600,1,12-24,1,0.40689000000000003,0.37439999999999996,25200,22191,46800,completed
9,4052,20515,3,6-12,3-4,1.1406150833333335,1.0667799999999998,25200,21148,45715,completed
11,5796,1421,1,0-2,1,0.02744108888888889,0.024630666666666665,25200,19404,26621,completed
12,6422,21600,1,6-12,1,0.40689000000000003,0.37439999999999996,25200,18778,46800,completed
13,6947,8320,2,2-6,2,0.2894368888888889,0.28842666666666666,25200,18253,33520,completed
17,9988,7523,1,2-6,1,0.13112073888888892,0.13039866666666666,25200,15212,32723,completed
21,12778,15319,1,6-12,1,0.2692355694444445,0.26552933333333334,25200,12422,40519,completed
38,26860,591,2,0-2,2,0.022825733333333334,0.020488,26860,0,27451,completed
39,26860,591,2,0-2,2,0.022825733333333334,0.020488,26860,0,27451,completed
40,26878,337,4,0-2,3-4,0.026031377777777774,0.02336533333333333,26878,0,27215,completed
41,27704,20468,1,6-12,1,0.4065854666666667,0.35477866666666663,27704,0,48172,completed
42,31213,2135,1,0-2,1,0.03466805277777778,0.03700666666666667,31213,0,33348,completed
43,33121,1602,2,0-2,2,0.0546638,0.055535999999999995,33121,0,34723,completed
44,33231,3539,1,0-2,1,0.06122413333333333,0.06134266666666666,33231,0,36770,completed
45,33334,11933,1,2-6,1,0.2276416388888889,0.20683866666666664,33334,0,45267,completed
46,33381,20619,1,6-12,1,0.54032305,0.357396,33381,0,54000,completed
47,33499,338,2,0-2,2,0.01153331111111111,0.011717333333333333,33499,0,33837,completed
48,34097,18740,1,6-12,1,0.4797458777777778,0.32482666666666665,34097,0,52837,completed
49,34607,386,1,0-2,1,0.006585588888888888,0.006690666666666666,34607,0,34993,completed
50,37374,16626,4,12-24,3-4,1.8827618000000002,1.152736,37374,0,54000,completed
51,37439,1484,1,0-2,1,0.026946966666666676,0.025722666666666665,37439,0,38923,completed
52,38457,443,3,0-2,3-4,0.024132425000000006,0.023035999999999997,38457,0,38900,completed
53,39395,14605,1,6-12,1,0.4339924583333334,0.25315333333333334,39395,0,54000,completed
54,39956,386,1,0-2,1,0.007071305555555557,0.006690666666666666,39956,0,40342,completed
55,40299,13701,1,12-24,1,0.4174647083333333,0.23748399999999997,40299,0,54000,completed
56,40576,13424,1,12-24,1,0.4123902222222222,0.23268266666666665,40576,0,54000,completed
57,40698,12794,1,2-6,1,0.38903091666666667,0.22176266666666666,40698,0,53492,completed
58,40788,13212,1,12-24,1,0.4085065,0.229008,40788,0,54000,completed
59,40853,345,1,0-2,1,0.006320208333333335,0.005979999999999999,40853,0,41198,completed
60,41076,1274,1,0-2,1,0.023338972222222226,0.022082666666666664,41076,0,42350,completed
61,41149,11609,1,2-6,1,0.3502466805555555,0.20122266666666666,41149,0,52758,completed
62,41385,12615,1,12-24,1,0.39756979166666667,0.21866,41385,0,54000,completed
63,41524,12476,1,12-24,1,0.3950233888888889,0.21625066666666665,41524,0,54000,completed
64,43402,10598,1,6-12,1,0.35935192222222223,0.18369866666666665,43402,0,54000,completed
65,43955,10045,1,2-6,1,0.34575119444444447,0.17411333333333331,43955,0,54000,completed
66,45189,8811,1,12-24,1,0.31540165000000003,0.152724,45189,0,54000,completed
67,45246,8754,1,6-12,1,0.3139997666666667,0.15173599999999998,45246,0,54000,completed
68,46122,7878,1,12-24,1,0.2924550333333334,0.13655199999999998,46122,0,54000,completed
69,46438,1642,1,0-2,1,0.05373163333333335,0.02846133333333333,46438,0,48080,completed
70,46587,7413,1,12-24,1,0.2810186166666667,0.128492,46587,0,54000,completed
71,46670,7330,1,12-24,1,0.27897727777777787,0.12705333333333332,46670,0,54000,completed
72,46833,3781,1,0-2,1,0.1338231,0.06553733333333332,46833,0,50614,completed
73,47307,6693,1,12-24,1,0.2580237333333334,0.11601199999999999,47307,0,54000,completed
74,47430,658,1,0-2,1,0.023044622222222227,0.011405333333333333,47430,0,48088,completed
75,47446,6554,1,12-24,1,0.2531556444444445,0.11360266666666666,47446,0,54000,completed
76,47919,427,1,0-2,1,0.014954488888888893,0.007401333333333333,47919,0,48346,completed
77,47927,345,1,0-2,1,0.01208266666666667,0.005979999999999999,47927,0,48272,completed
78,48071,589,1,0-2,1,0.020628088888888896,0.010209333333333332,48071,0,48660,completed
79,48327,5673,1,6-12,1,0.2223010666666667,0.09833199999999999,48327,0,54000,completed
80,48353,5647,3,0-2,3-4,0.6641714666666667,0.29364399999999996,48353,0,54000,completed
81,48968,5032,1,12-24,1,0.19985182222222225,0.08722133333333333,48968,0,54000,completed
82,49204,4796,1,12-24,1,0.19158657777777777,0.08313066666666666,49204,0,54000,completed
83,50938,3062,1,12-24,1,0.1273281666666667,0.053074666666666666,50938,0,54000,completed
84,51740,2260,1,6-12,1,0.09397833333333333,0.03917333333333333,51740,0,54000,completed
85,51939,2061,2,0-2,2,0.17140650000000004,0.071448,51939,0,54000,completed
86,51982,2018,1,12-24,1,0.08391516666666668,0.034978666666666665,51982,0,54000,completed
87,52289,1711,1,12-24,1,0.07114908333333336,0.02965733333333333,52289,0,54000,completed
88,52387,1613,1,24-48,1,0.06707391666666668,0.027958666666666666,52387,0,54000,completed
80,48353,201,3,0-2,3-4,0.033741200000000006,0.010452,75600,27247,75801,completed
85,51939,4531,2,0-2,2,0.5389715111111111,0.15707466666666667,75600,23661,80131,completed
89,55519,1512,1,0-2,1,0.08460480000000001,0.026208,77119,21600,78631,completed
90,56068,875,1,0-2,1,0.04896111111111111,0.015166666666666665,77668,21600,78543,completed
91,57022,397,1,0-2,1,0.022214355555555555,0.006881333333333333,78622,21600,79019,completed
92,57178,2329,1,0-2,1,0.16299375555555556,0.04036933333333333,78778,21600,81107,completed
93,59105,458,1,0-2,1,0.033474711111111125,0.007938666666666667,80705,21600,81163,completed
94,59278,341,1,0-2,1,0.024923311111111113,0.0059106666666666665,80878,21600,81219,completed
95,59302,6895,3,0-2,3-4,1.4804730916666666,0.35853999999999997,80902,21600,87797,completed
96,59761,1386,1,0-2,1,0.10130120000000001,0.024024,81361,21600,82747,completed
97,59895,314,1,0-2,1,0.022949911111111113,0.005442666666666666,81495,21600,81809,completed
99,62387,1100,1,0-2,1,0.0774125,0.019066666666666666,83987,21600,85087,completed
110,64777,6944,3,0-2,3-4,1.5463706249999998,0.36108799999999996,86377,21600,93321,completed
111,66212,949,1,0-2,1,0.0688947638888889,0.016449333333333333,87812,21600,88761,completed
112,67986,6830,3,0-2,3-4,1.68418735,0.35516,89586,21600,96416,completed
114,69118,306,1,0-2,1,0.0232645,0.005304,90718,21600,91024,completed
116,71361,2357,2,0-2,2,0.41152886666666666,0.08170933333333333,92961,21600,95318,completed
117,71815,4851,1,0-2,1,0.4588503666666667,0.08408399999999999,93415,21600,98266,completed
118,71852,337,1,0-2,1,0.028544036111111115,0.005841333333333333,93452,21600,93789,completed
119,72628,483,1,0-2,1,0.044190475000000014,0.008372,94228,21600,94711,completed
121,74115,407,3,0-2,3-4,0.11171132500000003,0.021164,95715,21600,96122,completed
123,75085,493,1,0-2,1,0.045105391666666675,0.008545333333333334,96685,21600,97178,completed
124,75341,6650,1,0-2,1,0.7328420222222221,0.11526666666666666,96941,21600,103591,completed
126,76317,625,1,0-2,1,0.06766840277777775,0.010833333333333332,97917,21600,98542,completed
127,76692,527,1,0-2,1,0.0570579972222222,0.009134666666666666,98292,21600,98819,completed
132,78832,336,1,0-2,1,0.036378533333333324,0.005823999999999999,100432,21600,100768,completed
134,80504,4420,1,0-2,1,0.46385175555555563,0.07661333333333332,102104,21600,106524,completed
136,81654,521,1,0-2,1,0.05961831944444444,0.009030666666666666,103254,21600,103775,completed
137,81860,2075,1,0-2,1,0.2150366111111111,0.03596666666666667,103460,21600,105535,completed
138,83339,1461,1,0-2,1,0.1383404666666667,0.025324,104939,21600,106400,completed
139,84591,458,1,0-2,1,0.04336751111111112,0.007938666666666667,106191,21600,106649,completed
140,84596,3106,1,0-2,1,0.26420470555555564,0.05383733333333333,106196,21600,109302,completed
142,84816,303,1,0-2,1,0.02869073333333334,0.005252,106416,21600,106719,completed
143,86690,5878,1,0-2,1,0.3746836166666667,0.10188533333333333,108290,21600,114168,completed
144,86691,5816,1,0-2,1,0.3713511027777778,0.10081066666666666,108291,21600,114107,completed
145,86692,5841,1,0-2,1,0.37266922222222226,0.101244,108292,21600,114133,completed
147,88414,4306,3,0-2,3-4,0.7774648833333333,0.223912,110014,21600,114320,completed
148,88519,1892,1,0-2,1,0.12819495833333333,0.032794666666666666,110119,21600,112011,completed
151,89441,346,1,0-2,1,0.024816850000000005,0.005997333333333333,111041,21600,111387,completed
152,89651,314,1,0-2,1,0.022521650000000004,0.005442666666666666,111251,21600,111565,completed
155,90727,6613,1,0-2,1,0.31845858888888895,0.11462533333333333,112327,21600,118940,completed
154,90727,6737,1,0-2,1,0.3231712777777778,0.11677466666666667,112327,21600,119064,completed
153,90727,6596,1,0-2,1,0.3178124944444445,0.11433066666666666,112327,21600,118923,completed
158,90728,5213,1,0-2,1,0.2572826777777778,0.09035866666666666,112328,21600,117541,completed
156,90728,4749,1,0-2,1,0.2367171666666667,0.082316,112328,21600,117077,completed
159,90729,1794,1,0-2,1,0.09589926666666668,0.031096,112329,21600,114123,completed
164,91113,2907,1,0-2,1,0.1515593,0.050387999999999995,112713,21600,115620,completed
167,91787,7133,1,0-2,1,0.3218444777777778,0.12363866666666666,113387,21600,120520,completed
168,92356,1871,2,0-2,2,0.18857748888888892,0.06486133333333333,113956,21600,115827,completed
169,92542,969,4,0-2,3-4,0.20719373333333335,0.067184,114142,21600,115111,completed
7,2939,29102,1,12-24,1,1.0359975333333333,0.5044346666666666,115200,112261,144302,completed
8,3009,27054,1,12-24,1,0.9384868000000001,0.46893599999999996,115200,112191,142254,completed
12,6422,4742,1,6-12,1,0.2029623444444445,0.08219466666666667,115200,108778,119942,completed
46,33381,1178,1,6-12,1,0.052211577777777796,0.020418666666666665,115200,81819,116378,completed
50,37374,28800,4,12-24,3-4,4.05488,1.9968,115200,77826,144000,completed
53,39395,7032,1,6-12,1,0.28999506666666675,0.121888,115200,75805,122232,completed
55,40299,23054,1,12-24,1,0.7867209222222222,0.39960266666666666,115200,74901,138254,completed
56,40576,21227,1,12-24,1,0.7270424027777779,0.36793466666666663,115200,74624,136427,completed
58,40788,17691,1,12-24,1,0.6230815333333334,0.30664399999999997,115200,74412,132891,completed
62,41385,23108,1,12-24,1,0.7885296222222222,0.40053866666666665,115200,73815,138308,completed
63,41524,23956,1,12-24,1,0.8169329111111112,0.4152373333333333,115200,73676,139156,completed
64,43402,14358,1,6-12,1,0.5260782166666668,0.24887199999999998,115200,71798,129558,completed
65,43955,364,1,2-6,1,0.016133288888888892,0.006309333333333333,115200,71245,115564,completed
66,45189,22433,1,12-24,1,0.7659208722222223,0.38883866666666667,115200,70011,137633,completed
67,45246,13177,1,6-12,1,0.49031688055555567,0.22840133333333332,115200,69954,128377,completed
68,46122,28800,1,12-24,1,1.01372,0.4992,115200,69078,144000,completed
70,46587,28800,1,12-24,1,1.01372,0.4992,115200,68613,144000,completed
71,46670,28800,1,12-24,1,1.01372,0.4992,115200,68530,144000,completed
73,47307,26373,1,12-24,1,0.9091432666666667,0.457132,115200,67893,141573,completed
75,47446,28800,1,12-24,1,1.01372,0.4992,115200,67754,144000,completed
79,48327,19265,1,6-12,1,0.6692996527777778,0.33392666666666665,115200,66873,134465,completed
81,48968,24036,1,12-24,1,0.8196124666666667,0.416624,115200,66232,139236,completed
82,49204,26983,1,12-24,1,0.9354274888888889,0.4677053333333333,115200,65996,142183,completed
83,50938,28800,1,12-24,1,1.01372,0.4992,115200,64262,144000,completed
84,51740,12512,1,6-12,1,0.47018031111111125,0.21687466666666666,115200,63460,127712,completed
86,51982,28800,1,12-24,1,1.01372,0.4992,115200,63218,144000,completed
87,52289,28800,1,12-24,1,1.01372,0.4992,115200,62911,144000,completed
88,52387,28800,1,24-48,1,1.01372,0.4992,115200,62813,144000,completed
171,94444,788,4,0-2,3-4,0.1397036444444445,0.054634666666666665,116044,21600,116832,completed
172,94548,978,1,0-2,1,0.04334713333333335,0.016952,116148,21600,117126,completed
173,95099,1637,1,0-2,1,0.0725554777777778,0.028374666666666666,116699,21600,118336,completed
174,95316,358,1,0-2,1,0.01586735555555556,0.006205333333333333,116916,21600,117274,completed
175,95643,4404,4,0-2,3-4,0.7088460666666667,0.305344,117243,21600,121647,completed
176,95758,784,4,0-2,3-4,0.13899448888888893,0.05435733333333333,117358,21600,118142,completed
177,95766,324,1,0-2,1,0.014360400000000004,0.0056159999999999995,117366,21600,117690,completed
178,96563,1150,2,0-2,2,0.09546021111111112,0.03986666666666666,118163,21600,119313,completed
213,118553,4487,1,0-2,1,0.16944936666666668,0.07777466666666666,118553,0,123040,completed
214,118629,337,1,0-2,1,0.013888022222222225,0.005841333333333333,118629,0,118966,completed
98,60272,13308,1,2-6,1,0.4407449333333333,0.230672,118800,58528,132108,completed
100,62697,18840,1,6-12,1,0.6065953333333334,0.32655999999999996,118800,56103,137640,completed
101,62697,16376,1,6-12,1,0.5306647777777778,0.28385066666666664,118800,56103,135176,completed
102,62745,8650,1,2-6,1,0.30268680555555555,0.14993333333333334,118800,56055,127450,completed
103,62745,8650,1,2-6,1,0.30268680555555555,0.14993333333333334,118800,56055,127450,completed
104,63321,25200,1,12-24,1,0.8541599999999999,0.43679999999999997,118800,55479,144000,completed
105,64259,23764,1,6-12,1,0.7922843555555554,0.4119093333333333,118800,54541,142564,completed
106,64259,23715,1,6-12,1,0.790173,0.41106,118800,54541,142515,completed
107,64262,23864,1,6-12,1,0.7965932444444443,0.41364266666666666,118800,54538,142664,completed
108,64285,24045,1,6-12,1,0.8043923333333333,0.41678,118800,54515,142845,completed
109,64385,15671,1,6-12,1,0.5099162361111111,0.27163066666666663,118800,54415,134471,completed
113,68977,7766,1,2-6,1,0.27591879444444445,0.13461066666666666,118800,49823,126566,completed
115,71226,21358,2,6-12,2,1.381868688888889,0.7404106666666667,118800,47574,140158,completed
120,72728,24731,1,6-12,1,0.8339513111111111,0.42867066666666664,118800,46072,143531,completed
122,74152,9375,1,2-6,1,0.32464020833333335,0.16249999999999998,118800,44648,128175,completed
125,75640,18638,2,6-12,2,1.1996589111111111,0.6461173333333333,118800,43160,137438,completed
128,77811,8703,1,2-6,1,0.304291675,0.15085199999999999,118800,40989,127503,completed
129,77827,9635,1,2-6,1,0.33251315277777777,0.16700666666666666,118800,40973,128435,completed
130,78621,16426,1,6-12,1,0.5321363055555556,0.2847173333333333,118800,40179,135226,completed
131,78654,18421,1,6-12,1,0.5925611611111111,0.3192973333333333,118800,40146,137221,completed
133,79367,25200,1,24-48,1,0.8541599999999999,0.43679999999999997,118800,39433,144000,completed
135,81174,12475,1,2-6,1,0.4165138888888889,0.21623333333333333,118800,37626,131275,completed
141,84649,25200,2,12-24,2,1.7083199999999998,0.8735999999999999,118800,34151,144000,completed
146,88055,13405,1,2-6,1,0.4435665555555556,0.23235333333333333,118800,30745,132205,completed
149,88975,7593,1,2-6,1,0.27068025833333337,0.13161199999999998,118800,29825,126393,completed
150,89356,14065,1,2-6,1,0.4627652222222222,0.2437933333333333,118800,29444,132865,completed
157,90728,7397,1,2-6,1,0.26474526944444443,0.12821466666666667,118800,28072,126197,completed
161,90731,8215,1,2-6,1,0.2895147638888889,0.14239333333333332,118800,28069,127015,completed
160,90731,8434,1,2-6,1,0.29614620555555554,0.14618933333333334,118800,28069,127234,completed
162,90861,9312,1,2-6,1,0.32273253333333335,0.161408,118800,27939,128112,completed
163,90890,9972,1,2-6,1,0.3427177,0.172848,118800,27910,128772,completed
165,91366,7204,1,2-6,1,0.2589011222222222,0.12486933333333333,118800,27434,126004,completed
166,91546,8796,1,2-6,1,0.30710776666666667,0.152464,118800,27254,127596,completed
170,93264,25200,3,12-24,3-4,2.56248,1.3104,118800,25536,144000,completed
179,97903,1276,4,0-2,3-4,0.19398035555555557,0.08846933333333333,118800,20897,120076,completed
180,98586,400,1,0-2,1,0.015202222222222225,0.006933333333333333,118800,20214,119200,completed
181,98684,880,1,0-2,1,0.0334448888888889,0.015253333333333332,118800,20116,119680,completed
182,99503,1878,1,0-2,1,0.07137443333333335,0.032552,118800,19297,120678,completed
183,99810,1943,1,0-2,1,0.07384479444444446,0.03367866666666666,118800,18990,120743,completed
184,99980,516,1,0-2,1,0.01961086666666667,0.008943999999999999,118800,18820,119316,completed
185,100180,25200,1,12-24,1,0.8541599999999999,0.43679999999999997,118800,18620,144000,completed
186,100746,2200,1,0-2,1,0.08361222222222221,0.03813333333333333,118800,18054,121000,completed
187,100869,1307,1,0-2,1,0.04967326111111111,0.022654666666666667,118800,17931,120107,completed
188,102638,466,1,0-2,1,0.017710588888888892,0.008077333333333332,118800,16162,119266,completed
189,102692,4421,1,0-2,1,0.16463365555555554,0.07663066666666667,118800,16108,123221,completed
190,102715,7658,1,2-6,1,0.27264849444444444,0.13273866666666667,118800,16085,126458,completed
191,102831,7331,1,2-6,1,0.2627467527777777,0.12707066666666667,118800,15969,126131,completed
192,104185,25200,1,12-24,1,0.8541599999999999,0.43679999999999997,118800,14615,144000,completed
193,105195,25200,2,24-48,2,1.7083199999999998,0.8735999999999999,118800,13605,144000,completed
194,107422,346,1,0-2,1,0.013149922222222223,0.005997333333333333,118800,11378,119146,completed
195,107817,3725,1,0-2,1,0.14105472222222226,0.06456666666666666,118800,10983,122525,completed
196,107957,3054,1,0-2,1,0.11606896666666669,0.052936,118800,10843,121854,completed
197,108189,3922,1,0-2,1,0.14772864444444445,0.06798133333333332,118800,10611,122722,completed
198,108368,3911,1,0-2,1,0.1473559888888889,0.06779066666666667,118800,10432,122711,completed
199,108892,5727,1,0-2,1,0.20887803333333332,0.099268,118800,9908,124527,completed
200,109732,3057,1,0-2,1,0.11618298333333335,0.05298799999999999,118800,9068,121857,completed
201,110621,421,1,0-2,1,0.01600033888888889,0.007297333333333333,118800,8179,119221,completed
202,112190,1385,1,0-2,1,0.05263769444444445,0.024006666666666666,118800,6610,120185,completed
203,112548,390,1,0-2,1,0.014822166666666668,0.0067599999999999995,118800,6252,119190,completed
204,112549,610,1,0-2,1,0.02318338888888889,0.010573333333333332,118800,6251,119410,completed
205,113237,1120,1,0-2,1,0.04256622222222222,0.01941333333333333,118800,5563,119920,completed
206,114094,309,1,0-2,1,0.011743716666666666,0.005356,118800,4706,119109,completed
207,114440,8039,1,2-6,1,0.28418538611111116,0.13934266666666667,118800,4360,126839,completed
208,114658,985,1,0-2,1,0.037435472222222224,0.017073333333333333,118800,4142,119785,completed
209,114942,997,1,0-2,1,0.037891538888888895,0.017281333333333333,118800,3858,119797,completed
210,115436,2710,1,0-2,1,0.10299505555555556,0.04697333333333333,118800,3364,121510,completed
211,116138,11942,1,2-6,1,0.4010095111111111,0.20699466666666666,118800,2662,130742,completed
212,117394,1256,1,0-2,1,0.047734977777777785,0.021770666666666664,118800,1406,120056,completed
215,118865,16102,4,6-12,3-4,2.088173722222222,1.1164053333333332,118865,0,134967,completed
216,119053,4397,1,0-2,1,0.1627762611111111,0.07621466666666667,119053,0,123450,completed
217,119530,1686,1,0-2,1,0.06407736666666668,0.029223999999999997,119530,0,121216,completed
218,120294,327,1,0-2,1,0.012427816666666666,0.005667999999999999,120294,0,120621,completed
219,121449,1015,1,0-2,1,0.038311461111111125,0.017593333333333332,121449,0,122464,completed
220,121796,480,1,0-2,1,0.01824266666666667,0.00832,121796,0,122276,completed
221,121817,437,1,0-2,1,0.01660842777777778,0.007574666666666666,121817,0,122254,completed
36,23562,6458,1,12-24,1,0.20850182777777773,0.11193866666666666,122400,98838,128858,completed
222,122409,1893,1,0-2,1,0.06413063333333331,0.032812,122409,0,124302,completed
223,122952,9490,1,2-6,1,0.29494008888888884,0.16449333333333332,122952,0,132442,completed
224,123815,20185,1,48+,1,0.6694029444444444,0.3498733333333333,123815,0,144000,completed
225,124452,516,1,0-2,1,0.01748093333333333,0.008943999999999999,124452,0,124968,completed
226,125405,335,1,0-2,1,0.011349055555555553,0.005806666666666667,125405,0,125740,completed
227,125500,18500,1,24-48,1,0.6123188888888889,0.32066666666666666,125500,0,144000,completed
228,125521,18479,1,12-24,1,0.6116074555555554,0.3203026666666666,125521,0,144000,completed
229,125698,17301,1,6-12,1,0.562479111111111,0.299884,125698,0,142999,completed
25,15673,10800,2,48+,2,0.6393599999999999,0.37439999999999996,126000,110327,136800,completed
230,127928,6566,1,0-2,1,0.19343222777777777,0.11381066666666666,127928,0,134494,completed
232,127992,946,2,0-2,2,0.057290811111111103,0.032794666666666666,127992,0,128938,completed
231,127992,946,2,0-2,2,0.057290811111111103,0.032794666666666666,127992,0,128938,completed
233,128383,15248,1,6-12,1,0.507321636111111,0.2642986666666666,128383,0,143631,completed
234,128393,629,1,0-2,1,0.019046469444444446,0.010902666666666666,128393,0,129022,completed
235,128628,415,2,0-2,2,0.025132861111111113,0.014386666666666666,128628,0,129043,completed
236,131671,443,1,0-2,1,0.012886377777777779,0.007678666666666666,131671,0,132114,completed
237,132696,2672,1,0-2,1,0.07846624444444443,0.046314666666666664,132696,0,135368,completed
238,132711,11289,1,6-12,1,0.3958744666666666,0.195676,132711,0,144000,completed
239,132795,2963,1,0-2,1,0.0870643611111111,0.051358666666666664,132795,0,135758,completed
240,133059,366,1,0-2,1,0.010723408333333332,0.006344,133059,0,133425,completed
241,133198,989,1,0-2,1,0.029106136111111108,0.017142666666666667,133198,0,134187,completed
242,133886,716,1,0-2,1,0.021072277777777773,0.012410666666666665,133886,0,134602,completed
243,133987,1156,1,0-2,1,0.03402172222222222,0.02003733333333333,133987,0,135143,completed
244,134421,336,1,0-2,1,0.009888666666666665,0.005823999999999999,134421,0,134757,completed
245,134425,325,1,0-2,1,0.009564930555555556,0.005633333333333333,134425,0,134750,completed
246,134448,1417,1,0-2,1,0.04170309722222222,0.02456133333333333,134448,0,135865,completed
247,134462,537,1,0-2,1,0.015804208333333333,0.009307999999999999,134462,0,134999,completed
248,134966,3920,1,0-2,1,0.12384504999999998,0.06794666666666667,134966,0,138886,completed
249,135849,2297,1,0-2,1,0.07307198055555555,0.039814666666666665,135849,0,138146,completed
250,136230,335,1,0-2,1,0.00985923611111111,0.005806666666666667,136230,0,136565,completed
251,136255,573,1,0-2,1,0.01697749722222222,0.009932,136255,0,136828,completed
252,136608,4747,1,0-2,1,0.16738055555555556,0.08228133333333333,136608,0,141355,completed
253,136701,7299,1,2-6,1,0.2786136249999999,0.126516,136701,0,144000,completed
25,15673,136856,2,48+,2,17.594007294444445,4.744341333333333,138073,122400,274929,completed
254,139131,4869,2,2-6,2,0.3952489,0.168792,139131,0,144000,completed
255,139606,4394,1,0-2,1,0.1817145888888889,0.07616266666666666,139606,0,144000,completed
256,141410,2590,1,0-2,1,0.11160022222222221,0.044893333333333334,141410,0,144000,completed
257,141439,2561,1,0-2,1,0.11035064444444444,0.04439066666666666,141439,0,144000,completed
258,141803,665,1,0-2,1,0.02865411111111111,0.011526666666666666,141803,0,142468,completed
259,143361,639,1,0-2,1,0.027533799999999997,0.011075999999999999,143361,0,144000,completed
255,139606,1682,1,0-2,1,0.1716714611111111,0.029154666666666666,165600,25994,167282,completed
256,141410,1404,1,0-2,1,0.14329770000000003,0.024336,165600,24190,167004,completed
257,141439,1206,1,0-2,1,0.12308905000000003,0.020904,165600,24161,166806,completed
259,143361,4738,1,0-2,1,0.481198388888889,0.08212533333333333,165600,22239,170338,completed
260,144316,1589,1,0-2,1,0.16217951944444445,0.027542666666666667,165916,21600,167505,completed
262,145349,5500,4,0-2,3-4,2.2182222555555557,0.3813333333333333,166949,21600,172449,completed
263,145849,803,1,0-2,1,0.08195730277777778,0.013918666666666666,167449,21600,168252,completed
264,146413,5056,3,0-2,3-4,1.5325539,0.262912,168013,21600,173069,completed
265,146494,350,1,0-2,1,0.035722361111111114,0.006066666666666666,168094,21600,168444,completed
266,147333,389,1,0-2,1,0.039447669444444444,0.006742666666666666,168933,21600,169322,completed
50,37374,11815,4,12-24,3-4,5.031203444444444,0.8191733333333333,169200,131826,181015,completed
68,46122,10122,1,12-24,1,1.073932633333333,0.175448,169200,123078,179322,completed
70,46587,11766,1,12-24,1,1.2524552333333332,0.203944,169200,122613,180966,completed
71,46670,14148,1,12-24,1,1.5123182,0.24523199999999998,169200,122530,183348,completed
75,47446,127,1,12-24,1,0.012696472222222218,0.0022013333333333334,169200,121754,169327,completed
83,50938,9728,1,12-24,1,1.0314309777777777,0.16861866666666667,169200,118262,178928,completed
86,51982,15706,1,12-24,1,1.6911935388888888,0.27223733333333333,169200,117218,184906,completed
87,52289,4881,1,12-24,1,0.5018170083333333,0.084604,169200,116911,174081,completed
88,52387,32624,1,24-48,1,3.2591697333333327,0.5654826666666666,169200,116813,201824,completed
268,148640,1236,1,0-2,1,0.12356566666666666,0.021424,170240,21600,171476,completed
270,149673,1441,1,0-2,1,0.1440599722222222,0.02497733333333333,171273,21600,172714,completed
271,149749,931,1,0-2,1,0.09307413888888888,0.016137333333333333,171349,21600,172280,completed
272,150123,1422,1,0-2,1,0.14589129166666664,0.024648,171723,21600,173145,completed
273,150467,2288,1,0-2,1,0.24555204166666664,0.03965866666666666,172067,21600,174355,completed
275,151727,621,1,0-2,1,0.06879817499999999,0.010764,173327,21600,173948,completed
276,151731,1624,1,0-2,1,0.1799166444444444,0.028149333333333332,173331,21600,174955,completed
277,151739,714,1,0-2,1,0.07910128333333333,0.012376,173339,21600,174053,completed
278,151745,616,1,0-2,1,0.06824424444444444,0.010677333333333332,173345,21600,173961,completed
279,151769,1851,1,0-2,1,0.20506509166666662,0.032084,173369,21600,175220,completed
280,153147,2933,1,0-2,1,0.321205886111111,0.050838666666666664,174747,21600,177680,completed
104,63321,3705,1,12-24,1,0.4039762249999999,0.06422,174921,111600,178626,completed
282,156175,552,1,0-2,1,0.05954546666666667,0.009568,177775,21600,178327,completed
283,159608,1342,1,0-2,1,0.14640474444444446,0.023261333333333332,181208,21600,182550,completed
284,161314,7108,1,0-2,1,0.8176543277777777,0.12320533333333332,182914,21600,190022,completed
285,161513,338,1,0-2,1,0.03687392222222222,0.0058586666666666665,183113,21600,183451,completed
287,162008,2018,1,0-2,1,0.23391422777777782,0.034978666666666665,183608,21600,185626,completed
288,162213,344,1,0-2,1,0.039874377777777775,0.0059626666666666665,183813,21600,184157,completed
289,162863,637,2,0-2,2,0.1476742944444444,0.022082666666666664,184463,21600,185100,completed
291,163472,542,1,0-2,1,0.06282532777777777,0.009394666666666666,185072,21600,185614,completed
292,165371,477,2,0-2,2,0.11030353888888887,0.016536,186971,21600,187448,completed
293,165415,476,2,0-2,2,0.11002345555555552,0.016501333333333333,187015,21600,187491,completed
294,168262,950,1,0-2,1,0.10939130555555551,0.016466666666666664,189862,21600,190812,completed
295,168471,411,1,0-2,1,0.047409991666666644,0.007123999999999999,190071,21600,190482,completed
296,168855,386,1,0-2,1,0.043863908333333326,0.006690666666666666,190455,21600,190841,completed
297,169192,340,4,0-2,3-4,0.13542888888888893,0.02357333333333333,190792,21600,191132,completed
133,79367,86265,1,24-48,1,4.227088666666668,1.4952599999999998,190967,111600,277232,completed
298,169893,458,3,0-2,3-4,0.13630079999999997,0.023815999999999997,191493,21600,191951,completed
300,170769,329,1,0-2,1,0.03263680000000001,0.005702666666666667,192369,21600,192698,completed
301,170781,417,2,0-2,2,0.08273280000000001,0.014455999999999998,192381,21600,192798,completed
302,171912,668,1,0-2,1,0.06626560000000001,0.011578666666666666,193512,21600,194180,completed
304,172434,6694,1,0-2,1,0.4905935555555555,0.11602933333333333,194034,21600,200728,completed
305,174203,313,1,0-2,1,0.022205611111111113,0.005425333333333333,195803,21600,196116,completed
141,84649,6912,2,12-24,2,0.9381049777777777,0.239616,196249,111600,203161,completed
306,175854,310,1,0-2,1,0.02199277777777778,0.005373333333333333,197454,21600,197764,completed
307,175985,335,1,0-2,1,0.023766388888888892,0.005806666666666667,197585,21600,197920,completed
309,178046,6140,1,0-2,1,0.35448523888888883,0.10642666666666666,199646,21600,205786,completed
310,178049,5236,1,0-2,1,0.3155772388888889,0.09075733333333333,199649,21600,204885,completed
312,178050,5613,1,0-2,1,0.3344983083333333,0.09729199999999999,199650,21600,205263,completed
313,178050,5544,1,0-2,1,0.33180923333333334,0.096096,199650,21600,205194,completed
315,178802,347,1,0-2,1,0.025298227777777772,0.006014666666666666,200402,21600,200749,completed
316,178829,3605,1,0-2,1,0.21380647222222218,0.06248666666666666,200429,21600,204034,completed
317,180415,963,1,0-2,1,0.05081429999999999,0.016692,202015,21600,202978,completed
318,181005,316,1,0-2,1,0.016674266666666666,0.005477333333333333,202605,21600,202921,completed
321,181403,4008,1,0-2,1,0.18412760833333333,0.06947199999999999,203003,21600,207011,completed
323,182355,3290,4,0-2,3-4,0.5708231666666668,0.22810666666666665,203955,21600,207245,completed
324,182652,1411,1,0-2,1,0.06745860833333334,0.02445733333333333,204252,21600,205663,completed
325,182908,1089,2,0-2,2,0.10292978333333336,0.037752,204508,21600,205597,completed
170,93264,21502,3,12-24,3-4,2.5782279333333333,1.118104,204864,111600,226366,completed
326,183420,470,1,0-2,1,0.02041891666666667,0.008146666666666667,205020,21600,205490,completed
185,100180,18000,1,12-24,1,0.69432,0.312,205200,105020,223200,completed
192,104185,18000,1,12-24,1,0.69432,0.312,205200,101015,223200,completed
193,105195,18000,2,24-48,2,1.38864,0.624,205200,100005,223200,completed
224,123815,108000,1,48+,1,4.28458,1.8719999999999999,205200,81385,313200,completed
227,125500,45097,1,24-48,1,1.9582285166666669,0.7816813333333333,205200,79700,250297,completed
228,125521,37363,1,12-24,1,1.603262688888889,0.6476253333333333,205200,79679,242563,completed
238,132711,14276,1,6-12,1,0.5310251666666668,0.24745066666666665,205200,72489,219476,completed
253,136701,3127,1,2-6,1,0.11775760833333336,0.05420133333333333,205200,68499,208327,completed
254,139131,4332,2,2-6,2,0.32174966666666666,0.150176,205200,66069,209532,completed
261,144811,20254,1,6-12,1,0.7992311777777779,0.3510693333333333,205200,60389,225454,completed
267,148618,25200,1,24-48,1,1.03026,0.43679999999999997,205200,56582,230400,completed
269,148985,9096,2,2-6,2,0.6591958666666667,0.315328,205200,56215,214296,completed
274,151023,8516,1,2-6,1,0.3083135444444445,0.14761066666666667,205200,54177,213716,completed
281,153489,15245,4,6-12,3-4,2.292583666666667,1.0569866666666665,205200,51711,220445,completed
286,161521,13998,1,2-6,1,0.51991675,0.242632,205200,43679,219198,completed
290,163353,12805,4,2-6,3-4,1.8889858333333334,0.8878133333333332,205200,41847,218005,completed
299,170457,11446,1,2-6,1,0.41794308333333335,0.19839733333333331,205200,34743,216646,completed
303,171994,18000,2,24-48,2,1.38864,0.624,205200,33206,223200,completed
308,177307,7570,1,2-6,1,0.27359797222222226,0.13121333333333332,205200,27893,212770,completed
311,178050,7883,1,2-6,1,0.2850842027777778,0.13663866666666666,205200,27150,213083,completed
314,178067,10302,1,2-6,1,0.37385478333333333,0.17856799999999998,205200,27133,215502,completed
319,181020,14400,1,6-12,1,0.53598,0.2496,205200,24180,219600,completed
320,181349,13392,1,2-6,1,0.49570200000000003,0.23212799999999997,205200,23851,218592,completed
322,182176,14400,1,6-12,1,0.53598,0.2496,205200,23024,219600,completed
327,184082,14400,3,6-12,3-4,1.6079399999999997,0.7487999999999999,205200,21118,219600,completed
328,185325,14400,1,24-48,1,0.53598,0.2496,205200,19875,219600,completed
329,185538,14400,1,6-12,1,0.53598,0.2496,205200,19662,219600,completed
330,185947,14400,3,6-12,3-4,1.6079399999999997,0.7487999999999999,205200,19253,219600,completed
331,186677,14400,1,12-24,1,0.53598,0.2496,205200,18523,219600,completed
332,187677,1211,1,0-2,1,0.04560424166666667,0.020990666666666664,205200,17523,206411,completed
333,188200,602,1,0-2,1,0.02267031666666667,0.010434666666666667,205200,17000,205802,completed
334,190304,14400,2,12-24,2,1.07196,0.4992,205200,14896,219600,completed
335,190644,5112,1,0-2,1,0.187839,0.08860799999999999,205200,14556,210312,completed
336,193347,7881,1,2-6,1,0.2850108083333333,0.136604,205200,11853,213081,completed
337,193609,5303,1,0-2,1,0.19444176388888892,0.09191866666666666,205200,11591,210503,completed
338,193730,10710,2,2-6,2,0.7776545,0.37128,205200,11470,215910,completed
339,194218,681,1,0-2,1,0.025645325000000004,0.011803999999999999,205200,10982,205881,completed
340,194225,1636,1,0-2,1,0.06160903333333334,0.02835733333333333,205200,10975,206836,completed
341,194474,4353,1,0-2,1,0.1616007916666667,0.07545199999999999,205200,10726,209553,completed
342,194911,7875,1,2-6,1,0.28479062499999996,0.13649999999999998,205200,10289,213075,completed
343,195170,5293,1,0-2,1,0.19409606944444446,0.09174533333333333,205200,10030,210493,completed
344,195598,14400,1,6-12,1,0.53598,0.2496,205200,9602,219600,completed
346,195651,14400,1,6-12,1,0.53598,0.2496,205200,9549,219600,completed
345,195651,14400,1,6-12,1,0.53598,0.2496,205200,9549,219600,completed
347,195779,6421,1,0-2,1,0.2330904027777778,0.11129733333333333,205200,9421,211621,completed
348,195874,467,1,0-2,1,0.017586441666666675,0.008094666666666667,205200,9326,205667,completed
349,195929,12695,2,2-6,2,0.9357020833333334,0.4400933333333333,205200,9271,217895,completed
350,196186,3715,1,0-2,1,0.13954548611111117,0.06439333333333333,205200,9014,208915,completed
351,196237,3866,1,0-2,1,0.14476547222222227,0.06701066666666666,205200,8963,209066,completed
352,196246,8485,1,2-6,1,0.3071759305555556,0.14707333333333333,205200,8954,213685,completed
353,196816,3797,1,0-2,1,0.14238018055555562,0.06581466666666666,205200,8384,208997,completed
354,196859,2048,1,0-2,1,0.07712426666666669,0.035498666666666664,205200,8341,207248,completed
355,197017,6183,1,0-2,1,0.22486287500000002,0.10717199999999999,205200,8183,211383,completed
356,197408,2314,1,0-2,1,0.08714138333333334,0.04010933333333333,205200,7792,207514,completed
357,197456,2185,1,0-2,1,0.08228345833333334,0.03787333333333333,205200,7744,207385,completed
358,199432,325,1,0-2,1,0.012238958333333334,0.005633333333333333,205200,5768,205525,completed
359,199613,3901,2,0-2,2,0.29195080555555564,0.13523466666666667,205200,5587,209101,completed
360,201595,705,1,0-2,1,0.026549125000000003,0.01222,205200,3605,205905,completed
361,203620,5670,1,0-2,1,0.20712875000000003,0.09827999999999999,205200,1580,210870,completed
362,203620,5670,1,0-2,1,0.20712875000000003,0.09827999999999999,205200,1580,210870,completed
363,205005,867,1,0-2,1,0.032649775000000006,0.015028,205200,195,206067,completed
364,205007,1027,1,0-2,1,0.03867510833333335,0.017801333333333332,205200,193,206227,completed
365,206564,800,1,0-2,1,0.030126666666666673,0.013866666666666666,206564,0,207364,completed
366,206629,753,1,0-2,1,0.028356725000000006,0.013052,206629,0,207382,completed
367,206629,753,1,0-2,1,0.028356725000000006,0.013052,206629,0,207382,completed
368,206935,7438,1,2-6,1,0.2670864111111111,0.12892533333333334,206935,0,214373,completed
369,208038,5535,1,0-2,1,0.19619149166666663,0.09594,208038,0,213573,completed
370,212446,7154,1,6-12,1,0.2742719277777778,0.12400266666666666,212446,0,219600,completed
371,212970,6630,1,6-12,1,0.2550425833333333,0.11492,212970,0,219600,completed
372,213916,5684,1,2-6,1,0.22032701111111114,0.09852266666666666,213916,0,219600,completed
373,213932,5668,1,6-12,1,0.21973985555555556,0.09824533333333332,213932,0,219600,completed
374,218855,745,1,6-12,1,0.029768958333333338,0.012913333333333332,218855,0,219600,completed
375,219458,142,1,0-2,1,0.005674083333333333,0.002461333333333333,219458,0,219600,completed
376,219459,141,2,0-2,2,0.01126825,0.004888,219459,0,219600,completed
377,219554,46,1,0-2,1,0.0018380833333333328,0.0007973333333333333,219554,0,219600,completed
185,100180,11889,1,12-24,1,0.5619304000000002,0.20607599999999998,229780,129600,241669,completed
192,104185,11482,1,12-24,1,0.5175981138888889,0.19902133333333333,233785,129600,245267,completed
193,105195,113145,2,24-48,2,8.485103416666666,3.92236,234795,129600,347940,completed
267,148618,14400,1,24-48,1,0.64859,0.2496,237600,88982,252000,completed
303,171994,7200,2,24-48,2,0.6252599999999999,0.2496,237600,65606,244800,completed
319,181020,1719,1,6-12,1,0.07223142499999999,0.029796,237600,56580,239319,completed
322,182176,3600,1,6-12,1,0.15127000000000002,0.0624,237600,55424,241200,completed
327,184082,3600,3,6-12,3-4,0.4538099999999998,0.18719999999999998,237600,53518,241200,completed
328,185325,3600,1,24-48,1,0.15127000000000002,0.0624,237600,52275,241200,completed
329,185538,3600,1,6-12,1,0.15127000000000002,0.0624,237600,52062,241200,completed
330,185947,3600,3,6-12,3-4,0.4538099999999998,0.18719999999999998,237600,51653,241200,completed
331,186677,3600,1,12-24,1,0.15127000000000002,0.0624,237600,50923,241200,completed
334,190304,3600,2,12-24,2,0.30254000000000003,0.1248,237600,47296,241200,completed
375,219458,635,1,0-2,1,0.028462111111111105,0.011006666666666666,241200,21742,241835,completed
376,219459,5610,2,0-2,2,0.5060543333333333,0.19448,241200,21741,246810,completed
377,219554,854,1,0-2,1,0.03827817777777777,0.014802666666666665,241200,21646,242054,completed
378,219910,858,2,0-2,2,0.07691493333333332,0.029744,241510,21600,242368,completed
379,220693,704,1,0-2,1,0.03155484444444444,0.012202666666666665,242293,21600,242997,completed
381,221073,5249,1,0-2,1,0.23771741111111108,0.09098266666666666,242673,21600,247922,completed
382,221341,991,1,0-2,1,0.04441882222222221,0.017177333333333333,242941,21600,243932,completed
383,221787,3930,1,0-2,1,0.17812298333333332,0.06812,243387,21600,247317,completed
384,222046,4749,1,0-2,1,0.21567681666666666,0.082316,243646,21600,248395,completed
385,222299,5840,1,0-2,1,0.26845743888888884,0.10122666666666666,243899,21600,249739,completed
386,222684,4121,1,0-2,1,0.18754685,0.07143066666666666,244284,21600,248405,completed
387,222693,925,1,0-2,1,0.04178798888888888,0.016033333333333333,244293,21600,245218,completed
388,224094,3449,1,0-2,1,0.15886211666666666,0.059782666666666665,245694,21600,249143,completed
390,224817,2678,1,0-2,1,0.1235989,0.046418666666666664,246417,21600,249095,completed
391,225266,2364,1,0-2,1,0.10956375555555554,0.040976,246866,21600,249230,completed
392,225969,1973,1,0-2,1,0.09239065,0.03419866666666666,247569,21600,249542,completed
393,226479,5899,1,0-2,1,0.28598970555555553,0.10224933333333333,248079,21600,253978,completed
394,227493,5400,1,0-2,1,0.2642072,0.09359999999999999,249093,21600,254493,completed
395,227499,4239,1,0-2,1,0.20577948333333332,0.073476,249099,21600,253338,completed
396,228110,1781,1,0-2,1,0.08498338333333333,0.030870666666666664,249710,21600,251491,completed
398,228553,1463,1,0-2,1,0.06980948333333332,0.025358666666666665,250153,21600,251616,completed
399,228555,1408,1,0-2,1,0.06718506666666665,0.02440533333333333,250155,21600,251563,completed
400,228663,4241,1,0-2,1,0.2089324277777778,0.07351066666666667,250263,21600,254504,completed
402,229311,1471,1,0-2,1,0.07119290555555555,0.02549733333333333,250911,21600,252382,completed
403,230711,2968,1,0-2,1,0.1494058222222222,0.05144533333333333,252311,21600,255279,completed
404,232121,1753,1,0-2,1,0.08824407222222222,0.03038533333333333,253721,21600,255474,completed
407,233604,356,2,0-2,2,0.03584128888888889,0.012341333333333333,255204,21600,255560,completed
267,148618,57600,1,24-48,1,2.06387,0.9984,255600,106982,313200,completed
408,236148,939,1,0-2,1,0.04429993333333332,0.016276,257748,21600,258687,completed
409,236207,362,1,0-2,1,0.01707835555555555,0.006274666666666666,257807,21600,258169,completed
303,171994,14400,2,24-48,2,1.2446199999999998,0.4992,259200,87206,273600,completed
410,238500,4087,1,0-2,1,0.17803283611111106,0.07084133333333333,260100,21600,264187,completed
412,239121,555,1,0-2,1,0.024967291666666662,0.00962,260721,21600,261276,completed
413,239553,308,1,0-2,1,0.013855722222222219,0.005338666666666666,261153,21600,261461,completed
415,240617,319,1,0-2,1,0.01435056944444444,0.005529333333333333,262217,21600,262536,completed
416,240770,996,2,0-2,2,0.08485793333333332,0.034527999999999996,262370,21600,263366,completed
322,182176,7200,1,6-12,1,0.29656,0.1248,262800,80624,270000,completed
327,184082,5571,3,6-12,3-4,0.686421525,0.289692,262800,78718,268371,completed
328,185325,7200,1,24-48,1,0.29656,0.1248,262800,77475,270000,completed
329,185538,59,1,6-12,1,0.002406380555555556,0.0010226666666666665,262800,77262,262859,completed
330,185947,7200,3,6-12,3-4,0.8896799999999998,0.37439999999999996,262800,76853,270000,completed
331,186677,7200,1,12-24,1,0.29656,0.1248,262800,76123,270000,completed
334,190304,7200,2,12-24,2,0.59312,0.2496,262800,72496,270000,completed
344,195598,3119,1,6-12,1,0.12721188055555557,0.05406266666666666,262800,67202,265919,completed
346,195651,7200,1,6-12,1,0.29656,0.1248,262800,67149,270000,completed
345,195651,7200,1,6-12,1,0.29656,0.1248,262800,67149,270000,completed
417,243031,563,1,0-2,1,0.022962580555555553,0.009758666666666665,264631,21600,265194,completed
418,243351,689,1,0-2,1,0.028101630555555552,0.011942666666666666,264951,21600,265640,completed
420,244638,471,1,0-2,1,0.019459174999999995,0.008164,266238,21600,266709,completed
421,247378,2247,1,0-2,1,0.09824418333333335,0.038947999999999997,268978,21600,271225,completed
422,247578,3039,3,0-2,3-4,0.40518554999999995,0.158028,269178,21600,272217,completed
423,248081,2948,3,0-2,3-4,0.39866172499999997,0.153296,269681,21600,272629,completed
424,248452,5020,3,0-2,3-4,0.6860028,0.26104,270052,21600,275072,completed
425,249892,849,1,0-2,1,0.0386295,0.014716,271492,21600,272341,completed
426,249910,692,1,0-2,1,0.03148600000000001,0.011994666666666666,271510,21600,272202,completed
427,250177,632,1,0-2,1,0.028756000000000007,0.010954666666666666,271777,21600,272409,completed
428,250684,616,1,0-2,1,0.028028000000000008,0.010677333333333332,272284,21600,272900,completed
429,253387,639,1,0-2,1,0.029186325000000003,0.011075999999999999,274987,21600,275626,completed
430,253491,1887,1,0-2,1,0.08618872500000002,0.032708,275091,21600,276978,completed
303,171994,36000,2,24-48,2,2.2145799999999998,1.248,277200,105206,313200,completed
433,256034,632,4,0-2,3-4,0.11258026666666668,0.043818666666666665,277634,21600,278266,completed
435,257863,535,3,0-2,3-4,0.07147599999999998,0.027819999999999998,279463,21600,279998,completed
436,258058,4284,2,0-2,2,0.27670607777777784,0.14851199999999998,279658,21600,283942,completed
437,258996,462,1,0-2,1,0.016269383333333335,0.008008,280596,21600,281058,completed
322,182176,1232,1,6-12,1,0.03430777777777779,0.021354666666666664,280800,98624,282032,completed
328,185325,32400,1,24-48,1,0.94697,0.5616,280800,95475,313200,completed
330,185947,1877,3,6-12,3-4,0.15680770833333335,0.097604,280800,94853,282677,completed
331,186677,24285,1,12-24,1,0.6615870416666667,0.42094,280800,94123,305085,completed
334,190304,16082,2,12-24,2,0.8936441888888891,0.5575093333333333,280800,90496,296882,completed
346,195651,2571,1,6-12,1,0.07159520833333335,0.044564,280800,85149,283371,completed
345,195651,2571,1,6-12,1,0.07159520833333335,0.044564,280800,85149,283371,completed
370,212446,11153,1,6-12,1,0.3278269944444445,0.19331866666666667,280800,68354,291953,completed
371,212970,16295,1,6-12,1,0.4513761527777779,0.2824466666666666,280800,67830,297095,completed
372,213916,7597,1,2-6,1,0.21390175000000006,0.13168133333333332,280800,66884,288397,completed
373,213932,9378,1,6-12,1,0.27222950000000007,0.162552,280800,66868,290178,completed
374,218855,22489,1,6-12,1,0.6130401638888889,0.3898093333333333,280800,61945,303289,completed
380,220938,7200,1,6-12,1,0.20090000000000005,0.1248,280800,59862,288000,completed
389,224643,7200,1,12-24,1,0.20090000000000005,0.1248,280800,56157,288000,completed
397,228373,7200,1,2-6,1,0.20090000000000005,0.1248,280800,52427,288000,completed
401,229057,7200,1,24-48,1,0.20090000000000005,0.1248,280800,51743,288000,completed
405,233054,7200,4,12-24,3-4,0.8036000000000002,0.4992,280800,47746,288000,completed
406,233406,7200,1,2-6,1,0.20090000000000005,0.1248,280800,47394,288000,completed
411,238950,7200,4,2-6,3-4,0.8036000000000002,0.4992,280800,41850,288000,completed
414,240246,7200,1,2-6,1,0.20090000000000005,0.1248,280800,40554,288000,completed
419,243639,7200,2,6-12,2,0.4018000000000001,0.2496,280800,37161,288000,completed
431,255379,3600,1,2-6,1,0.10025000000000003,0.0624,280800,25421,284400,completed
432,255772,3600,1,2-6,1,0.10025000000000003,0.0624,280800,25028,284400,completed
438,260363,5774,1,0-2,1,0.16116063888888893,0.10008266666666667,281963,21600,287737,completed
440,261835,6498,1,0-2,1,0.19082831944444445,0.112632,283435,21600,289933,completed
442,261836,6740,1,0-2,1,0.19875872222222227,0.11682666666666666,283436,21600,290176,completed
447,261841,1389,1,0-2,1,0.03872756944444446,0.024076,283441,21600,284830,completed
448,261841,1389,1,0-2,1,0.03872756944444446,0.024076,283441,21600,284830,completed
452,267749,1987,2,0-2,2,0.1301485,0.06888266666666666,289349,21600,291336,completed
453,267778,2400,1,0-2,1,0.07732235555555556,0.0416,289378,21600,291778,completed
454,267924,663,1,0-2,1,0.021713250000000003,0.011491999999999999,289524,21600,290187,completed
380,220938,10854,1,6-12,1,0.27166965000000004,0.188136,291600,70662,302454,completed
389,224643,18000,1,12-24,1,0.47562,0.312,291600,66957,309600,completed
397,228373,6395,1,2-6,1,0.15181865277777776,0.11084666666666666,291600,63227,297995,completed
401,229057,18000,1,24-48,1,0.47562,0.312,291600,62543,309600,completed
405,233054,18000,4,12-24,3-4,1.90248,1.248,291600,58546,309600,completed
406,233406,3821,1,2-6,1,0.0967851027777778,0.06623066666666666,291600,58194,295421,completed
411,238950,4098,4,2-6,3-4,0.41083006666666677,0.284128,291600,52650,295698,completed
414,240246,1658,1,2-6,1,0.04239874444444445,0.028738666666666666,291600,51354,293258,completed
419,243639,14400,2,6-12,2,0.73504,0.4992,291600,47961,306000,completed
431,255379,7200,1,2-6,1,0.16903,0.1248,291600,36221,298800,completed
432,255772,5996,1,2-6,1,0.1432878111111111,0.10393066666666666,291600,35828,297596,completed
434,257576,7200,1,12-24,1,0.16903,0.1248,291600,34024,298800,completed
439,261833,7200,1,2-6,1,0.16903,0.1248,291600,29767,298800,completed
444,261836,7200,1,12-24,1,0.16903,0.1248,291600,29764,298800,completed
441,261836,7200,1,12-24,1,0.16903,0.1248,291600,29764,298800,completed
443,261836,7200,1,2-6,1,0.16903,0.1248,291600,29764,298800,completed
445,261839,7200,1,2-6,1,0.16903,0.1248,291600,29761,298800,completed
446,261839,7200,1,6-12,1,0.16903,0.1248,291600,29761,298800,completed
449,263929,3600,1,12-24,1,0.07696999999999998,0.0624,295200,31271,298800,completed
450,266116,3600,1,6-12,1,0.07696999999999998,0.0624,295200,29084,298800,completed
451,266551,3600,1,6-12,1,0.07696999999999998,0.0624,295200,28649,298800,completed
455,277091,3600,1,24-48,1,0.07696999999999998,0.0624,295200,18109,298800,completed
456,277119,3600,1,24-48,1,0.07696999999999998,0.0624,295200,18081,298800,completed
457,277120,3600,1,12-24,1,0.07696999999999998,0.0624,295200,18080,298800,completed
459,277122,3600,1,24-48,1,0.07696999999999998,0.0624,295200,18078,298800,completed
458,277122,3600,1,24-48,1,0.07696999999999998,0.0624,295200,18078,298800,completed
460,277122,3600,1,24-48,1,0.07696999999999998,0.0624,295200,18078,298800,completed
461,277268,3600,1,6-12,1,0.07696999999999998,0.0624,295200,17932,298800,completed
462,280792,3457,1,0-2,1,0.07391258055555552,0.059921333333333326,295200,14408,298657,completed
463,281348,3600,1,0-2,1,0.07696999999999998,0.0624,295200,13852,298800,completed
464,281485,3600,1,2-6,1,0.07696999999999998,0.0624,295200,13715,298800,completed
465,282271,1286,1,0-2,1,0.02749539444444444,0.022290666666666667,295200,12929,296486,completed
466,282283,3600,1,0-2,1,0.07696999999999998,0.0624,295200,12917,298800,completed
467,283226,3600,1,0-2,1,0.07696999999999998,0.0624,295200,11974,298800,completed
468,284176,3600,1,6-12,1,0.07696999999999998,0.0624,295200,11024,298800,completed
469,284548,3600,1,6-12,1,0.07696999999999998,0.0624,295200,10652,298800,completed
470,285446,3600,3,6-12,3-4,0.23090999999999995,0.18719999999999998,295200,9754,298800,completed
471,285786,1531,1,0-2,1,0.032733630555555546,0.026537333333333333,295200,9414,296731,completed
472,286921,801,1,0-2,1,0.017125824999999997,0.013883999999999999,295200,8279,296001,completed
473,287707,455,1,0-2,1,0.009728152777777775,0.007886666666666667,295200,7493,295655,completed
474,287713,1591,1,0-2,1,0.034016463888888876,0.027577333333333332,295200,7487,296791,completed
475,288498,525,1,0-2,1,0.011224791666666664,0.009099999999999999,295200,6702,295725,completed
476,289198,1825,1,0-2,1,0.03901951388888888,0.03163333333333333,295200,6002,297025,completed
477,289201,2724,1,0-2,1,0.05824063333333332,0.047215999999999994,295200,5999,297924,completed
478,289599,335,1,0-2,1,0.007162486111111111,0.005806666666666667,295200,5601,295535,completed
479,291817,3320,1,0-2,1,0.07098344444444442,0.05754666666666666,295200,3383,298520,completed
480,292492,1285,1,0-2,1,0.027474013888888885,0.022273333333333332,295200,2708,296485,completed
481,293939,1226,1,0-2,1,0.02621256111111111,0.021250666666666664,295200,1261,296426,completed
482,296094,653,1,0-2,1,0.013961502777777775,0.011318666666666666,296094,0,296747,completed
483,296434,2366,1,0-2,1,0.05058639444444444,0.04101066666666667,296434,0,298800,completed
484,297846,954,3,6-12,3-4,0.06119114999999998,0.049608,297846,0,298800,completed
431,255379,1507,1,2-6,1,0.04073504722222221,0.026121333333333333,302400,47021,303907,completed
434,257576,3600,1,12-24,1,0.09730999999999998,0.0624,302400,44824,306000,completed
463,281348,55,1,0-2,1,0.001651527777777777,0.0009533333333333333,306548,25200,306603,completed
466,282283,996,1,0-2,1,0.029907666666666673,0.017263999999999998,307483,25200,308479,completed
467,283226,1016,1,0-2,1,0.03050822222222223,0.017610666666666667,308426,25200,309442,completed
224,123815,86400,1,48+,1,2.2193899999999998,1.4975999999999998,320400,196585,406800,completed
483,296434,719,1,0-2,1,0.03645929166666667,0.012462666666666665,320400,23966,321119,completed
488,301753,3759,1,0-2,1,0.14849689166666669,0.06515599999999999,323353,21600,327112,completed
267,148618,20486,1,24-48,1,0.5465469611111111,0.35509066666666667,324000,175382,344486,completed
303,171994,40659,2,24-48,2,2.176467466666667,1.4095119999999999,324000,152006,364659,completed
328,185325,391,1,24-48,1,0.014535425000000005,0.006777333333333333,324000,138675,324391,completed
491,305734,687,1,0-2,1,0.022053111111111114,0.011907999999999998,327334,21600,328021,completed
492,305793,617,1,0-2,1,0.019541947222222224,0.010694666666666667,327393,21600,328010,completed
493,305795,605,1,0-2,1,0.01917865277777778,0.010486666666666667,327395,21600,328000,completed
389,224643,26289,1,12-24,1,0.6168187,0.45567599999999997,327600,102957,353889,completed
401,229057,32400,1,24-48,1,0.7772300000000001,0.5616,327600,98543,360000,completed
405,233054,7459,4,12-24,3-4,0.7984806444444443,0.5171573333333332,327600,94546,335059,completed
419,243639,188,2,6-12,2,0.010864311111111111,0.006517333333333333,327600,83961,327788,completed
494,306100,2137,2,0-2,2,0.12349485555555553,0.07408266666666666,327700,21600,329837,completed
495,306134,784,2,0-2,2,0.04530648888888888,0.027178666666666663,327734,21600,328518,completed
497,306561,2156,1,0-2,1,0.06229642222222222,0.03737066666666666,328161,21600,330317,completed
496,306561,2156,1,0-2,1,0.06229642222222222,0.03737066666666666,328161,21600,330317,completed
498,306654,3563,1,0-2,1,0.10051375555555553,0.06175866666666666,328254,21600,331817,completed
500,308013,3008,1,0-2,1,0.08130153888888889,0.052138666666666666,329613,21600,332621,completed
501,308520,3207,1,0-2,1,0.08426283333333331,0.055588,330120,21600,333327,completed
502,309025,4870,1,0-2,1,0.12197844444444443,0.08441333333333333,330625,21600,335495,completed
434,257576,25200,1,12-24,1,0.56991,0.43679999999999997,331200,73624,356400,completed
439,261833,823,1,2-6,1,0.020529277777777778,0.014265333333333333,331200,69367,332023,completed
444,261836,25200,1,12-24,1,0.56991,0.43679999999999997,331200,69364,356400,completed
443,261836,2778,1,2-6,1,0.06929566666666667,0.048152,331200,69364,333978,completed
441,261836,25200,1,12-24,1,0.56991,0.43679999999999997,331200,69364,356400,completed
445,261839,4366,1,2-6,1,0.10695414444444443,0.07567733333333333,331200,69361,335566,completed
446,261839,12505,1,6-12,1,0.2903195972222222,0.21675333333333333,331200,69361,343705,completed
449,263929,25200,1,12-24,1,0.56991,0.43679999999999997,331200,67271,356400,completed
450,266116,17555,1,6-12,1,0.4013402777777778,0.30428666666666665,331200,65084,348755,completed
451,266551,16522,1,6-12,1,0.3795898888888889,0.2863813333333333,331200,64649,347722,completed
504,310006,2540,1,0-2,1,0.06335888888888887,0.044026666666666665,331606,21600,334146,completed
503,310006,1032,1,0-2,1,0.025742666666666667,0.017887999999999998,331606,21600,332638,completed
507,311462,3098,1,0-2,1,0.0738098888888889,0.053698666666666665,333062,21600,336160,completed
508,312765,1947,1,0-2,1,0.04471123333333333,0.033748,334365,21600,336312,completed
455,277091,21600,1,24-48,1,0.4801100000000001,0.37439999999999996,334800,57709,356400,completed
456,277119,21600,1,24-48,1,0.4801100000000001,0.37439999999999996,334800,57681,356400,completed
457,277120,21600,1,12-24,1,0.4801100000000001,0.37439999999999996,334800,57680,356400,completed
459,277122,21600,1,24-48,1,0.4801100000000001,0.37439999999999996,334800,57678,356400,completed
458,277122,21600,1,24-48,1,0.4801100000000001,0.37439999999999996,334800,57678,356400,completed
460,277122,21600,1,24-48,1,0.4801100000000001,0.37439999999999996,334800,57678,356400,completed
461,277268,21600,1,6-12,1,0.4801100000000001,0.37439999999999996,334800,57532,356400,completed
464,281485,4169,1,2-6,1,0.09322967222222221,0.07226266666666666,334800,53315,338969,completed
468,284176,7200,1,6-12,1,0.16040000000000001,0.1248,334800,50624,342000,completed
469,284548,7200,1,6-12,1,0.16040000000000001,0.1248,334800,50252,342000,completed
470,285446,7200,3,6-12,3-4,0.48120000000000007,0.37439999999999996,334800,49354,342000,completed
509,313526,4118,1,0-2,1,0.09202338888888889,0.07137866666666666,335126,21600,339244,completed
511,316647,1085,1,0-2,1,0.024080505555555562,0.018806666666666666,338247,21600,339332,completed
512,318009,1407,1,0-2,1,0.03118068333333334,0.024388,339609,21600,341016,completed
513,318114,565,1,0-2,1,0.01252102777777778,0.009793333333333333,339714,21600,340279,completed
514,322583,889,1,0-2,1,0.02091866388888889,0.015409333333333332,344183,21600,345072,completed
468,284176,4987,1,6-12,1,0.10558967777777775,0.08644133333333333,345600,61424,350587,completed
469,284548,10800,1,6-12,1,0.235,0.18719999999999998,345600,61052,356400,completed
470,285446,6386,3,6-12,3-4,0.40691126666666666,0.332072,345600,60154,351986,completed
484,297846,7200,3,6-12,3-4,0.45935999999999994,0.37439999999999996,345600,47754,352800,completed
485,299126,7200,1,6-12,1,0.15312,0.1248,345600,46474,352800,completed
486,299982,7200,1,6-12,1,0.15312,0.1248,345600,45618,352800,completed
487,300646,7200,1,12-24,1,0.15312,0.1248,345600,44954,352800,completed
489,303292,3600,1,2-6,1,0.0758,0.0624,345600,42308,349200,completed
490,305082,3600,1,2-6,1,0.0758,0.0624,345600,40518,349200,completed
515,326140,2789,3,0-2,3-4,0.1778552333333333,0.145028,347740,21600,350529,completed
517,328375,632,1,0-2,1,0.013573955555555555,0.010954666666666666,349975,21600,350607,completed
518,328500,573,1,0-2,1,0.012306766666666667,0.009932,350100,21600,350673,completed
521,328767,2296,4,0-2,3-4,0.19725191111111112,0.15918933333333332,350367,21600,352663,completed
524,330015,4776,1,0-2,1,0.10712646666666666,0.082784,351615,21600,356391,completed
525,330589,428,1,0-2,1,0.009192488888888888,0.007418666666666666,352189,21600,352617,completed
526,330716,2061,1,0-2,1,0.046263233333333334,0.035724,352316,21600,354377,completed
527,331742,3560,1,0-2,1,0.08395712222222222,0.06170666666666666,353342,21600,356902,completed
528,332857,592,1,0-2,1,0.013464711111111107,0.010261333333333332,354457,21600,355049,completed
531,340682,386,1,0-2,1,0.014702311111111113,0.006690666666666666,362282,21600,362668,completed
532,340688,450,1,0-2,1,0.017140000000000002,0.0078,362288,21600,362738,completed
533,341470,3765,2,0-2,2,0.28508400000000006,0.13052,363070,21600,366835,completed
534,341742,3811,1,0-2,1,0.14420928888888893,0.06605733333333333,363342,21600,367153,completed
536,342395,459,1,0-2,1,0.017360400000000005,0.007956,363995,21600,364454,completed
537,343229,1813,1,0-2,1,0.06857168888888891,0.03142533333333333,364829,21600,366642,completed
401,229057,25614,1,24-48,1,0.39239044999999995,0.443976,367200,138143,392814,completed
434,257576,16629,1,12-24,1,0.269409075,0.288236,367200,109624,383829,completed
444,261836,4090,1,12-24,1,0.08572280555555556,0.07089333333333332,367200,105364,371290,completed
441,261836,3686,1,12-24,1,0.07989959444444444,0.06389066666666667,367200,105364,370886,completed
449,263929,226,1,12-24,1,0.004938099999999999,0.003917333333333333,367200,103271,367426,completed
455,277091,32400,1,24-48,1,0.5299699999999999,0.5616,367200,90109,399600,completed
456,277119,32400,1,24-48,1,0.5299699999999999,0.5616,367200,90081,399600,completed
457,277120,32012,1,12-24,1,0.5208487666666666,0.5548746666666666,367200,90080,399212,completed
460,277122,32400,1,24-48,1,0.5299699999999999,0.5616,367200,90078,399600,completed
458,277122,32400,1,24-48,1,0.5299699999999999,0.5616,367200,90078,399600,completed
459,277122,32400,1,24-48,1,0.5299699999999999,0.5616,367200,90078,399600,completed
461,277268,1648,1,6-12,1,0.036008799999999994,0.02856533333333333,367200,89932,368848,completed
469,284548,193,1,6-12,1,0.004217049999999998,0.003345333333333333,367200,82652,367393,completed
484,297846,19629,3,6-12,3-4,0.934974075,1.020708,367200,69354,386829,completed
485,299126,12037,1,6-12,1,0.20224856944444441,0.20864133333333332,367200,68074,379237,completed
543,345753,6974,1,0-2,1,0.1261547361111111,0.12088266666666667,367353,21600,374327,completed
542,345753,6462,1,0-2,1,0.11877482499999999,0.112008,367353,21600,373815,completed
545,345754,6284,1,0-2,1,0.11620171666666665,0.10892266666666665,367354,21600,373638,completed
549,345782,4847,1,0-2,1,0.09528074722222221,0.08401466666666667,367382,21600,372229,completed
548,345782,5251,1,0-2,1,0.10110395833333331,0.09101733333333333,367382,21600,372633,completed
550,347684,881,2,0-2,2,0.03849969999999999,0.03054133333333333,369284,21600,370165,completed
582,370271,6872,1,0-2,1,0.10418981944444441,0.11911466666666666,370271,0,377143,completed
486,299982,12573,1,6-12,1,0.18413327499999999,0.217932,370800,70818,383373,completed
487,300646,25200,1,12-24,1,0.36667999999999995,0.43679999999999997,370800,70154,396000,completed
489,303292,5134,1,2-6,1,0.07467416111111111,0.08898933333333332,370800,67508,375934,completed
490,305082,4261,1,2-6,1,0.061707686111111104,0.07385733333333333,370800,65718,375061,completed
499,306923,8046,4,2-6,3-4,0.4713069999999999,0.557856,370800,63877,378846,completed
505,310024,12658,1,2-6,1,0.18536648333333333,0.2194053333333333,370800,60776,383458,completed
506,310957,25200,1,24-48,1,0.36667999999999995,0.43679999999999997,370800,59843,396000,completed
510,315485,25200,1,24-48,1,0.36667999999999995,0.43679999999999997,370800,55315,396000,completed
516,328312,24547,1,6-12,1,0.35582750277777775,0.4254813333333333,370800,42488,395347,completed
519,328742,8885,1,2-6,1,0.13019034722222222,0.15400666666666665,370800,42058,379685,completed
520,328764,12644,1,2-6,1,0.18516336666666666,0.21916266666666664,370800,42036,383444,completed
522,328771,10392,1,2-6,1,0.15239766666666665,0.18012799999999998,370800,42029,381192,completed
523,328883,16108,1,6-12,1,0.23408230000000002,0.2792053333333333,370800,41917,386908,completed
529,337422,12924,1,2-6,1,0.1892257,0.224016,370800,33378,383724,completed
530,338108,12940,1,2-6,1,0.18945783333333333,0.22429333333333332,370800,32692,383740,completed
535,341755,16736,3,6-12,3-4,0.7281048000000001,0.8702719999999999,370800,29045,387536,completed
538,343881,7501,1,2-6,1,0.10979556944444444,0.13001733333333332,370800,26919,378301,completed
539,344643,7644,2,2-6,2,0.22380566666666663,0.264992,370800,26157,378444,completed
540,345719,25200,1,24-48,1,0.36667999999999995,0.43679999999999997,370800,25081,396000,completed
544,345753,7597,1,2-6,1,0.11121023611111108,0.13168133333333332,370800,25047,378397,completed
541,345753,7606,1,2-6,1,0.1113428611111111,0.13183733333333333,370800,25047,378406,completed
546,345754,7546,1,2-6,1,0.11045869444444442,0.13079733333333332,370800,25046,378346,completed
547,345761,8867,1,2-6,1,0.1299250972222222,0.15369466666666665,370800,25039,379667,completed
551,350173,13232,1,2-6,1,0.19369426666666667,0.22935466666666665,370800,20627,384032,completed
552,350276,12987,1,2-6,1,0.19013972499999998,0.22510799999999997,370800,20524,383787,completed
553,350441,12694,1,2-6,1,0.18588878333333334,0.22002933333333333,370800,20359,383494,completed
554,350610,3433,2,0-2,2,0.0989657611111111,0.11901066666666665,370800,20190,374233,completed
555,353948,1668,2,0-2,2,0.048084733333333324,0.05782399999999999,370800,16852,372468,completed
556,354560,2178,1,0-2,1,0.03139345,0.037752,370800,16240,372978,completed
557,357496,1086,3,0-2,3-4,0.04696045,0.056471999999999994,370800,13304,371886,completed
558,360154,9830,1,2-6,1,0.14411597222222222,0.17038666666666666,370800,10646,380630,completed
559,361690,525,1,0-2,1,0.007567291666666667,0.009099999999999999,370800,9110,371325,completed
560,363919,602,1,0-2,1,0.00867716111111111,0.010434666666666667,370800,6881,371402,completed
561,364486,3356,1,0-2,1,0.04837301111111111,0.05817066666666666,370800,6314,374156,completed
562,364779,6371,1,0-2,1,0.09304704722222219,0.11043066666666666,370800,6021,377171,completed
563,365578,741,1,0-2,1,0.010680691666666665,0.012844,370800,5222,371541,completed
564,366958,2895,1,0-2,1,0.04172820833333333,0.050179999999999995,370800,3842,373695,completed
565,367111,7194,1,0-2,1,0.1052708833333333,0.12469599999999999,370800,3689,377994,completed
566,367858,3411,1,0-2,1,0.049165774999999995,0.059123999999999996,370800,2942,374211,completed
567,367966,2363,1,0-2,1,0.034060019444444437,0.040958666666666664,370800,2834,373163,completed
568,368267,9236,1,2-6,1,0.1353627222222222,0.16009066666666666,370800,2533,380036,completed
569,368314,4324,1,0-2,1,0.0626434111111111,0.07494933333333333,370800,2486,375124,completed
570,368795,3957,1,0-2,1,0.057192441666666656,0.068588,370800,2005,374757,completed
571,368821,6413,1,0-2,1,0.09367086388888887,0.11115866666666666,370800,1979,377213,completed
572,368853,4715,1,0-2,1,0.06845084722222222,0.08172666666666666,370800,1947,375515,completed
573,368974,5074,1,0-2,1,0.07378299444444443,0.08794933333333332,370800,1826,375874,completed
574,369083,6841,1,0-2,1,0.10002785277777776,0.11857733333333333,370800,1717,377641,completed
575,369193,10120,1,2-6,1,0.14838944444444443,0.1754133333333333,370800,1607,380920,completed
576,369391,3248,1,0-2,1,0.046816311111111106,0.056298666666666664,370800,1409,374048,completed
577,369627,6003,1,0-2,1,0.08758122499999998,0.10405199999999999,370800,1173,376803,completed
578,369627,9703,1,2-6,1,0.1422444861111111,0.16818533333333333,370800,1173,380503,completed
579,369857,9880,1,2-6,1,0.14485277777777777,0.1712533333333333,370800,943,380680,completed
580,369864,14244,1,2-6,1,0.2083767,0.24689599999999998,370800,936,385044,completed
581,369872,12312,1,2-6,1,0.1803466,0.213408,370800,928,383112,completed
583,370873,314,1,0-2,1,0.004525961111111111,0.005442666666666666,370873,0,371187,completed
584,371378,312,1,0-2,1,0.0044971333333333335,0.005408,371378,0,371690,completed
585,374388,5765,1,0-2,1,0.08536981388888887,0.09992666666666666,374388,0,380153,completed
586,374392,4731,1,0-2,1,0.07013396388888887,0.082004,374392,0,379123,completed
587,376896,3464,1,0-2,1,0.05117468888888889,0.06004266666666666,376896,0,380360,completed
588,376899,991,1,0-2,1,0.014719102777777772,0.017177333333333333,376899,0,377890,completed
589,379271,3461,1,0-2,1,0.05074383611111112,0.059990666666666664,379271,0,382732,completed
590,383698,15902,1,6-12,1,0.26246151666666667,0.27563466666666664,383698,0,399600,completed
591,383778,9067,1,2-6,1,0.12423650277777776,0.15716133333333332,383778,0,392845,completed
592,383782,15818,1,6-12,1,0.2612428166666666,0.2741786666666666,383782,0,399600,completed
593,383838,15762,1,12-24,1,0.26043035,0.273208,383838,0,399600,completed
594,383984,1291,1,0-2,1,0.018671508333333336,0.022377333333333332,383984,0,385275,completed
595,385133,14467,1,6-12,1,0.2416420583333333,0.25076133333333334,385133,0,399600,completed
596,386588,1961,1,0-2,1,0.026914724999999994,0.03399066666666666,386588,0,388549,completed
597,388684,590,1,0-2,1,0.007754100000000001,0.010226666666666667,388684,0,389274,completed
598,388890,648,1,0-2,1,0.008424000000000001,0.011231999999999999,388890,0,389538,completed
599,390202,321,1,0-2,1,0.0041730000000000005,0.0055639999999999995,390202,0,390523,completed
600,390220,312,1,0-2,1,0.004056000000000001,0.005408,390220,0,390532,completed
601,391758,7842,1,6-12,1,0.152806,0.135928,391758,0,399600,completed
602,391759,7841,1,6-12,1,0.15279299999999996,0.13591066666666665,391759,0,399600,completed
603,392115,745,1,0-2,1,0.011349944444444444,0.012913333333333332,392115,0,392860,completed
604,392125,683,1,0-2,1,0.010355733333333332,0.011838666666666666,392125,0,392808,completed
605,392150,811,1,0-2,1,0.01257350833333333,0.014057333333333333,392150,0,392961,completed
606,394004,2559,1,0-2,1,0.04640760277777778,0.044356,394004,0,396563,completed
607,394244,5294,1,0-2,1,0.11235622777777779,0.09176266666666666,394244,0,399538,completed
608,395065,4535,1,0-2,1,0.10016918055555557,0.07860666666666666,395065,0,399600,completed
609,395232,417,1,0-2,1,0.006930308333333332,0.007227999999999999,395232,0,395649,completed
610,395245,4355,1,0-2,1,0.09717768055555556,0.07548666666666666,395245,0,399600,completed
611,395336,4264,1,0-2,1,0.09566531111111112,0.07390933333333333,395336,0,399600,completed
612,395516,4084,1,0-2,1,0.09267381111111112,0.07078933333333333,395516,0,399600,completed
613,395671,2048,1,0-2,1,0.04587862222222222,0.035498666666666664,395671,0,397719,completed
614,395673,1601,1,0-2,1,0.035384175,0.027750666666666667,395673,0,397274,completed
615,395727,3873,1,0-2,1,0.08916710833333333,0.067132,395727,0,399600,completed
616,395914,3686,1,0-2,1,0.0860592722222222,0.06389066666666667,395914,0,399600,completed
617,396236,3364,1,2-6,1,0.07908203333333333,0.05830933333333333,396236,0,399600,completed
618,397777,1823,1,0-2,1,0.04285569166666666,0.031598666666666664,397777,0,399600,completed
224,123815,202,1,48+,1,0.009831788888888887,0.0035013333333333333,417600,293785,417802,completed
487,300646,7467,1,12-24,1,0.3156404277777777,0.129428,419446,118800,426913,completed
455,277091,913,1,24-48,1,0.040239072222222214,0.015825333333333334,421091,144000,422004,completed
456,277119,7,1,24-48,1,0.0003407055555555555,0.00012133333333333332,421119,144000,421126,completed
459,277122,1338,1,24-48,1,0.058543433333333325,0.023191999999999997,421122,144000,422460,completed
460,277122,1636,1,24-48,1,0.07149153333333333,0.02835733333333333,421122,144000,422758,completed
458,277122,1744,1,24-48,1,0.07618413333333332,0.03022933333333333,421122,144000,422866,completed
608,395065,1061,1,0-2,1,0.04610044999999999,0.018390666666666666,421200,26135,422261,completed
610,395245,2358,1,0-2,1,0.1024551,0.040872,421200,25955,423558,completed
611,395336,1257,1,0-2,1,0.05461664999999999,0.021788,421200,25864,422457,completed
612,395516,2761,1,0-2,1,0.11996544999999997,0.04785733333333333,421200,25684,423961,completed
615,395727,2083,1,0-2,1,0.09050634999999999,0.03610533333333333,421200,25473,423283,completed
616,395914,1626,1,0-2,1,0.07064969999999998,0.028183999999999997,421200,25286,422826,completed
618,397777,2442,1,0-2,1,0.10610489999999997,0.042328,421200,23423,423642,completed
506,310957,43513,1,24-48,1,1.7871862944444443,0.7542253333333333,422557,111600,466070,completed
619,401332,598,1,0-2,1,0.025983099999999995,0.010365333333333332,422932,21600,423530,completed
620,403424,2839,1,0-2,1,0.09922305000000001,0.04920933333333333,425024,21600,427863,completed
621,403451,4464,1,0-2,1,0.15347398055555556,0.077376,425051,21600,429515,completed
622,405035,2416,1,0-2,1,0.08295455833333334,0.04187733333333333,426635,21600,429051,completed
510,315485,59282,1,24-48,1,2.078281936111111,1.0275546666666666,427085,111600,486367,completed
624,405535,1853,1,0-2,1,0.06342138333333333,0.03211866666666666,427135,21600,428988,completed
626,406633,1757,1,0-2,1,0.057781066666666665,0.030454666666666665,428233,21600,429990,completed
627,407223,358,3,0-2,3-4,0.03508698333333332,0.018615999999999997,428823,21600,429181,completed
628,407593,2038,1,0-2,1,0.06658032777777778,0.035325333333333334,429193,21600,431231,completed
630,409192,915,1,0-2,1,0.029892541666666668,0.01586,430792,21600,431707,completed
631,409309,2390,1,0-2,1,0.07462318888888889,0.04142666666666667,430909,21600,433299,completed
632,409943,1149,1,0-2,1,0.035695702777777776,0.019916,431543,21600,432692,completed
633,410282,490,1,0-2,1,0.01501809444444444,0.008493333333333334,431882,21600,432372,completed
635,412244,668,1,0-2,1,0.020045566666666667,0.011578666666666666,433844,21600,434512,completed
637,413292,6646,4,0-2,3-4,0.805786311111111,0.46078933333333333,434892,21600,441538,completed
590,383698,1159,1,6-12,1,0.033054036111111115,0.02008933333333333,435600,51902,436759,completed
592,383782,2438,1,6-12,1,0.06953040555555556,0.04225866666666667,435600,51818,438038,completed
593,383838,3600,1,12-24,1,0.10266999999999998,0.0624,435600,51762,439200,completed
595,385133,2698,1,6-12,1,0.07694546111111111,0.04676533333333333,435600,50467,438298,completed
601,391758,3600,1,6-12,1,0.10266999999999998,0.0624,435600,43842,439200,completed
602,391759,3600,1,6-12,1,0.10266999999999998,0.0624,435600,43841,439200,completed
617,396236,3600,1,2-6,1,0.10266999999999998,0.0624,435600,39364,439200,completed
623,405284,3600,4,2-6,3-4,0.41067999999999993,0.2496,435600,30316,439200,completed
625,405808,3600,1,6-12,1,0.10266999999999998,0.0624,435600,29792,439200,completed
629,408458,3600,1,6-12,1,0.10266999999999998,0.0624,435600,27142,439200,completed
634,410614,3600,1,12-24,1,0.10266999999999998,0.0624,435600,24986,439200,completed
636,412907,3600,1,6-12,1,0.10266999999999998,0.0624,435600,22693,439200,completed
638,413554,3600,3,2-6,3-4,0.3080099999999999,0.18719999999999998,435600,22046,439200,completed
639,413778,3600,3,2-6,3-4,0.3080099999999999,0.18719999999999998,435600,21822,439200,completed
640,414085,986,2,0-2,2,0.05624034444444443,0.034181333333333334,435600,21515,436586,completed
641,418588,303,1,0-2,1,0.008641391666666668,0.005252,435600,17012,435903,completed
642,419896,997,1,0-2,1,0.028433886111111105,0.017281333333333333,435600,15704,436597,completed
643,419991,404,2,0-2,2,0.023043711111111108,0.014005333333333333,435600,15609,436004,completed
644,422371,2306,3,0-2,3-4,0.19729751666666664,0.11991199999999999,435600,13229,437906,completed
645,422558,2588,3,0-2,3-4,0.2214249666666666,0.134576,435600,13042,438188,completed
646,423497,2521,1,0-2,1,0.07189751944444443,0.04369733333333333,435600,12103,438121,completed
647,423528,1144,2,0-2,2,0.06525248888888888,0.03965866666666666,435600,12072,436744,completed
648,423545,1307,1,0-2,1,0.037274913888888886,0.022654666666666667,435600,12055,436907,completed
649,423757,526,2,0-2,2,0.03000245555555555,0.018234666666666666,435600,11843,436126,completed
650,424544,381,2,0-2,2,0.021731816666666667,0.013208,435600,11056,435981,completed
651,425893,3600,4,0-2,3-4,0.41067999999999993,0.2496,435600,9707,439200,completed
652,426465,1353,1,0-2,1,0.03858680833333333,0.023451999999999997,435600,9135,436953,completed
653,426774,3333,4,0-2,3-4,0.38022123333333324,0.231088,435600,8826,438933,completed
654,426981,307,1,0-2,1,0.008755469444444445,0.005321333333333333,435600,8619,435907,completed
655,427090,317,1,0-2,1,0.00904066388888889,0.005494666666666666,435600,8510,435917,completed
656,427477,2467,1,0-2,1,0.07035746944444445,0.04276133333333333,435600,8123,438067,completed
657,427815,3600,1,12-24,1,0.10266999999999998,0.0624,435600,7785,439200,completed
658,427822,3219,1,0-2,1,0.09180409166666666,0.055796,435600,7778,438819,completed
659,428376,3600,1,2-6,1,0.10266999999999998,0.0624,435600,7224,439200,completed
660,430227,3600,1,0-2,1,0.10266999999999998,0.0624,435600,5373,439200,completed
661,430354,3600,1,2-6,1,0.10266999999999998,0.0624,435600,5246,439200,completed
662,430373,692,1,0-2,1,0.019735455555555552,0.011994666666666666,435600,5227,436292,completed
663,431480,627,1,0-2,1,0.017881691666666664,0.010868,435600,4120,436227,completed
664,432610,1929,1,0-2,1,0.05501400833333332,0.033436,435600,2990,437529,completed
665,433023,864,1,0-2,1,0.024640799999999994,0.014976,435600,2577,436464,completed
666,433508,467,1,0-2,1,0.013318580555555553,0.008094666666666667,435600,2092,436067,completed
667,434097,1629,2,0-2,2,0.09291634999999998,0.056471999999999994,435600,1503,437229,completed
668,434223,1156,1,0-2,1,0.03296847777777778,0.02003733333333333,435600,1377,436756,completed
669,435621,2253,1,0-2,1,0.06425430833333333,0.039051999999999996,435621,0,437874,completed
670,435684,3516,1,2-6,1,0.10027436666666664,0.060944,435684,0,439200,completed
671,435968,3232,1,24-48,1,0.09217484444444443,0.05602133333333333,435968,0,439200,completed
672,436141,2019,1,0-2,1,0.057580758333333315,0.034996,436141,0,438160,completed
673,436310,2890,1,24-48,1,0.08242119444444443,0.05009333333333333,436310,0,439200,completed
674,436808,2392,2,0-2,2,0.1364370222222222,0.08292266666666666,436808,0,439200,completed
675,437266,1070,1,0-2,1,0.030515805555555553,0.018546666666666666,437266,0,438336,completed
676,437419,1781,1,2-6,1,0.05079313055555554,0.030870666666666664,437419,0,439200,completed
677,437420,1780,1,2-6,1,0.050764611111111094,0.03085333333333333,437420,0,439200,completed
678,437421,1779,1,0-2,1,0.05073609166666665,0.030836,437421,0,439200,completed
679,437963,1237,1,0-2,1,0.03527855277777778,0.021441333333333333,437963,0,439200,completed
680,438455,734,1,0-2,1,0.02093327222222222,0.012722666666666665,438455,0,439189,completed
651,425893,1288,4,0-2,3-4,0.35420000000000007,0.08930133333333333,451093,25200,452381,completed
660,430227,923,1,0-2,1,0.03710972777777778,0.015998666666666665,455427,25200,456350,completed
540,345719,39066,1,24-48,1,1.4604081583333333,0.677144,457319,111600,496385,completed
712,460589,6294,1,0-2,1,0.1831797111111111,0.109096,460589,0,466883,completed
713,460604,3135,1,0-2,1,0.09567304444444444,0.05434,460604,0,463739,completed
714,460628,5984,1,0-2,1,0.1746722222222222,0.10372266666666666,460628,0,466612,completed
715,460628,4423,1,0-2,1,0.13262061666666666,0.07666533333333334,460628,0,465051,completed
716,460686,6662,1,0-2,1,0.19270414444444442,0.11547466666666666,460686,0,467348,completed
717,460715,2253,1,0-2,1,0.06873066111111112,0.039051999999999996,460715,0,462968,completed
674,436808,1112,2,0-2,2,0.06780728888888889,0.03854933333333333,460800,23992,461912,completed
678,437421,3932,1,0-2,1,0.11870371111111111,0.06815466666666667,460800,23379,464732,completed
679,437963,690,1,0-2,1,0.02103733333333333,0.011959999999999998,460800,22837,461490,completed
681,440612,1797,1,0-2,1,0.054788533333333334,0.031148,460800,20188,462597,completed
682,440936,412,1,0-2,1,0.012561422222222222,0.007141333333333333,460800,19864,461212,completed
683,442568,406,1,0-2,1,0.01237848888888889,0.007037333333333333,460800,18232,461206,completed
684,442624,3109,1,0-2,1,0.09478995555555556,0.05388933333333333,460800,18176,463909,completed
685,442640,538,1,0-2,1,0.016403022222222223,0.009325333333333333,460800,18160,461338,completed
686,443111,602,1,0-2,1,0.01835431111111111,0.010434666666666667,460800,17689,461402,completed
688,443523,1728,1,0-2,1,0.0526848,0.029952,460800,17277,462528,completed
687,443523,1718,1,0-2,1,0.05237991111111111,0.029778666666666665,460800,17277,462518,completed
689,443972,1229,1,0-2,1,0.03747084444444444,0.021302666666666664,460800,16828,462029,completed
690,444922,25200,1,24-48,1,0.6042,0.43679999999999997,460800,15878,486000,completed
691,445314,1868,1,0-2,1,0.05695324444444444,0.03237866666666667,460800,15486,462668,completed
692,445847,837,3,0-2,3-4,0.0765576,0.043524,460800,14953,461637,completed
693,445853,848,3,0-2,3-4,0.07756373333333333,0.044095999999999996,460800,14947,461648,completed
694,446058,4797,1,0-2,1,0.14200585000000002,0.083148,460800,14742,465597,completed
695,447822,1200,2,0-2,2,0.07317333333333334,0.0416,460800,12978,462000,completed
696,447885,341,1,0-2,1,0.010396711111111113,0.0059106666666666665,460800,12915,461141,completed
697,448159,3612,1,0-2,1,0.11008326666666665,0.062608,460800,12641,464412,completed
698,448851,8275,1,2-6,1,0.22984354166666662,0.14343333333333333,460800,11949,469075,completed
699,453071,2211,1,0-2,1,0.06741093333333334,0.038324,460800,7729,463011,completed
700,453099,2304,1,0-2,1,0.0702464,0.039936,460800,7701,463104,completed
701,453310,335,1,0-2,1,0.01021377777777778,0.005806666666666667,460800,7490,461135,completed
702,454092,7719,1,2-6,1,0.21789417499999997,0.133796,460800,6708,468519,completed
703,454284,2954,1,0-2,1,0.09006417777777778,0.05120266666666666,460800,6516,463754,completed
704,454832,2711,1,0-2,1,0.08265537777777777,0.04699066666666667,460800,5968,463511,completed
705,455077,2379,1,0-2,1,0.07253306666666667,0.041235999999999995,460800,5723,463179,completed
706,455316,6351,1,0-2,1,0.18386888333333332,0.11008399999999999,460800,5484,467151,completed
707,455728,4166,1,0-2,1,0.1250074111111111,0.07221066666666666,460800,5072,464966,completed
708,456107,3557,1,0-2,1,0.10844897777777777,0.06165466666666666,460800,4693,464357,completed
709,456119,3343,1,0-2,1,0.10192435555555554,0.05794533333333333,460800,4681,464143,completed
710,459385,354,1,0-2,1,0.010793066666666667,0.006136,460800,1415,461154,completed
711,459975,436,1,0-2,1,0.013293155555555556,0.007557333333333333,460800,825,461236,completed
718,461776,2299,1,0-2,1,0.07009395555555556,0.039849333333333334,461776,0,464075,completed
719,462130,316,1,0-2,1,0.00963448888888889,0.005477333333333333,462130,0,462446,completed
720,462575,7163,1,0-2,1,0.18997473888888886,0.12415866666666665,462575,0,469738,completed
721,463329,22671,1,12-24,1,0.5270935999999999,0.392964,463329,0,486000,completed
722,464114,8837,1,2-6,1,0.2114145527777777,0.15317466666666665,464114,0,472951,completed
723,464336,941,1,0-2,1,0.025576694444444437,0.016310666666666664,464336,0,465277,completed
593,383838,11030,1,12-24,1,0.25477644444444436,0.19118666666666664,464400,80562,475430,completed
601,391758,6234,1,6-12,1,0.15358904999999998,0.108056,464400,72642,470634,completed
602,391759,13210,1,6-12,1,0.30118622222222213,0.2289733333333333,464400,72641,477610,completed
617,396236,655,1,2-6,1,0.01764497222222222,0.011353333333333333,464400,68164,465055,completed
623,405284,9617,4,2-6,3-4,0.9002400111111108,0.6667786666666666,464400,59116,474017,completed
625,405808,19648,1,6-12,1,0.4401310222222221,0.34056533333333333,464400,58592,484048,completed
629,408458,21600,1,6-12,1,0.4944399999999999,0.37439999999999996,464400,55942,486000,completed
634,410614,21600,1,12-24,1,0.4944399999999999,0.37439999999999996,464400,53786,486000,completed
636,412907,17696,1,6-12,1,0.3885580444444443,0.30673066666666665,464400,51493,482096,completed
638,413554,9354,3,2-6,3-4,0.65862635,0.48640799999999995,464400,50846,473754,completed
639,413778,7202,3,2-6,3-4,0.5231758833333334,0.374504,464400,50622,471602,completed
657,427815,21600,1,12-24,1,0.4944399999999999,0.37439999999999996,464400,36585,486000,completed
659,428376,3980,1,2-6,1,0.10514683333333331,0.06898666666666667,464400,36024,468380,completed
661,430354,9645,1,2-6,1,0.22564745833333327,0.16718,464400,34046,474045,completed
670,435684,10270,1,2-6,1,0.2387603055555555,0.17801333333333333,464400,28716,474670,completed
671,435968,21600,1,24-48,1,0.4944399999999999,0.37439999999999996,464400,28432,486000,completed
673,436310,21600,1,24-48,1,0.4944399999999999,0.37439999999999996,464400,28090,486000,completed
676,437419,9019,1,2-6,1,0.2125136305555555,0.15632933333333332,464400,26981,473419,completed
677,437420,8357,1,2-6,1,0.1986245027777777,0.14485466666666666,464400,26980,472757,completed
724,464408,2405,1,0-2,1,0.06478802777777777,0.041686666666666664,464408,0,466813,completed
725,464720,21280,1,12-24,1,0.48581955555555545,0.3688533333333333,464720,0,486000,completed
726,464953,19471,3,6-12,3-4,1.3070849166666667,1.012492,464953,0,484424,completed
727,465314,597,1,0-2,1,0.016082516666666664,0.010348,465314,0,465911,completed
728,466051,4939,1,0-2,1,0.11676397777777778,0.08560933333333333,466051,0,470990,completed
729,466287,19713,1,12-24,1,0.44360631666666656,0.341692,466287,0,486000,completed
730,468030,395,1,0-2,1,0.008489208333333335,0.006846666666666666,468030,0,468425,completed
731,468496,12230,1,2-6,1,0.2551317333333333,0.21198666666666666,468496,0,480726,completed
732,468893,4396,1,0-2,1,0.0936141,0.07619733333333333,468893,0,473289,completed
733,469079,8143,1,2-6,1,0.17275662499999994,0.14114533333333332,469079,0,477222,completed
734,469125,6846,1,0-2,1,0.14513560833333333,0.11866399999999999,469125,0,475971,completed
735,469254,7922,1,2-6,1,0.16801629444444438,0.13731466666666667,469254,0,477176,completed
736,470119,441,1,0-2,1,0.009477824999999999,0.007644,470119,0,470560,completed
737,471382,3132,1,0-2,1,0.06582252222222222,0.054287999999999996,471382,0,474514,completed
738,471481,466,1,0-2,1,0.00983776111111111,0.008077333333333332,471481,0,471947,completed
739,471509,10363,1,2-6,1,0.2119476083333333,0.17962533333333333,471509,0,481872,completed
740,471603,9934,1,2-6,1,0.20362348055555549,0.17218933333333333,471603,0,481537,completed
741,472637,13363,1,6-12,1,0.2983331638888888,0.23162533333333332,472637,0,486000,completed
742,473453,6614,1,0-2,1,0.1371407861111111,0.11464266666666666,473453,0,480067,completed
743,473714,339,1,0-2,1,0.007112408333333334,0.005875999999999999,473714,0,474053,completed
744,473912,11968,1,2-6,1,0.26824428888888885,0.20744533333333331,473912,0,485880,completed
745,473957,8018,1,2-6,1,0.16247938611111107,0.13897866666666667,473957,0,481975,completed
746,474131,9171,1,2-6,1,0.19192385833333328,0.158964,474131,0,483302,completed
747,474179,5630,1,0-2,1,0.11705276944444444,0.09758666666666665,474179,0,479809,completed
748,474194,5875,1,0-2,1,0.12163183888888889,0.10183333333333333,474194,0,480069,completed
749,474356,2593,1,0-2,1,0.05494185555555556,0.04494533333333333,474356,0,476949,completed
750,475443,10557,1,2-6,1,0.23938679999999996,0.18298799999999998,475443,0,486000,completed
751,477147,1117,1,0-2,1,0.023779688888888886,0.01936133333333333,477147,0,478264,completed
752,477380,2366,1,0-2,1,0.04803604444444444,0.04101066666666667,477380,0,479746,completed
753,477565,4680,3,0-2,3-4,0.27340299999999995,0.24336,477565,0,482245,completed
754,478421,7579,1,6-12,1,0.17598848888888885,0.13136933333333334,478421,0,486000,completed
755,478464,2667,1,0-2,1,0.051027666666666666,0.046228,478464,0,481131,completed
756,478684,1211,1,0-2,1,0.023079844444444445,0.020990666666666664,478684,0,479895,completed
757,479080,906,1,0-2,1,0.017052933333333332,0.015704,479080,0,479986,completed
758,480378,3043,1,0-2,1,0.06646502222222221,0.05274533333333333,480378,0,483421,completed
759,480727,590,1,0-2,1,0.01110511111111111,0.010226666666666667,480727,0,481317,completed
760,480947,320,1,0-2,1,0.006023111111111111,0.005546666666666667,480947,0,481267,completed
761,481115,2727,1,0-2,1,0.0643062,0.047268,481115,0,483842,completed
762,481668,4332,1,2-6,1,0.11393786666666664,0.075088,481668,0,486000,completed
763,481730,368,1,0-2,1,0.006926577777777778,0.006378666666666666,481730,0,482098,completed
764,482734,323,1,0-2,1,0.008986577777777775,0.005598666666666667,482734,0,483057,completed
765,482981,3019,1,0-2,1,0.08399528888888888,0.05232933333333333,482981,0,486000,completed
766,483060,2940,1,0-2,1,0.08179733333333332,0.05096,483060,0,486000,completed
767,483123,2877,1,0-2,1,0.08004453333333332,0.049867999999999996,483123,0,486000,completed
768,483163,2837,1,0-2,1,0.07893164444444443,0.049174666666666665,483163,0,486000,completed
769,483249,2215,1,0-2,1,0.061626222222222214,0.03839333333333333,483249,0,485464,completed
770,483249,2180,1,0-2,1,0.06065244444444443,0.03778666666666666,483249,0,485429,completed
771,483895,487,1,0-2,1,0.013549422222222222,0.008441333333333334,483895,0,484382,completed
772,484508,820,1,0-2,1,0.022814222222222222,0.014213333333333333,484508,0,485328,completed
773,484810,1190,1,12-24,1,0.03310844444444444,0.020626666666666665,484810,0,486000,completed
774,485233,767,1,0-2,1,0.021339644444444444,0.013294666666666666,485233,0,486000,completed
765,482981,3134,1,0-2,1,0.3311506277777778,0.054322666666666665,507600,24619,510734,completed
766,483060,2677,1,0-2,1,0.2828622305555556,0.04640133333333333,507600,24540,510277,completed
767,483123,605,1,0-2,1,0.06392665277777777,0.010486666666666667,507600,24477,508205,completed
768,483163,3587,1,0-2,1,0.3790163694444445,0.06217466666666666,507600,24437,511187,completed
774,485233,4497,1,0-2,1,0.470172225,0.07794799999999999,507600,22367,512097,completed
775,486355,1569,2,0-2,2,0.33157328333333336,0.054391999999999996,507955,21600,509524,completed
776,486589,5160,1,0-2,1,0.533250961111111,0.08943999999999999,508189,21600,513349,completed
777,486726,4685,1,0-2,1,0.48494402499999995,0.08120666666666666,508326,21600,513011,completed
779,486727,3700,1,0-2,1,0.3863481611111111,0.06413333333333333,508327,21600,512027,completed
778,486727,2496,1,0-2,1,0.26373706666666663,0.043264,508327,21600,510823,completed
780,486847,4930,1,0-2,1,0.5087922444444444,0.08545333333333333,508447,21600,513377,completed
781,487038,4817,1,0-2,1,0.49641759166666655,0.08349466666666666,508638,21600,513455,completed
782,487215,2381,1,0-2,1,0.25158571944444447,0.041270666666666664,508815,21600,511196,completed
783,487563,3741,1,0-2,1,0.3857935416666666,0.064844,509163,21600,512904,completed
784,488133,2222,1,0-2,1,0.23057813333333332,0.03851466666666666,509733,21600,511955,completed
785,488135,1374,1,0-2,1,0.14518218333333333,0.023815999999999997,509735,21600,511109,completed
786,489061,4088,1,0-2,1,0.41217816111111094,0.07085866666666667,510661,21600,514749,completed
787,489961,3676,1,0-2,1,0.3635002027777776,0.06371733333333333,511561,21600,515237,completed
788,492376,1520,1,0-2,1,0.14507299999999992,0.026346666666666664,513976,21600,515496,completed
789,492381,1329,1,0-2,1,0.12784390833333328,0.023035999999999997,513981,21600,515310,completed
790,492906,573,1,0-2,1,0.05451989999999998,0.009932,514506,21600,515079,completed
791,492986,1532,1,0-2,1,0.13995907222222215,0.026554666666666664,514586,21600,516118,completed
792,493810,5892,1,0-2,1,0.5181104055555557,0.102128,515410,21600,521302,completed
793,493817,369,1,0-2,1,0.03318744999999999,0.006396,515417,21600,515786,completed
794,495028,324,1,0-2,1,0.02914019999999999,0.0056159999999999995,516628,21600,516952,completed
795,495122,1326,1,0-2,1,0.11925896666666663,0.022983999999999997,516722,21600,518048,completed
796,496028,528,1,0-2,1,0.04748773333333332,0.009151999999999999,517628,21600,518156,completed
797,496029,371,1,0-2,1,0.03336732777777777,0.006430666666666666,517629,21600,518000,completed
799,496346,1873,1,0-2,1,0.16268099722222223,0.03246533333333333,517946,21600,519819,completed
798,496346,715,1,0-2,1,0.06324418055555554,0.012393333333333333,517946,21600,518661,completed
800,497677,1375,4,0-2,3-4,0.4722819444444446,0.09533333333333333,519277,21600,520652,completed
801,498060,663,1,0-2,1,0.05693144166666668,0.011491999999999999,519660,21600,520323,completed
629,408458,1345,1,6-12,1,0.11549440277777781,0.023313333333333332,520058,111600,521403,completed
803,498897,5393,1,0-2,1,0.4049414972222223,0.09347866666666665,520497,21600,525890,completed
807,499432,1440,1,0-2,1,0.11663624444444447,0.02496,521032,21600,522472,completed
806,499432,1440,1,0-2,1,0.11663624444444447,0.02496,521032,21600,522472,completed
634,410614,29426,1,12-24,1,1.9470358111111112,0.5100506666666667,522214,111600,551640,completed
808,501578,837,1,0-2,1,0.05943164999999999,0.014507999999999998,523178,21600,524015,completed
811,503478,386,1,0-2,1,0.02740814444444444,0.006690666666666666,525078,21600,525464,completed
812,504375,424,1,0-2,1,0.02962111111111112,0.007349333333333333,525975,21600,526399,completed
813,504823,318,1,0-2,1,0.022215833333333337,0.0055119999999999995,526423,21600,526741,completed
815,506629,370,1,0-2,1,0.02584861111111112,0.0064133333333333325,528229,21600,528599,completed
817,508350,2908,3,0-2,3-4,0.7833348,0.151216,529950,21600,532858,completed
819,510136,751,3,0-2,3-4,0.2020315166666667,0.039051999999999996,531736,21600,532487,completed
820,512507,362,1,0-2,1,0.03461323333333334,0.006274666666666666,534107,21600,534469,completed
821,512558,1001,1,0-2,1,0.09571228333333336,0.017350666666666667,534158,21600,535159,completed
824,514004,1250,1,0-2,1,0.10974848333333334,0.021666666666666664,535604,21600,536854,completed
825,514288,439,1,0-2,1,0.04197571666666667,0.0076093333333333325,535888,21600,536327,completed
826,514434,2590,1,0-2,1,0.19977556666666665,0.044893333333333334,536034,21600,538624,completed
828,514729,2009,1,0-2,1,0.15037843333333328,0.03482266666666666,536329,21600,538338,completed
833,517015,2969,1,0-2,1,0.19990095833333332,0.051462666666666664,538615,21600,541584,completed
834,517512,3411,1,0-2,1,0.22074765,0.059123999999999996,539112,21600,542523,completed
657,427815,24060,1,12-24,1,0.7975713333333333,0.41703999999999997,539415,111600,563475,completed
835,518155,2057,2,0-2,2,0.2588789166666667,0.07130933333333334,539755,21600,541812,completed
836,518428,3211,1,0-2,1,0.19720891666666662,0.05565733333333333,540028,21600,543239,completed
837,518944,1151,2,0-2,2,0.14138116666666667,0.03990133333333333,540544,21600,541695,completed
838,519150,616,1,0-2,1,0.03783266666666667,0.010677333333333332,540750,21600,541366,completed
839,519674,4612,1,0-2,1,0.24947166666666665,0.07994133333333332,541274,21600,545886,completed
840,519914,1564,3,0-2,3-4,0.28816699999999995,0.081328,541514,21600,543078,completed
841,520326,497,1,0-2,1,0.03052408333333333,0.008614666666666666,541926,21600,542423,completed
842,520358,6891,2,0-2,2,0.6407563777777777,0.238888,541958,21600,548849,completed
847,523618,3491,1,0-2,1,0.13968674444444446,0.060510666666666664,545218,21600,548709,completed
850,524364,386,1,0-2,1,0.018002611111111108,0.006690666666666666,545964,21600,546350,completed
671,435968,62751,1,24-48,1,1.3622309166666666,1.0876839999999999,547200,111232,609951,completed
673,436310,36022,1,24-48,1,0.8231640666666667,0.6243813333333333,547200,110890,583222,completed
721,463329,6906,1,12-24,1,0.18994265,0.11970399999999999,547200,83871,554106,completed
725,464720,8543,1,12-24,1,0.22230834722222217,0.14807866666666666,547200,82480,555743,completed
729,466287,28865,1,12-24,1,0.6054800833333334,0.5003266666666666,547200,80913,576065,completed
741,472637,1209,1,6-12,1,0.03785513333333333,0.020956,547200,74563,548409,completed
750,475443,3654,1,2-6,1,0.11398134999999998,0.06333599999999999,547200,71757,550854,completed
754,478421,11573,1,6-12,1,0.2794927083333333,0.20059866666666665,547200,68779,558773,completed
762,481668,3381,1,2-6,1,0.10586286666666664,0.058603999999999996,547200,65532,550581,completed
773,484810,37733,1,12-24,1,0.8802544333333334,0.6540386666666667,547200,62390,584933,completed
852,526316,2013,1,0-2,1,0.06302926666666667,0.034892,547916,21600,549929,completed
851,526316,2013,1,0-2,1,0.06302926666666667,0.034892,547916,21600,549929,completed
853,527271,327,1,0-2,1,0.010238733333333333,0.005667999999999999,548871,21600,549198,completed
854,527644,3010,2,0-2,2,0.1653662111111111,0.10434666666666666,549244,21600,552254,completed
855,527705,3986,2,0-2,2,0.20999143888888888,0.13818133333333332,549305,21600,553291,completed
856,528365,522,1,0-2,1,0.0163444,0.009047999999999999,549965,21600,550487,completed
690,444922,28800,1,24-48,1,0.58685,0.4992,550800,105878,579600,completed
802,498681,16729,1,6-12,1,0.3250625916666666,0.2899693333333333,550800,52119,567529,completed
804,499358,10665,1,2-6,1,0.216686875,0.18486,550800,51442,561465,completed
805,499395,25200,1,24-48,1,0.49102999999999997,0.43679999999999997,550800,51405,576000,completed
809,502119,19242,3,6-12,3-4,1.1175234,1.000584,550800,48681,570042,completed
810,502276,9756,3,2-6,3-4,0.5994975,0.507312,550800,48524,560556,completed
857,529253,425,1,0-2,1,0.009927291666666666,0.007366666666666666,550853,21600,551278,completed
858,529999,1993,1,0-2,1,0.04655315833333334,0.03454533333333333,551599,21600,553592,completed
859,530296,1392,1,0-2,1,0.032514799999999996,0.024128,551896,21600,553288,completed
860,530929,452,1,0-2,1,0.010557966666666667,0.007834666666666667,552529,21600,552981,completed
861,530990,588,1,0-2,1,0.013734699999999999,0.010192,552590,21600,553178,completed
863,531498,6076,1,0-2,1,0.12053046666666667,0.10531733333333333,553098,21600,559174,completed
864,531848,4988,1,0-2,1,0.09867129999999999,0.08645866666666666,553448,21600,558436,completed
865,531876,2708,1,0-2,1,0.05545432222222222,0.04693866666666666,553476,21600,556184,completed
866,532405,5806,1,0-2,1,0.1111555,0.10063733333333333,554005,21600,559811,completed
867,532523,474,1,0-2,1,0.010210522222222221,0.008216,554123,21600,554597,completed
814,506319,10165,1,2-6,1,0.18778640277777778,0.1761933333333333,554400,48081,564565,completed
816,506994,8529,1,2-6,1,0.15871559166666668,0.147836,554400,47406,562929,completed
818,509251,11150,1,2-6,1,0.20536708333333334,0.19326666666666664,554400,45149,565550,completed
822,512565,21600,2,12-24,2,0.81388,0.7487999999999999,554400,41835,576000,completed
823,513256,9385,1,2-6,1,0.17392623611111113,0.16267333333333334,554400,41144,563785,completed
827,514520,21600,1,12-24,1,0.40694,0.37439999999999996,554400,39880,576000,completed
829,516896,15194,1,6-12,1,0.27955237777777775,0.26336266666666663,554400,37504,569594,completed
830,516902,21600,1,6-12,1,0.40694,0.37439999999999996,554400,37498,576000,completed
831,516905,21600,1,6-12,1,0.40694,0.37439999999999996,554400,37495,576000,completed
832,516905,21600,1,6-12,1,0.40694,0.37439999999999996,554400,37495,576000,completed
843,521397,18000,2,6-12,2,0.67016,0.624,554400,33003,572400,completed
844,522066,18000,1,6-12,1,0.33508,0.312,554400,32334,572400,completed
846,523038,7690,1,2-6,1,0.1438070277777778,0.13329333333333332,554400,31362,562090,completed
845,523038,8474,1,2-6,1,0.15773827222222223,0.14688266666666666,554400,31362,562874,completed
848,523638,14400,1,6-12,1,0.26383999999999996,0.2496,554400,30762,568800,completed
849,523968,14400,1,12-24,1,0.26383999999999996,0.2496,554400,30432,568800,completed
868,533602,385,1,0-2,1,0.007309652777777778,0.006673333333333333,555202,21600,555587,completed
869,534048,5323,1,0-2,1,0.09974262500000002,0.09226533333333332,555648,21600,560971,completed
870,534821,512,1,0-2,1,0.009720888888888888,0.008874666666666666,556421,21600,556933,completed
871,535693,324,1,0-2,1,0.0061515,0.0056159999999999995,557293,21600,557617,completed
872,536608,2396,1,0-2,1,0.044425833333333345,0.04153066666666667,558208,21600,560604,completed
873,537504,599,1,0-2,1,0.011106458333333336,0.010382666666666667,559104,21600,559703,completed
875,538135,1005,1,0-2,1,0.018634375000000005,0.017419999999999998,559735,21600,560740,completed
876,538255,3544,1,0-2,1,0.0643224388888889,0.06142933333333333,559855,21600,563399,completed
877,539665,3518,1,0-2,1,0.0627716,0.06097866666666666,561265,21600,564783,completed
878,539739,2253,1,0-2,1,0.04023610833333333,0.039051999999999996,561339,21600,563592,completed
879,539819,3923,1,0-2,1,0.06988085833333334,0.06799866666666667,561419,21600,565342,completed
862,531146,7200,1,12-24,1,0.12874,0.1248,561600,30454,568800,completed
880,540472,1845,1,0-2,1,0.032784625,0.03198,562072,21600,563917,completed
881,540669,6379,2,0-2,2,0.22823501666666662,0.22113866666666665,562269,21600,568648,completed
882,540789,375,1,0-2,1,0.006663541666666667,0.0065,562389,21600,562764,completed
883,540864,1451,1,0-2,1,0.025783463888888886,0.025150666666666665,562464,21600,563915,completed
884,541076,476,1,0-2,1,0.008458255555555554,0.008250666666666667,562676,21600,563152,completed
885,541082,1024,1,0-2,1,0.018195911111111112,0.017749333333333332,562682,21600,563706,completed
886,541102,1323,1,0-2,1,0.023508974999999998,0.022931999999999998,562702,21600,564025,completed
887,541251,6174,2,0-2,2,0.22192584999999998,0.214032,562851,21600,569025,completed
888,541601,379,1,0-2,1,0.006734619444444444,0.006569333333333333,563201,21600,563580,completed
889,541868,6990,1,0-2,1,0.12835665555555556,0.12115999999999999,563468,21600,570458,completed
890,542175,3710,1,0-2,1,0.06643241666666666,0.06430666666666666,563775,21600,567485,completed
891,543242,2281,1,0-2,1,0.04095943611111111,0.039537333333333334,564842,21600,567123,completed
892,543534,7091,1,0-2,1,0.13371972777777777,0.12291066666666665,565134,21600,572225,completed
893,544088,682,1,0-2,1,0.012270316666666666,0.011821333333333333,565688,21600,566370,completed
894,544656,2135,1,0-2,1,0.038412208333333336,0.03700666666666667,566256,21600,568391,completed
895,544734,1495,1,0-2,1,0.026897541666666667,0.025913333333333333,566334,21600,567829,completed
896,544759,2814,1,0-2,1,0.05129891388888889,0.048776,566359,21600,569173,completed
897,544760,4814,1,0-2,1,0.09087848888888889,0.08344266666666666,566360,21600,571174,completed
898,544761,2499,1,0-2,1,0.04506900833333333,0.043316,566361,21600,568860,completed
899,544762,4072,1,0-2,1,0.07619872777777778,0.07058133333333333,566362,21600,570434,completed
900,545059,2631,1,0-2,1,0.04821671388888889,0.045604,566659,21600,569290,completed
901,545083,2932,1,0-2,1,0.05421630277777778,0.05082133333333333,566683,21600,569615,completed
902,545595,459,1,0-2,1,0.008258175,0.007956,567195,21600,567654,completed
903,546580,5932,1,0-2,1,0.11656825555555556,0.10282133333333332,568180,21600,574112,completed
904,546580,399,1,0-2,1,0.007178674999999999,0.006915999999999999,568180,21600,568579,completed
906,547282,2340,1,0-2,1,0.046306,0.04056,568882,21600,571222,completed
907,547596,372,1,0-2,1,0.007361466666666667,0.006448,569196,21600,569568,completed
909,548256,391,1,0-2,1,0.007737455555555557,0.006777333333333333,569856,21600,570247,completed
911,548275,433,1,0-2,1,0.008568588888888888,0.007505333333333333,569875,21600,570308,completed
910,548275,332,1,0-2,1,0.006569911111111112,0.005754666666666667,569875,21600,570207,completed
913,548929,4635,1,0-2,1,0.09219752222222223,0.08034,570529,21600,575164,completed
914,549308,440,1,0-2,1,0.008707111111111112,0.007626666666666666,570908,21600,571348,completed
915,549311,1393,1,0-2,1,0.027565922222222226,0.02414533333333333,570911,21600,572304,completed
916,549422,439,1,0-2,1,0.008687322222222224,0.0076093333333333325,571022,21600,571461,completed
917,549829,2527,1,0-2,1,0.0502745,0.04380133333333333,571429,21600,573956,completed
919,550528,504,1,0-2,1,0.010013555555555557,0.008735999999999999,572128,21600,572632,completed
920,550914,419,1,0-2,1,0.008363705555555555,0.007262666666666666,572514,21600,572933,completed
921,551813,915,1,0-2,1,0.018264416666666672,0.01586,573413,21600,574328,completed
923,553006,529,1,0-2,1,0.01055942777777778,0.009169333333333333,574606,21600,575135,completed
924,553515,361,1,0-2,1,0.007205961111111112,0.006257333333333333,575115,21600,575476,completed
925,556872,2013,1,0-2,1,0.06022668333333334,0.034892,578472,21600,580485,completed
928,561746,2752,1,0-2,1,0.09182506666666665,0.04770133333333333,583346,21600,586098,completed
929,563199,6351,3,0-2,3-4,0.5481851000000001,0.330252,584799,21600,591150,completed
930,563480,6074,3,0-2,3-4,0.5203168666666667,0.31584799999999996,585080,21600,591154,completed
931,563510,5571,3,0-2,3-4,0.48658463333333335,0.289692,585110,21600,590681,completed
690,444922,32182,1,24-48,1,0.5496485555555555,0.5578213333333333,585322,140400,617504,completed
933,564056,3600,1,0-2,1,0.10620266666666668,0.0624,585656,21600,589256,completed
935,564502,583,1,0-2,1,0.019452766666666666,0.010105333333333332,586102,21600,586685,completed
936,565085,353,4,0-2,3-4,0.041719066666666665,0.024474666666666665,586685,21600,587038,completed
937,565203,741,2,0-2,2,0.0410514,0.025688,586803,21600,587544,completed
938,565301,515,1,0-2,1,0.014265500000000004,0.008926666666666666,586901,21600,587416,completed
939,566190,415,1,0-2,1,0.011495500000000002,0.007193333333333333,587790,21600,588205,completed
940,566512,4791,1,0-2,1,0.11758145555555558,0.08304399999999999,588112,21600,592903,completed
941,566703,512,1,0-2,1,0.014182400000000005,0.008874666666666666,588303,21600,588815,completed
942,566770,826,1,0-2,1,0.022880200000000003,0.014317333333333333,588370,21600,589196,completed
943,566787,1604,1,0-2,1,0.04443080000000001,0.027802666666666667,588387,21600,589991,completed
944,566820,4254,1,0-2,1,0.10409073333333332,0.073736,588420,21600,592674,completed
946,567328,4133,1,0-2,1,0.09839983333333334,0.07163866666666666,588928,21600,593061,completed
945,567328,3773,1,0-2,1,0.09060383333333333,0.06539866666666666,588928,21600,592701,completed
947,567571,406,1,0-2,1,0.011246200000000001,0.007037333333333333,589171,21600,589577,completed
948,567824,4389,1,0-2,1,0.1009456111111111,0.07607599999999999,589424,21600,593813,completed
949,568504,2259,1,0-2,1,0.05070905555555555,0.039155999999999996,590104,21600,592363,completed
805,499395,34749,1,24-48,1,0.480375525,0.602316,590400,91005,625149,completed
950,569046,1178,1,0-2,1,0.025510244444444444,0.020418666666666665,590646,21600,591824,completed
951,570550,2396,1,0-2,1,0.05180329444444444,0.04153066666666667,592150,21600,594546,completed
952,572123,6328,1,0-2,1,0.13449151388888886,0.10968533333333333,593723,21600,600051,completed
954,573933,540,1,0-2,1,0.011611499999999997,0.00936,595533,21600,596073,completed
955,574081,1054,1,0-2,1,0.02266392777777778,0.018269333333333332,595681,21600,596735,completed
956,575624,3029,1,0-2,1,0.06337798611111109,0.05250266666666666,597224,21600,600253,completed
822,512565,16290,2,12-24,2,0.4142445,0.56472,597600,85035,613890,completed
827,514520,26570,1,12-24,1,0.3142338055555556,0.46054666666666666,597600,83080,624170,completed
830,516902,1646,1,6-12,1,0.01636855555555556,0.028530666666666666,601200,84298,602846,completed
832,516905,2362,1,6-12,1,0.023488777777777782,0.04094133333333333,601200,84295,603562,completed
831,516905,2713,1,6-12,1,0.026979277777777783,0.04702533333333333,601200,84295,603913,completed
843,521397,4900,2,6-12,2,0.09851000000000001,0.16986666666666667,601200,79803,606100,completed
844,522066,5418,1,6-12,1,0.05461630000000001,0.093912,601200,79134,606618,completed
848,523638,4664,1,6-12,1,0.04681240000000001,0.08084266666666666,601200,77562,605864,completed
849,523968,35249,1,12-24,1,0.3760872111111111,0.6109826666666667,601200,77232,636449,completed
862,531146,40209,1,12-24,1,0.434448,0.6969559999999999,601200,70054,641409,completed
874,537967,13163,2,2-6,2,0.2745615944444445,0.4563173333333333,601200,63233,614363,completed
905,547107,21600,1,24-48,1,0.22413,0.37439999999999996,601200,54093,622800,completed
908,547988,19070,1,6-12,1,0.1983591388888889,0.33054666666666666,601200,53212,620270,completed
912,548703,9667,1,2-6,1,0.09930613888888891,0.1675613333333333,601200,52497,610867,completed
918,549857,21600,3,12-24,3-4,0.67239,1.1232,601200,51343,622800,completed
922,552459,7312,1,2-6,1,0.07425155555555558,0.12674133333333332,601200,48741,608512,completed
926,558454,9816,1,2-6,1,0.10089133333333336,0.170144,601200,42746,611016,completed
927,559836,19599,2,6-12,2,0.40749518333333334,0.6794319999999999,601200,41364,620799,completed
932,563537,12418,1,2-6,1,0.12910856111111113,0.21524533333333332,601200,37663,613618,completed
934,564065,21600,1,12-24,1,0.22413,0.37439999999999996,601200,37135,622800,completed
953,573403,21600,1,6-12,1,0.22413,0.37439999999999996,601200,27797,622800,completed
958,577971,19987,1,6-12,1,0.20769980277777778,0.3464413333333333,601200,23229,621187,completed
957,577971,19329,1,6-12,1,0.20099734166666666,0.335036,601200,23229,620529,completed
959,578713,21600,1,6-12,1,0.22413,0.37439999999999996,601200,22487,622800,completed
960,580739,19605,2,6-12,2,0.4076174166666667,0.6796399999999999,601200,20461,620805,completed
961,580898,538,1,0-2,1,0.005350111111111112,0.009325333333333333,601200,20302,601738,completed
962,581833,2111,1,0-2,1,0.020992722222222225,0.03659066666666667,601200,19367,603311,completed
963,581922,2523,1,0-2,1,0.02508983333333334,0.043732,601200,19278,603723,completed
964,581947,4304,1,0-2,1,0.04308640000000001,0.07460266666666666,601200,19253,605504,completed
965,581956,833,1,0-2,1,0.008283722222222224,0.014438666666666666,601200,19244,602033,completed
966,581982,2645,1,0-2,1,0.02630305555555556,0.04584666666666666,601200,19218,603845,completed
967,582126,18270,1,6-12,1,0.19021025,0.31667999999999996,601200,19074,619470,completed
968,584260,388,1,0-2,1,0.0038584444444444456,0.006725333333333333,601200,16940,601588,completed
969,584702,413,1,0-2,1,0.0041070555555555565,0.0071586666666666665,601200,16498,601613,completed
970,589544,987,4,0-2,3-4,0.03926066666666668,0.06843199999999999,601200,11656,602187,completed
971,590377,10800,1,6-12,1,0.11136000000000001,0.18719999999999998,601200,10823,612000,completed
972,592077,2624,3,0-2,3-4,0.07828266666666667,0.13644799999999999,601200,9123,603824,completed
973,592165,10800,1,6-12,1,0.11136000000000001,0.18719999999999998,601200,9035,612000,completed
974,592202,10800,1,6-12,1,0.11136000000000001,0.18719999999999998,601200,8998,612000,completed
975,593689,304,1,0-2,1,0.003023111111111112,0.005269333333333333,601200,7511,601504,completed
976,595221,2462,1,0-2,1,0.02448322222222223,0.042674666666666666,601200,5979,603662,completed
977,595666,6509,1,0-2,1,0.06590815000000003,0.11282266666666665,601200,5534,607709,completed
978,595697,10800,2,24-48,2,0.22272000000000003,0.37439999999999996,601200,5503,612000,completed
979,595700,10800,2,24-48,2,0.22272000000000003,0.37439999999999996,601200,5500,612000,completed
980,595822,6976,1,0-2,1,0.07074160000000002,0.12091733333333332,601200,5378,608176,completed
981,597081,4002,1,0-2,1,0.03996070000000001,0.069368,601200,4119,605202,completed
982,597909,2195,1,0-2,1,0.02182805555555556,0.038046666666666666,601200,3291,603395,completed
983,599093,5418,1,0-2,1,0.05461630000000001,0.093912,601200,2107,606618,completed
984,599134,2175,1,0-2,1,0.02162916666666667,0.0377,601200,2066,603375,completed
985,599824,10800,1,12-24,1,0.11136000000000001,0.18719999999999998,601200,1376,612000,completed
986,599889,452,1,0-2,1,0.004494888888888889,0.007834666666666667,601200,1311,601652,completed
987,600414,2034,1,0-2,1,0.020227000000000002,0.035255999999999996,601200,786,603234,completed
988,600462,404,1,0-2,1,0.004017555555555556,0.007002666666666667,601200,738,601604,completed
989,600706,2141,1,0-2,1,0.02129105555555556,0.03711066666666667,601200,494,603341,completed
990,601074,8839,1,2-6,1,0.09049713888888891,0.15320933333333334,601200,126,610039,completed
992,601076,6109,1,0-2,1,0.061768150000000015,0.10588933333333332,601200,124,607309,completed
991,601076,6685,1,0-2,1,0.06772975000000002,0.11587333333333333,601200,124,607885,completed
993,601528,490,1,0-2,1,0.004872777777777779,0.008493333333333334,601528,0,602018,completed
994,601792,486,1,0-2,1,0.0048330000000000005,0.008424,601792,0,602278,completed
995,602292,315,1,0-2,1,0.0031325000000000007,0.00546,602292,0,602607,completed
996,603249,1139,1,0-2,1,0.011326722222222224,0.019742666666666665,603249,0,604388,completed
997,603325,337,1,0-2,1,0.0033512777777777785,0.005841333333333333,603325,0,603662,completed
998,603393,662,1,0-2,1,0.006583222222222224,0.011474666666666666,603393,0,604055,completed
999,604756,1361,1,0-2,1,0.014068505555555558,0.023590666666666666,604756,0,606117,completed
971,590377,7035,1,6-12,1,0.07159929166666668,0.12193999999999999,615600,25223,622635,completed
973,592165,7200,1,6-12,1,0.07328,0.1248,615600,23435,622800,completed
974,592202,7200,1,6-12,1,0.07328,0.1248,615600,23398,622800,completed
978,595697,7200,2,24-48,2,0.14656,0.2496,615600,19903,622800,completed
979,595700,7200,2,24-48,2,0.14656,0.2496,615600,19900,622800,completed
985,599824,7200,1,12-24,1,0.07328,0.1248,615600,15776,622800,completed
905,547107,3600,1,24-48,1,0.039430000000000014,0.0624,630000,82893,633600,completed
918,549857,3600,3,12-24,3-4,0.11829000000000003,0.18719999999999998,630000,80143,633600,completed
934,564065,3600,1,12-24,1,0.039430000000000014,0.0624,630000,65935,633600,completed
953,573403,3239,1,6-12,1,0.03547604722222224,0.05614266666666666,630000,56597,633239,completed
959,578713,3600,1,6-12,1,0.039430000000000014,0.0624,630000,51287,633600,completed
973,592165,3600,1,6-12,1,0.039430000000000014,0.0624,630000,37835,633600,completed
974,592202,3600,1,6-12,1,0.039430000000000014,0.0624,630000,37798,633600,completed
978,595697,3600,2,24-48,2,0.07886000000000003,0.1248,630000,34303,633600,completed
979,595700,3600,2,24-48,2,0.07886000000000003,0.1248,630000,34300,633600,completed
985,599824,3600,1,12-24,1,0.039430000000000014,0.0624,630000,30176,633600,completed
905,547107,117512,1,24-48,1,2.5523122305555557,2.0368746666666664,658707,111600,776219,completed
918,549857,5477,3,12-24,3-4,0.2661942666666666,0.284804,661457,111600,666934,completed
934,564065,3600,1,12-24,1,0.03925999999999999,0.0624,673200,109135,676800,completed
959,578713,73,1,6-12,1,0.0007961055555555555,0.0012653333333333332,673200,94487,673273,completed
973,592165,3344,1,6-12,1,0.03646817777777777,0.05796266666666666,673200,81035,676544,completed
974,592202,2556,1,6-12,1,0.0278746,0.044303999999999996,673200,80998,675756,completed
978,595697,3600,2,24-48,2,0.07851999999999998,0.1248,673200,77503,676800,completed
979,595700,3600,2,24-48,2,0.07851999999999998,0.1248,673200,77500,676800,completed
985,599824,3600,1,12-24,1,0.03925999999999999,0.0624,673200,73376,676800,completed
934,564065,23316,1,12-24,1,0.2615085805555556,0.40414399999999995,679265,115200,702581,completed
978,595697,14400,2,24-48,2,0.30188000000000004,0.4992,687600,91903,702000,completed
979,595700,14400,2,24-48,2,0.30188000000000004,0.4992,687600,91900,702000,completed
985,599824,13149,1,12-24,1,0.13797477500000002,0.22791599999999998,687600,87776,700749,completed
978,595697,59610,2,24-48,2,3.989645200000001,2.06648,721697,126000,781307,completed
979,595700,59642,2,24-48,2,3.9930706888888885,2.0675893333333333,721700,126000,781342,completed
-1,0,0,0,0,0,0.0,0.0,0,0,0,0
