ID,arrival_time,length,cpus,length_class,resource_class,carbon_cost,dollar_cost,start_time,waiting_time,exit_time,reason
0,0,720,1,0-2,1,0.09614,0.0,0,0,720,completed
1,13,200,1,0-2,1,0.02670555555555556,0.0,13,0,213,completed
2,92,314,3,0-2,3-4,0.12578316666666667,0.0,92,0,406,completed
3,167,389,1,0-2,1,0.051942305555555554,0.0,167,0,556,completed
4,397,133,1,0-2,1,0.017759194444444446,0.0,397,0,530,completed
6,523,125,2,0-2,2,0.03338194444444444,0.0,523,0,648,completed
5,523,125,2,0-2,2,0.03338194444444444,0.0,523,0,648,completed
7,587,8773,1,12-24,1,1.0547591944444445,0.0,587,0,9360,completed
8,601,2649,1,2-6,1,0.37825577777777775,0.0,601,0,3250,completed
9,810,412,3,0-2,3-4,0.1701731666666667,0.0,810,0,1222,completed
12,1284,1104,1,0-2,1,0.15649966666666665,0.0,1284,0,2388,completed
25,3134,9106,2,12-24,2,2.759922611111111,0.0,3134,0,12240,completed
8,601,5760,1,6-12,1,0.6200000000000001,0.0,3600,2999,9360,completed
36,4712,4648,1,6-12,1,0.45395344444444446,0.0,4712,0,9360,completed
0,0,540,1,0-2,1,0.05213999999999999,0.0,5040,5040,5580,completed
3,167,4320,1,6-12,1,0.40689,0.0,5040,4873,9360,completed
9,810,4320,3,6-12,3-4,1.22067,1.1232,5040,4230,9360,completed
10,958,350,2,0-2,2,0.06758888888888889,0.0,5040,4082,5390,completed
11,1159,281,1,0-2,1,0.02713211111111111,0.024353333333333334,5040,3881,5321,completed
12,1284,4320,1,6-12,1,0.40689,0.3744,5040,3756,9360,completed
21,2555,508,1,0-2,1,0.04905022222222221,0.044026666666666665,5040,2485,5548,completed
41,5540,3820,1,6-12,1,0.3586122222222223,0.0,5540,0,9360,completed
11,1159,284,1,0-2,1,0.022124388888888884,0.0,5760,4601,6044,completed
13,1389,2434,2,2-6,2,0.4159552777777778,0.42189333333333334,5760,4371,8194,completed
14,1515,408,1,0-2,1,0.03178433333333333,0.0,5760,4245,6168,completed
16,1725,222,1,0-2,1,0.017294416666666663,0.01924,5760,4035,5982,completed
15,1725,222,1,0-2,1,0.017294416666666663,0.01924,5760,4035,5982,completed
17,1997,1667,1,2-6,1,0.13811970833333334,0.14447333333333334,5760,3763,7427,completed
18,2096,83,1,0-2,1,0.006465930555555554,0.007193333333333334,5760,3664,5843,completed
19,2253,494,1,0-2,1,0.03848397222222222,0.042813333333333335,5760,3507,6254,completed
20,2299,112,1,0-2,1,0.00872511111111111,0.009706666666666667,5760,3461,5872,completed
21,2555,2880,1,2-6,1,0.24883000000000002,0.24960000000000002,5760,3205,8640,completed
22,2660,97,1,0-2,1,0.007556569444444443,0.008406666666666666,5760,3100,5857,completed
23,2887,183,4,0-2,3-4,0.057024833333333316,0.06344,5760,2873,5943,completed
24,3055,65,1,0-2,1,0.005063680555555555,0.005633333333333333,5760,2705,5825,completed
26,3178,74,1,0-2,1,0.005764805555555554,0.006413333333333333,5760,2582,5834,completed
27,3179,68,1,0-2,1,0.005297388888888887,0.005893333333333334,5760,2581,5828,completed
28,3284,2472,1,2-6,1,0.21145833333333336,0.21424,5760,2476,8232,completed
29,3291,95,2,0-2,2,0.014801527777777771,0.016466666666666668,5760,2469,5855,completed
30,3349,704,1,0-2,1,0.05484355555555555,0.061013333333333336,5760,2411,6464,completed
31,3487,285,3,0-2,3-4,0.06660687499999998,0.0741,5760,2273,6045,completed
32,3505,2215,1,2-6,1,0.1879178472222222,0.19196666666666667,5760,2255,7975,completed
33,4268,61,1,0-2,1,0.0047520694444444424,0.005286666666666667,5760,1492,5821,completed
34,4465,709,1,0-2,1,0.055233069444444435,0.06144666666666667,5760,1295,6469,completed
35,4543,2548,1,2-6,1,0.21841972222222222,0.22082666666666667,5760,1217,8308,completed
37,4901,471,2,0-2,2,0.07338441666666666,0.08164,5760,859,6231,completed
39,5372,118,2,0-2,2,0.01838505555555555,0.020453333333333334,5760,388,5878,completed
38,5372,118,2,0-2,2,0.01838505555555555,0.020453333333333334,5760,388,5878,completed
40,5375,67,4,0-2,3-4,0.02087794444444444,0.023226666666666666,5760,385,5827,completed
42,6242,427,1,0-2,1,0.03466361111111111,0.0,6242,0,6669,completed
43,6624,320,2,0-2,2,0.05459555555555557,0.055466666666666664,6624,0,6944,completed
44,6646,707,1,0-2,1,0.06115040277777779,0.0,6646,0,7353,completed
45,6666,2386,1,2-6,1,0.22753772222222224,0.20678666666666667,6666,0,9052,completed
46,6676,2684,1,2-6,1,0.2645601111111111,0.0,6676,0,9360,completed
47,6699,67,2,0-2,2,0.011430944444444447,0.011613333333333333,6699,0,6766,completed
48,6819,2541,1,2-6,1,0.25236141666666667,0.22022,6819,0,9360,completed
49,6921,77,1,0-2,1,0.006568527777777779,0.006673333333333333,6921,0,6998,completed
50,7474,4046,4,6-12,3-4,2.5806923333333334,1.4026133333333333,7474,0,11520,completed
51,7487,296,1,0-2,1,0.026874333333333333,0.0,7487,0,7783,completed
52,7691,88,3,0-2,3-4,0.023969000000000004,0.02288,7691,0,7779,completed
53,7879,1481,1,2-6,1,0.15821245833333336,0.0,7879,0,9360,completed
54,7991,77,1,0-2,1,0.00705298611111111,0.006673333333333333,7991,0,8068,completed
55,8059,2741,1,2-6,1,0.4175379861111111,0.23755333333333334,8059,0,10800,completed
56,8115,2610,1,2-6,1,0.39681479166666667,0.2262,8115,0,10725,completed
57,8139,1221,1,0-2,1,0.13443020833333336,0.10582,8139,0,9360,completed
58,8157,1923,1,2-6,1,0.25886145833333335,0.16666,8157,0,10080,completed
59,8170,69,1,0-2,1,0.006320208333333332,0.00598,8170,0,8239,completed
60,8215,254,1,0-2,1,0.023265694444444443,0.022013333333333333,8215,0,8469,completed
61,8229,1131,1,0-2,1,0.12618645833333333,0.09802,8229,0,9360,completed
62,8277,2523,1,2-6,1,0.3975697916666666,0.21866,8277,0,10800,completed
63,8304,2496,1,2-6,1,0.39509666666666665,0.21632,8304,0,10800,completed
64,8680,1391,1,0-2,1,0.20812511111111112,0.12055333333333333,8680,0,10071,completed
65,8791,569,1,0-2,1,0.06997119444444445,0.049313333333333334,8791,0,9360,completed
66,9037,1763,1,2-6,1,0.31550002777777775,0.15279333333333334,9037,0,10800,completed
67,9049,786,1,0-2,1,0.12142213888888888,0.06812,9049,0,9835,completed
68,9224,2296,1,2-6,1,0.4669142222222222,0.19898666666666667,9224,0,11520,completed
69,9287,328,1,0-2,1,0.05363030555555555,0.028426666666666666,9287,0,9615,completed
70,9317,2203,1,2-6,1,0.4554778055555555,0.19092666666666666,9317,0,11520,completed
71,9334,2186,1,2-6,1,0.45338727777777765,0.18945333333333333,9334,0,11520,completed
72,9366,756,1,0-2,1,0.1337618333333333,0.0,9366,0,10122,completed
73,9461,1339,1,0-2,1,0.25809377777777776,0.0,9461,0,10800,completed
74,9486,131,1,0-2,1,0.022939555555555553,0.0,9486,0,9617,completed
75,9489,1336,1,0-2,1,0.25924656944444435,0.0,9489,0,10825,completed
76,9583,85,1,0-2,1,0.01488444444444444,0.0,9583,0,9668,completed
77,9585,69,1,0-2,1,0.012082666666666662,0.0,9585,0,9654,completed
78,9614,117,1,0-2,1,0.020488000000000003,0.0,9614,0,9731,completed
79,9665,667,1,0-2,1,0.1250661111111111,0.0,9665,0,10332,completed
80,9670,1169,3,0-2,3-4,0.6928282916666666,0.30394,9670,0,10839,completed
81,9793,1007,1,0-2,1,0.19995688888888885,0.0,9793,0,10800,completed
82,9840,960,1,0-2,1,0.19172666666666663,0.0,9840,0,10800,completed
83,10187,1333,1,0-2,1,0.3018629166666666,0.0,10187,0,11520,completed
85,10387,1133,2,0-2,2,0.5205591666666666,0.0,10387,0,11520,completed
86,10396,1124,1,0-2,1,0.25840833333333324,0.09741333333333334,10396,0,11520,completed
87,10457,1063,1,0-2,1,0.2457254166666666,0.09212666666666666,10457,0,11520,completed
88,10477,1763,1,2-6,1,0.4785970833333333,0.15279333333333334,10477,0,12240,completed
89,11103,302,1,0-2,1,0.07315530555555554,0.0,11103,0,11405,completed
90,11213,175,1,0-2,1,0.04239131944444443,0.0,11213,0,11388,completed
91,11404,79,1,0-2,1,0.019136652777777766,0.0,11404,0,11483,completed
92,11435,85,1,0-2,1,0.020590069444444435,0.0,11435,0,11520,completed
25,3134,2880,2,2-6,2,1.7198599999999997,0.0,12960,9826,15840,completed
88,10477,2880,1,2-6,1,0.8599299999999999,0.0,12960,2483,15840,completed
86,10396,260,1,0-2,1,0.0810875,0.0,13680,3284,13940,completed
50,7474,922,4,0-2,3-4,0.9743404444444443,0.0,14400,6926,15322,completed
68,9224,720,1,0-2,1,0.18707,0.0,14400,5176,15120,completed
70,9317,912,1,0-2,1,0.2407873333333333,0.0,14400,5083,15312,completed
71,9334,1389,1,0-2,1,0.3742413333333333,0.12038,14400,5066,15789,completed
83,10187,720,1,0-2,1,0.18707,0.062400000000000004,14400,4213,15120,completed
85,10387,185,2,0-2,2,0.09613319444444443,0.03206666666666667,14400,4013,14585,completed
86,10396,1440,1,0-2,1,0.3885099999999999,0.12480000000000001,14400,4004,15840,completed
87,10457,255,1,0-2,1,0.06625395833333333,0.0221,14400,3943,14655,completed
92,11435,380,1,0-2,1,0.09873138888888888,0.032933333333333335,14400,2965,14780,completed
93,11821,91,1,0-2,1,0.023643569444444443,0.007886666666666667,14400,2579,14491,completed
94,11855,68,1,0-2,1,0.01766772222222222,0.005893333333333334,14400,2545,14468,completed
95,11860,1379,3,0-2,3-4,1.1143306666666666,0.35854,14400,2540,15779,completed
96,11952,277,1,0-2,1,0.0719699861111111,0.024006666666666666,14400,2448,14677,completed
97,11979,62,1,0-2,1,0.016108805555555553,0.005373333333333333,14400,2421,14462,completed
99,12477,220,1,0-2,1,0.057160277777777775,0.019066666666666666,14400,1923,14620,completed
104,12664,21,1,0-2,1,0.005456208333333333,0.00182,14400,1736,14421,completed
110,12955,1388,3,0-2,3-4,1.1218846666666664,0.36088,14400,1445,15788,completed
111,13242,189,1,0-2,1,0.04910587499999999,0.01638,14400,1158,14589,completed
112,13597,1366,3,0-2,3-4,1.103419333333333,0.35516000000000003,14400,803,15766,completed
114,13823,61,1,0-2,1,0.01584898611111111,0.005286666666666667,14400,577,14461,completed
116,14272,471,2,0-2,2,0.24474991666666662,0.08164,14400,128,14871,completed
117,14363,970,1,0-2,1,0.25701444444444443,0.08406666666666666,14400,37,15370,completed
118,14370,67,1,0-2,1,0.017407902777777776,0.005806666666666667,14400,30,14467,completed
119,14525,96,1,0-2,1,0.024942666666666665,0.008320000000000001,14525,0,14621,completed
121,14823,81,3,0-2,3-4,0.06313612499999999,0.02106,14823,0,14904,completed
123,15017,98,1,0-2,1,0.025462305555555554,0.008493333333333334,15017,0,15115,completed
124,15068,772,1,0-2,1,0.21495061111111105,0.06690666666666667,15068,0,15840,completed
126,15263,125,1,0-2,1,0.0349722222222222,0.0,15263,0,15388,completed
127,15338,105,1,0-2,1,0.02937666666666666,0.0,15338,0,15443,completed
132,15766,67,1,0-2,1,0.018745111111111108,0.0,15766,0,15833,completed
25,3134,720,2,0-2,2,0.5067000000000002,0.0,16560,13426,17280,completed
88,10477,720,1,0-2,1,0.2533500000000001,0.0,16560,6083,17280,completed
124,15068,558,1,0-2,1,0.19634625000000006,0.0,16560,1492,17118,completed
133,15873,687,1,0-2,1,0.24173812500000008,0.0,16560,687,17247,completed
134,16100,884,1,0-2,1,0.31287972222222227,0.0,16560,460,17444,completed
136,16330,104,1,0-2,1,0.03659500000000001,0.0,16560,230,16664,completed
137,16372,415,1,0-2,1,0.14602812500000006,0.0,16560,188,16975,completed
138,16667,292,1,0-2,1,0.10274750000000003,0.0,16667,0,16959,completed
139,16918,91,1,0-2,1,0.03202062500000001,0.0,16918,0,17009,completed
140,16919,361,1,0-2,1,0.12702687500000004,0.031286666666666664,16919,0,17280,completed
142,16963,60,1,0-2,1,0.02111250000000001,0.0,16963,0,17023,completed
140,16919,260,1,0-2,1,0.09324249999999999,0.0,21600,4681,21860,completed
143,17338,662,1,0-2,1,0.23740975000000003,0.0,21600,4262,22262,completed
144,17338,662,1,0-2,1,0.23740975000000003,0.0,21600,4262,22262,completed
145,17338,662,1,0-2,1,0.23740975000000003,0.0,21600,4262,22262,completed
147,17682,318,3,0-2,3-4,0.34212825,0.0,21600,3918,21918,completed
148,17703,297,1,0-2,1,0.106511625,0.0,21600,3897,21897,completed
151,17888,69,1,0-2,1,0.024745125000000007,0.0,21600,3712,21669,completed
152,17930,62,1,0-2,1,0.022234750000000008,0.005373333333333333,21600,3670,21662,completed
25,3134,6480,2,12-24,2,2.4123200000000002,0.0,22320,19186,28800,completed
50,7474,6480,4,12-24,3-4,4.8246400000000005,0.0,22320,14846,28800,completed
68,9224,584,1,0-2,1,0.15609022222222224,0.0,22320,13096,22904,completed
70,9317,6480,1,12-24,1,1.2061600000000001,0.0,22320,13003,28800,completed
71,9334,6480,1,12-24,1,1.2061600000000001,0.0,22320,12986,28800,completed
83,10187,505,1,0-2,1,0.1349752777777778,0.04376666666666667,22320,12133,22825,completed
86,10396,6480,1,12-24,1,1.2061600000000001,0.5616,22320,11924,28800,completed
88,10477,6480,1,12-24,1,1.2061600000000001,0.5616,22320,11843,28800,completed
133,15873,6480,1,12-24,1,1.2061600000000001,0.5616,22320,6447,28800,completed
141,16929,351,2,0-2,2,0.18762900000000005,0.06084,22320,5391,22671,completed
143,17338,513,1,0-2,1,0.1371135,0.04446,22320,4982,22833,completed
145,17338,506,1,0-2,1,0.13524255555555556,0.043853333333333334,22320,4982,22826,completed
144,17338,501,1,0-2,1,0.1339061666666667,0.04342,22320,4982,22821,completed
147,17682,543,3,0-2,3-4,0.43539550000000005,0.14118,22320,4638,22863,completed
148,17703,81,1,0-2,1,0.021649500000000002,0.00702,22320,4617,22401,completed
159,18145,358,1,0-2,1,0.09568544444444446,0.031026666666666668,22320,4175,22678,completed
156,18145,575,1,0-2,1,0.15368472222222224,0.049833333333333334,22320,4175,22895,completed
158,18145,575,1,0-2,1,0.15368472222222224,0.049833333333333334,22320,4175,22895,completed
153,18145,575,1,0-2,1,0.15368472222222224,0.049833333333333334,22320,4175,22895,completed
155,18145,575,1,0-2,1,0.15368472222222224,0.049833333333333334,22320,4175,22895,completed
154,18145,575,1,0-2,1,0.15368472222222224,0.049833333333333334,22320,4175,22895,completed
164,18222,498,1,0-2,1,0.13310433333333335,0.043160000000000004,22320,4098,22818,completed
167,18357,363,1,0-2,1,0.09702183333333333,0.03146,22320,3963,22683,completed
168,18471,249,2,0-2,2,0.13310433333333332,0.043160000000000004,22320,3849,22569,completed
169,18508,193,4,0-2,3-4,0.20633844444444444,0.06690666666666667,22320,3812,22513,completed
68,9224,5760,1,6-12,1,1.0137200000000002,0.0,23040,13816,28800,completed
73,9461,234,1,0-2,1,0.051857000000000014,0.02028,23040,13579,23274,completed
75,9489,5760,1,6-12,1,1.0137200000000002,0.49920000000000003,23040,13551,28800,completed
82,9840,355,1,0-2,1,0.07867194444444447,0.030766666666666668,23040,13200,23395,completed
83,10187,5760,1,6-12,1,1.0137200000000002,0.49920000000000003,23040,12853,28800,completed
87,10457,5760,1,6-12,1,1.0137200000000002,0.49920000000000003,23040,12583,28800,completed
104,12664,5760,1,6-12,1,1.0137200000000002,0.49920000000000003,23040,10376,28800,completed
141,16929,5760,2,6-12,2,2.0274400000000004,0.9984000000000001,23040,6111,28800,completed
155,18145,747,1,0-2,1,0.16469075000000005,0.06474,23040,4895,23787,completed
158,18145,467,1,0-2,1,0.10349238888888893,0.04047333333333333,23040,4895,23507,completed
153,18145,744,1,0-2,1,0.16412066666666675,0.06448,23040,4895,23784,completed
154,18145,772,1,0-2,1,0.16944144444444448,0.06690666666666667,23040,4895,23812,completed
156,18145,374,1,0-2,1,0.08288255555555558,0.032413333333333336,23040,4895,23414,completed
164,18222,83,1,0-2,1,0.018393722222222224,0.007193333333333334,23040,4818,23123,completed
167,18357,1063,1,0-2,1,0.22473952777777784,0.09212666666666666,23040,4683,24103,completed
168,18471,125,2,0-2,2,0.05540277777777779,0.021666666666666667,23040,4569,23165,completed
170,18652,700,3,0-2,3-4,0.4653833333333334,0.182,23040,4388,23740,completed
171,18888,157,4,0-2,3-4,0.13917177777777778,0.054426666666666665,23040,4152,23197,completed
172,18909,195,1,0-2,1,0.04321416666666668,0.016900000000000002,23040,4131,23235,completed
173,19019,327,1,0-2,1,0.07246683333333334,0.02834,23040,4021,23367,completed
174,19063,71,1,0-2,1,0.015734388888888895,0.006153333333333334,23040,3977,23111,completed
175,19128,312,4,0-2,3-4,0.27657066666666674,0.10816,23040,3912,23352,completed
176,19151,156,4,0-2,3-4,0.13828533333333337,0.05408,23040,3889,23196,completed
177,19153,64,1,0-2,1,0.014183111111111115,0.005546666666666667,23040,3887,23104,completed
178,19312,128,2,0-2,2,0.05673244444444447,0.022186666666666667,23040,3728,23168,completed
185,20036,5760,1,6-12,1,1.0137200000000002,0.49920000000000003,23040,3004,28800,completed
192,20837,5760,1,6-12,1,1.0137200000000002,0.49920000000000003,23040,2203,28800,completed
193,21039,5760,2,6-12,2,2.0274400000000004,0.9984000000000001,23040,2001,28800,completed
55,8059,4610,1,6-12,1,0.7615188888888889,0.39953333333333335,23760,15701,28370,completed
56,8115,4320,1,6-12,1,0.6990399999999999,0.3744,23760,15645,28080,completed
58,8157,657,1,0-2,1,0.12484825,0.05694,23760,15603,24417,completed
62,8277,4621,1,6-12,1,0.7638887777777779,0.40048666666666666,23760,15483,28381,completed
63,8304,4790,1,6-12,1,0.8002988888888889,0.41513333333333335,23760,15456,28550,completed
66,9037,4485,1,6-12,1,0.7345883333333334,0.3887,23760,14723,28245,completed
73,9461,5040,1,6-12,1,0.85416,0.4368,23760,14299,28800,completed
79,9665,4320,1,6-12,1,0.6990399999999999,0.3744,23760,14095,28080,completed
81,9793,4806,1,6-12,1,0.8037460000000001,0.41652,23760,13967,28566,completed
82,9840,5040,1,6-12,1,0.85416,0.4368,23760,13920,28800,completed
100,12539,168,1,0-2,1,0.031924666666666664,0.01456,23760,11221,23928,completed
106,12851,4743,1,6-12,1,0.790173,0.41106,23760,10909,28503,completed
105,12851,4752,1,6-12,1,0.792112,0.41184,23760,10909,28512,completed
107,12852,4772,1,6-12,1,0.7964208888888888,0.41357333333333335,23760,10908,28532,completed
108,12857,4809,1,6-12,1,0.8043923333333334,0.41678,23760,10903,28569,completed
115,14245,671,2,0-2,2,0.2550172777777778,0.11630666666666667,23760,9515,24431,completed
120,14545,4946,1,6-12,1,0.8339082222222223,0.42865333333333333,23760,9215,28706,completed
125,15128,127,2,0-2,2,0.048267055555555556,0.022013333333333333,23760,8632,23887,completed
131,15730,84,1,0-2,1,0.015962333333333335,0.00728,23760,8030,23844,completed
170,18652,5040,3,6-12,3-4,2.56248,1.3104,23760,5108,28800,completed
175,19128,568,4,0-2,3-4,0.4317431111111111,0.19690666666666667,23760,4632,24328,completed
178,19312,102,2,0-2,2,0.03876566666666667,0.01768,23760,4448,23862,completed
179,19580,255,4,0-2,3-4,0.19382833333333332,0.0884,23760,4180,24015,completed
180,19717,80,1,0-2,1,0.015202222222222221,0.006933333333333333,23760,4043,23840,completed
181,19736,176,1,0-2,1,0.033444888888888885,0.015253333333333334,23760,4024,23936,completed
182,19900,260,1,0-2,1,0.04940722222222222,0.022533333333333332,23760,3860,24020,completed
183,19962,198,1,0-2,1,0.0376255,0.01716,23760,3798,23958,completed
184,19996,103,1,0-2,1,0.019572861111111114,0.008926666666666666,23760,3764,23863,completed
186,20149,11,1,0-2,1,0.0020903055555555553,0.0009533333333333334,23760,3611,23771,completed
58,8157,3600,1,6-12,1,0.5622199999999999,0.312,24480,16323,28080,completed
64,8680,3600,1,6-12,1,0.5622199999999999,0.312,24480,15800,28080,completed
67,9049,3600,1,6-12,1,0.5622199999999999,0.312,24480,15431,28080,completed
84,10348,74,1,0-2,1,0.012534777777777777,0.006413333333333333,24480,14132,24554,completed
101,12539,395,1,0-2,1,0.0669086111111111,0.03423333333333333,24480,11941,24875,completed
100,12539,3600,1,6-12,1,0.5622199999999999,0.312,24480,11941,28080,completed
109,12877,254,1,0-2,1,0.04302477777777778,0.022013333333333333,24480,11603,24734,completed
115,14245,3600,2,6-12,2,1.1244399999999999,0.624,24480,10235,28080,completed
125,15128,3600,2,6-12,2,1.1244399999999999,0.624,24480,9352,28080,completed
130,15724,405,1,0-2,1,0.06860250000000001,0.0351,24480,8756,24885,completed
131,15730,3600,1,6-12,1,0.5622199999999999,0.312,24480,8750,28080,completed
182,19900,115,1,0-2,1,0.019479722222222225,0.009966666666666667,24480,4580,24595,completed
183,19962,190,1,0-2,1,0.03218388888888889,0.016466666666666668,24480,4518,24670,completed
186,20149,429,1,0-2,1,0.07266783333333335,0.03718,24480,4331,24909,completed
187,20173,261,1,0-2,1,0.0442105,0.02262,24480,4307,24741,completed
188,20527,93,1,0-2,1,0.015753166666666665,0.00806,24480,3953,24573,completed
189,20538,342,1,0-2,1,0.05793099999999999,0.02964,24480,3942,24822,completed
215,23773,340,4,0-2,3-4,0.23036888888888885,0.11786666666666668,24480,707,24820,completed
224,24763,4037,1,6-12,1,0.6694029444444445,0.3498733333333333,24763,0,28800,completed
227,25100,3700,1,6-12,1,0.6123188888888889,0.32066666666666666,25100,0,28800,completed
228,25104,3696,1,6-12,1,0.6116413333333334,0.32032,25104,0,28800,completed
229,25139,2941,1,6-12,1,0.45059272222222224,0.25488666666666665,25139,0,28080,completed
7,587,2219,1,2-6,1,0.32956086111111105,0.19231333333333334,25200,24613,27419,completed
8,601,2160,1,2-6,1,0.31967999999999996,0.1872,25200,24599,27360,completed
46,6676,235,1,0-2,1,0.03557965277777778,0.02036666666666667,25200,18524,25435,completed
53,7879,2846,1,2-6,1,0.4345659444444444,0.24665333333333334,25200,17321,28046,completed
65,8791,72,1,0-2,1,0.010901000000000001,0.00624,25200,16409,25272,completed
84,10348,2880,1,2-6,1,0.44026,0.24960000000000002,25200,14852,28080,completed
98,12054,2661,1,2-6,1,0.40358358333333333,0.23062,25200,13146,27861,completed
101,12539,2880,1,2-6,1,0.44026,0.24960000000000002,25200,12661,28080,completed
103,12549,290,1,0-2,1,0.04390680555555556,0.025133333333333334,25200,12651,25490,completed
102,12549,290,1,0-2,1,0.04390680555555556,0.025133333333333334,25200,12651,25490,completed
109,12877,2880,1,2-6,1,0.44026,0.24960000000000002,25200,12323,28080,completed
113,13795,113,1,0-2,1,0.017108513888888892,0.009793333333333333,25200,11405,25313,completed
122,14830,435,1,0-2,1,0.06586020833333335,0.0377,25200,10370,25635,completed
128,15562,300,1,0-2,1,0.04542083333333334,0.026,25200,9638,25500,completed
129,15565,487,1,0-2,1,0.07373315277777778,0.04220666666666667,25200,9635,25687,completed
130,15724,2880,1,2-6,1,0.44026,0.24960000000000002,25200,9476,28080,completed
135,16234,2495,1,2-6,1,0.3757831944444444,0.21623333333333333,25200,8966,27695,completed
146,17611,2681,1,2-6,1,0.40693302777777773,0.23235333333333333,25200,7589,27881,completed
149,17795,78,1,0-2,1,0.01180941666666667,0.00676,25200,7405,25278,completed
150,17871,2813,1,2-6,1,0.42903936111111113,0.24379333333333333,25200,7329,28013,completed
157,18145,39,1,0-2,1,0.005904708333333336,0.00338,25200,7055,25239,completed
161,18146,203,1,0-2,1,0.030734763888888898,0.017593333333333332,25200,7054,25403,completed
160,18146,246,1,0-2,1,0.03724508333333334,0.02132,25200,7054,25446,completed
162,18172,422,1,0-2,1,0.06389197222222223,0.03657333333333333,25200,7028,25622,completed
163,18178,554,1,0-2,1,0.0838771388888889,0.04801333333333333,25200,7022,25754,completed
166,18309,319,1,0-2,1,0.04829748611111112,0.027646666666666667,25200,6891,25519,completed
189,20538,542,1,0-2,1,0.08206030555555555,0.04697333333333333,25200,4662,25742,completed
190,20543,91,1,0-2,1,0.013777652777777781,0.007886666666666667,25200,4657,25291,completed
191,20566,26,1,0-2,1,0.003936472222222222,0.0022533333333333333,25200,4634,25226,completed
194,21484,69,1,0-2,1,0.010446791666666668,0.00598,25200,3716,25269,completed
195,21563,37,1,0-2,1,0.005601902777777779,0.0032066666666666667,25200,3637,25237,completed
196,21591,9,1,0-2,1,0.0013626250000000001,0.00078,25200,3609,25209,completed
207,22888,167,1,0-2,1,0.025284263888888894,0.014473333333333333,25200,2312,25367,completed
211,23227,2388,1,2-6,1,0.3578636666666667,0.20696,25200,1973,27588,completed
215,23773,2880,4,2-6,3-4,1.76104,0.9984000000000001,25200,1427,28080,completed
223,24590,458,1,0-2,1,0.06934247222222223,0.03969333333333334,25200,610,25658,completed
233,25676,2404,1,2-6,1,0.36819227777777774,0.20834666666666668,25676,0,28080,completed
36,4712,1291,1,0-2,1,0.18874423611111107,0.11188666666666666,25920,21208,27211,completed
41,5540,273,1,0-2,1,0.03970633333333333,0.02366,25920,20380,26193,completed
46,6676,1440,1,0-2,1,0.21066999999999997,0.12480000000000001,25920,19244,27360,completed
48,6819,1207,1,0-2,1,0.17638340277777775,0.10460666666666667,25920,19101,27127,completed
57,8139,1337,1,0-2,1,0.19551326388888884,0.11587333333333334,25920,17781,27257,completed
61,8229,1190,1,0-2,1,0.17388180555555555,0.10313333333333334,25920,17691,27110,completed
65,8791,1440,1,0-2,1,0.21066999999999997,0.12480000000000001,25920,17129,27360,completed
102,12549,1440,1,0-2,1,0.21066999999999997,0.12480000000000001,25920,13371,27360,completed
103,12549,1440,1,0-2,1,0.21066999999999997,0.12480000000000001,25920,13371,27360,completed
113,13795,1440,1,0-2,1,0.21066999999999997,0.12480000000000001,25920,12125,27360,completed
122,14830,1440,1,0-2,1,0.21066999999999997,0.12480000000000001,25920,11090,27360,completed
128,15562,1440,1,0-2,1,0.21066999999999997,0.12480000000000001,25920,10358,27360,completed
129,15565,1440,1,0-2,1,0.21066999999999997,0.12480000000000001,25920,10355,27360,completed
149,17795,1440,1,0-2,1,0.21066999999999997,0.12480000000000001,25920,8125,27360,completed
157,18145,1440,1,0-2,1,0.21066999999999997,0.12480000000000001,25920,7775,27360,completed
160,18146,1440,1,0-2,1,0.21066999999999997,0.12480000000000001,25920,7774,27360,completed
161,18146,1440,1,0-2,1,0.21066999999999997,0.12480000000000001,25920,7774,27360,completed
162,18172,1440,1,0-2,1,0.21066999999999997,0.12480000000000001,25920,7748,27360,completed
163,18178,1440,1,0-2,1,0.21066999999999997,0.12480000000000001,25920,7742,27360,completed
165,18273,1440,1,2-6,1,0.21066999999999997,0.12480000000000001,25920,7647,27360,completed
166,18309,1440,1,0-2,1,0.21066999999999997,0.12480000000000001,25920,7611,27360,completed
190,20543,1440,1,0-2,1,0.21066999999999997,0.12480000000000001,25920,5377,27360,completed
191,20566,1440,1,0-2,1,0.21066999999999997,0.12480000000000001,25920,5354,27360,completed
195,21563,708,1,0-2,1,0.10297466666666664,0.06136,25920,4357,26628,completed
196,21591,601,1,0-2,1,0.08741211111111111,0.05208666666666667,25920,4329,26521,completed
197,21637,784,1,0-2,1,0.11413777777777774,0.06794666666666667,25920,4283,26704,completed
198,21673,782,1,0-2,1,0.11384347222222219,0.06777333333333334,25920,4247,26702,completed
199,21778,1145,1,0-2,1,0.16725993055555555,0.09923333333333334,25920,4142,27065,completed
200,21946,611,1,0-2,1,0.08886655555555555,0.05295333333333333,25920,3974,26531,completed
201,22124,84,1,0-2,1,0.012217333333333332,0.00728,25920,3796,26004,completed
202,22438,277,1,0-2,1,0.04028811111111111,0.024006666666666666,25920,3482,26197,completed
204,22509,122,1,0-2,1,0.01774422222222222,0.010573333333333334,25920,3411,26042,completed
203,22509,78,1,0-2,1,0.011344666666666666,0.00676,25920,3411,25998,completed
205,22647,224,1,0-2,1,0.03257955555555555,0.019413333333333335,25920,3273,26144,completed
206,22818,61,1,0-2,1,0.008872111111111112,0.005286666666666667,25920,3102,25981,completed
207,22888,1440,1,0-2,1,0.21066999999999997,0.12480000000000001,25920,3032,27360,completed
208,22931,197,1,0-2,1,0.02865255555555555,0.017073333333333333,25920,2989,26117,completed
209,22988,199,1,0-2,1,0.02894344444444444,0.017246666666666667,25920,2932,26119,completed
210,23087,542,1,0-2,1,0.07883088888888887,0.04697333333333333,25920,2833,26462,completed
212,23478,251,1,0-2,1,0.036506555555555556,0.021753333333333333,25920,2442,26171,completed
213,23710,897,1,0-2,1,0.13076604166666667,0.07774,25920,2210,26817,completed
214,23725,67,1,0-2,1,0.009744777777777778,0.005806666666666667,25920,2195,25987,completed
216,23810,879,1,0-2,1,0.12811729166666663,0.07618,25920,2110,26799,completed
217,23906,337,1,0-2,1,0.04901477777777777,0.029206666666666665,25920,2014,26257,completed
218,24058,65,1,0-2,1,0.009453888888888888,0.005633333333333333,25920,1862,25985,completed
219,24289,203,1,0-2,1,0.029525222222222217,0.017593333333333332,25920,1631,26123,completed
220,24359,96,1,0-2,1,0.013962666666666663,0.008320000000000001,25920,1561,26016,completed
221,24363,87,1,0-2,1,0.012653666666666665,0.00754,25920,1557,26007,completed
222,24481,378,1,0-2,1,0.054977999999999985,0.03276,25920,1439,26298,completed
223,24590,1440,1,0-2,1,0.21066999999999997,0.12480000000000001,25920,1330,27360,completed
225,24890,103,1,0-2,1,0.014980777777777775,0.008926666666666666,25920,1030,26023,completed
226,25081,67,1,0-2,1,0.009744777777777778,0.005806666666666667,25920,839,25987,completed
230,25585,1313,1,0-2,1,0.1919815972222222,0.11379333333333333,25920,335,27233,completed
232,25598,189,2,0-2,2,0.054977999999999985,0.03276,25920,322,26109,completed
231,25598,189,2,0-2,2,0.054977999999999985,0.03276,25920,322,26109,completed
234,25678,125,1,0-2,1,0.018180555555555554,0.010833333333333334,25920,242,26045,completed
235,25725,83,2,0-2,2,0.024143777777777774,0.014386666666666667,25920,195,26003,completed
236,26334,88,1,0-2,1,0.012799111111111108,0.007626666666666667,26334,0,26422,completed
237,26539,534,1,0-2,1,0.07840704166666665,0.04628,26539,0,27073,completed
238,26542,1538,1,2-6,1,0.24078355555555556,0.13329333333333335,26542,0,28080,completed
239,26559,592,1,0-2,1,0.08697606944444444,0.05130666666666667,26559,0,27151,completed
240,26611,73,1,0-2,1,0.01069261111111111,0.006326666666666667,26611,0,26684,completed
241,26639,197,1,0-2,1,0.028987388888888882,0.017073333333333333,26639,0,26836,completed
242,26777,143,1,0-2,1,0.021042847222222216,0.012393333333333334,26777,0,26920,completed
243,26797,231,1,0-2,1,0.03399229166666666,0.02002,26797,0,27028,completed
244,26884,67,1,0-2,1,0.009859236111111109,0.005806666666666667,26884,0,26951,completed
245,26885,65,1,0-2,1,0.009564930555555554,0.005633333333333333,26885,0,26950,completed
246,26889,283,1,0-2,1,0.04164423611111111,0.024526666666666665,26889,0,27172,completed
247,26892,107,1,0-2,1,0.01574534722222222,0.009273333333333333,26892,0,26999,completed
248,26993,784,1,0-2,1,0.12384098611111112,0.06794666666666667,26993,0,27777,completed
249,27169,459,1,0-2,1,0.0729887361111111,0.03978,27169,0,27628,completed
250,27246,67,1,0-2,1,0.009859236111111109,0.005806666666666667,27246,0,27313,completed
251,27251,114,1,0-2,1,0.016877013888888886,0.00988,27251,0,27365,completed
252,27321,949,1,0-2,1,0.16725340277777778,0.08224666666666666,27321,0,28270,completed
253,27340,740,1,0-2,1,0.12352305555555557,0.06413333333333333,27340,0,28080,completed
254,27826,254,2,0-2,2,0.08507588888888888,0.044026666666666665,27826,0,28080,completed
255,27921,879,1,0-2,1,0.18174808333333334,0.07618,27921,0,28800,completed
256,28282,518,1,0-2,1,0.11160022222222223,0.044893333333333334,28282,0,28800,completed
257,28287,513,1,0-2,1,0.110523,0.04446,28287,0,28800,completed
258,28360,133,1,0-2,1,0.02865411111111112,0.011526666666666668,28360,0,28493,completed
259,28672,355,1,0-2,1,0.11130205555555557,0.030766666666666668,28672,0,29027,completed
262,29069,380,4,0-2,3-4,0.5606266666666666,0.0,29069,0,29449,completed
264,29282,238,3,0-2,3-4,0.263347,0.0,29282,0,29520,completed
255,27921,336,1,0-2,1,0.12227599999999997,0.0,30960,3039,31296,completed
256,28282,280,1,0-2,1,0.10189666666666664,0.0,30960,2678,31240,completed
257,28287,240,1,0-2,1,0.08734,0.0,30960,2673,31200,completed
259,28672,720,1,0-2,1,0.2620199999999999,0.0,30960,2288,31680,completed
260,28863,317,1,0-2,1,0.1153615833333333,0.0,30960,2097,31277,completed
262,29069,720,4,0-2,3-4,1.0480799999999997,0.0,30960,1891,31680,completed
263,29169,160,1,0-2,1,0.05822666666666665,0.013866666666666666,30960,1791,31120,completed
264,29282,773,3,0-2,3-4,0.8453117916666666,0.20098,30960,1678,31733,completed
265,29298,70,1,0-2,1,0.025474166666666652,0.006066666666666666,30960,1662,31030,completed
266,29466,77,1,0-2,1,0.02802158333333332,0.006673333333333333,30960,1494,31037,completed
268,29728,247,1,0-2,1,0.08988741666666666,0.021406666666666668,30960,1232,31207,completed
270,29934,288,1,0-2,1,0.10480799999999997,0.02496,30960,1026,31248,completed
271,29949,186,1,0-2,1,0.06768849999999998,0.01612,30960,1011,31146,completed
272,30024,284,1,0-2,1,0.1033523333333333,0.024613333333333334,30960,936,31244,completed
273,30093,457,1,0-2,1,0.16630991666666667,0.039606666666666665,30960,867,31417,completed
275,30345,124,1,0-2,1,0.04512566666666666,0.010746666666666667,30960,615,31084,completed
276,30346,324,1,0-2,1,0.11790899999999996,0.02808,30960,614,31284,completed
277,30347,142,1,0-2,1,0.05167616666666665,0.012306666666666667,30960,613,31102,completed
278,30349,123,1,0-2,1,0.044761749999999996,0.01066,30960,611,31083,completed
279,30353,370,1,0-2,1,0.13464916666666665,0.03206666666666667,30960,607,31330,completed
280,30629,586,1,0-2,1,0.2132551666666666,0.05078666666666667,30960,331,31546,completed
282,31235,110,1,0-2,1,0.04003083333333332,0.0,31235,0,31345,completed
283,31921,268,1,0-2,1,0.09987094444444447,0.0,31921,0,32189,completed
284,32262,858,1,0-2,1,0.3605460833333334,0.0,32262,0,33120,completed
285,32302,67,1,0-2,1,0.02496773611111111,0.0,32302,0,32369,completed
287,32401,403,1,0-2,1,0.17302133333333333,0.0,32401,0,32804,completed
288,32442,68,1,0-2,1,0.029194666666666664,0.0,32442,0,32510,completed
289,32572,127,2,0-2,2,0.10905066666666664,0.0,32572,0,32699,completed
291,32694,108,1,0-2,1,0.04636799999999999,0.0,32694,0,32802,completed
292,33074,46,2,0-2,2,0.03949866666666667,0.0,33074,0,33120,completed
293,33083,37,2,0-2,2,0.03177066666666667,0.0,33083,0,33120,completed
284,32262,563,1,0-2,1,0.2814218055555555,0.0,33840,1578,34403,completed
292,33074,49,2,0-2,2,0.048986388888888885,0.0,33840,766,33889,completed
293,33083,58,2,0-2,2,0.05798388888888888,0.0,33840,757,33898,completed
294,33652,188,1,0-2,1,0.09397388888888886,0.0,33840,188,34028,completed
295,33694,82,1,0-2,1,0.0409886111111111,0.0,33840,146,33922,completed
296,33771,69,1,0-2,1,0.03449041666666666,0.0,33840,69,33909,completed
297,33838,2,4,0-2,3-4,0.003998888888888889,0.0006933333333333333,33840,2,33842,completed
294,33652,2,1,0-2,1,0.000992,0.0,38160,4508,38162,completed
296,33771,8,1,0-2,1,0.003968,0.0,38160,4389,38168,completed
297,33838,66,4,0-2,3-4,0.13094400000000003,0.0,38160,4322,38226,completed
298,33978,91,3,0-2,3-4,0.13540800000000003,0.0,38160,4182,38251,completed
300,34153,65,1,0-2,1,0.032240000000000005,0.005633333333333333,38160,4007,38225,completed
301,34156,83,2,0-2,2,0.08233600000000002,0.014386666666666667,38160,4004,38243,completed
302,34382,133,1,0-2,1,0.06596800000000003,0.011526666666666668,38160,3778,38293,completed
304,34486,74,1,0-2,1,0.03670400000000001,0.006413333333333333,38160,3674,38234,completed
25,3134,720,2,0-2,2,0.5108000000000001,0.0,38880,35746,39600,completed
88,10477,720,1,0-2,1,0.25540000000000007,0.0,38880,28403,39600,completed
304,34486,1264,1,0-2,1,0.4537031111111112,0.0,38880,4394,40144,completed
305,34840,62,1,0-2,1,0.021992777777777778,0.0,38880,4040,38942,completed
306,35170,62,1,0-2,1,0.021992777777777778,0.0,38880,3710,38942,completed
307,35197,67,1,0-2,1,0.023766388888888892,0.0,38880,3683,38947,completed
310,35609,391,1,0-2,1,0.1386963888888889,0.0,38880,3271,39271,completed
309,35609,391,1,0-2,1,0.1386963888888889,0.0,38880,3271,39271,completed
312,35610,390,1,0-2,1,0.1383416666666667,0.033800000000000004,38880,3270,39270,completed
313,35610,390,1,0-2,1,0.1383416666666667,0.033800000000000004,38880,3270,39270,completed
315,35760,69,1,0-2,1,0.024475833333333336,0.00598,38880,3120,38949,completed
316,35765,235,1,0-2,1,0.08335972222222225,0.02036666666666667,38880,3115,39115,completed
25,3134,14665,2,24-48,2,6.52667875,0.0,40320,37186,54985,completed
88,10477,44,1,0-2,1,0.011608666666666666,0.0,40320,29843,40364,completed
133,15873,15126,1,24-48,1,3.368586,0.0,40320,24447,55446,completed
141,16929,311,2,0-2,2,0.16410433333333338,0.0,40320,23391,40631,completed
310,35609,656,1,0-2,1,0.17307466666666668,0.0,40320,4711,40976,completed
309,35609,837,1,0-2,1,0.21199012500000003,0.0,40320,4711,41157,completed
313,35610,718,1,0-2,1,0.18943233333333337,0.0,40320,4710,41038,completed
312,35610,732,1,0-2,1,0.19221950000000002,0.06344,40320,4710,41052,completed
316,35765,486,1,0-2,1,0.12822300000000003,0.04212,40320,4555,40806,completed
317,36083,192,1,0-2,1,0.05065600000000001,0.016640000000000002,40320,4237,40512,completed
318,36201,63,1,0-2,1,0.016621500000000004,0.0054600000000000004,40320,4119,40383,completed
321,36280,440,1,0-2,1,0.11608666666666669,0.03813333333333333,40320,4040,40760,completed
323,36471,249,4,0-2,3-4,0.26277800000000007,0.08632000000000001,40320,3849,40569,completed
324,36530,190,1,0-2,1,0.050128333333333344,0.016466666666666668,40320,3790,40510,completed
325,36581,139,2,0-2,2,0.07334566666666668,0.024093333333333335,40320,3739,40459,completed
326,36684,36,1,0-2,1,0.009498,0.00312,40320,3636,40356,completed
170,18652,3600,3,6-12,3-4,2.08296,0.0,41040,22388,44640,completed
185,20036,4444,1,6-12,1,0.8908787777777778,0.0,41040,21004,45484,completed
192,20837,3643,1,6-12,1,0.7043270555555556,0.0,41040,20203,44683,completed
193,21039,5040,2,6-12,2,2.06052,0.8736,41040,20001,46080,completed
224,24763,5040,1,6-12,1,1.03026,0.4368,41040,16277,46080,completed
227,25100,3600,1,6-12,1,0.69432,0.312,41040,15940,44640,completed
228,25104,3600,1,6-12,1,0.69432,0.312,41040,15936,44640,completed
238,26542,2880,1,2-6,1,0.53598,0.24960000000000002,41040,14498,43920,completed
254,27826,146,2,0-2,2,0.054981166666666664,0.02530666666666667,41040,13214,41186,completed
261,28962,3330,1,6-12,1,0.6349425,0.2886,41040,12078,44370,completed
267,29723,4837,1,6-12,1,0.9827861944444444,0.41920666666666667,41040,11317,45877,completed
269,29797,379,2,0-2,2,0.14272508333333334,0.06569333333333334,41040,11243,41419,completed
274,30204,263,1,0-2,1,0.04952070833333332,0.022793333333333332,41040,10836,41303,completed
281,30697,2880,4,2-6,3-4,2.14392,0.9984000000000001,41040,10343,43920,completed
286,32304,2799,1,2-6,1,0.5197968749999999,0.24258000000000002,41040,8736,43839,completed
290,32670,2561,4,2-6,3-4,1.8889858333333331,0.8878133333333333,41040,8370,43601,completed
299,34091,2289,1,2-6,1,0.41790312500000004,0.19838,41040,6949,43329,completed
303,34398,3600,2,6-12,2,1.38864,0.624,41040,6642,44640,completed
308,35461,74,1,0-2,1,0.013933583333333333,0.006413333333333333,41040,5579,41114,completed
311,35610,136,1,0-2,1,0.025607666666666667,0.011786666666666668,41040,5430,41176,completed
314,35613,620,1,0-2,1,0.11674083333333332,0.053733333333333334,41040,5427,41660,completed
319,36204,2676,1,2-6,1,0.4952225,0.23192000000000002,41040,4836,43716,completed
320,36269,2611,1,2-6,1,0.48223604166666667,0.22628666666666666,41040,4771,43651,completed
321,36280,361,1,0-2,1,0.06797329166666666,0.031286666666666664,41040,4760,41401,completed
322,36435,2445,1,2-6,1,0.449070625,0.2119,41040,4605,43485,completed
323,36471,409,4,0-2,3-4,0.3080451666666666,0.14178666666666667,41040,4569,41449,completed
324,36530,92,1,0-2,1,0.017322833333333332,0.007973333333333334,41040,4510,41132,completed
325,36581,78,2,0-2,2,0.029373499999999997,0.01352,41040,4459,41118,completed
326,36684,58,1,0-2,1,0.010920916666666666,0.005026666666666667,41040,4356,41098,completed
327,36816,624,3,0-2,3-4,0.35248199999999996,0.16224,41040,4224,41664,completed
328,37065,2880,1,2-6,1,0.53598,0.24960000000000002,41040,3975,43920,completed
329,37107,333,1,0-2,1,0.062701125,0.02886,41040,3933,41373,completed
330,37189,251,3,0-2,3-4,0.14178362499999997,0.06526,41040,3851,41291,completed
331,37335,2880,1,2-6,1,0.53598,0.24960000000000002,41040,3705,43920,completed
334,38060,2496,2,2-6,2,0.91852,0.43264,41040,2980,43536,completed
229,25139,519,1,0-2,1,0.08970770833333333,0.0,41760,16621,42279,completed
233,25676,645,1,0-2,1,0.11148645833333334,0.0559,41760,16084,42405,completed
253,27340,1345,1,0-2,1,0.23912881944444445,0.11656666666666667,41760,14420,43105,completed
254,27826,1440,2,0-2,2,0.51312,0.24960000000000002,41760,13934,43200,completed
269,29797,1440,2,0-2,2,0.51312,0.24960000000000002,41760,11963,43200,completed
274,30204,1440,1,0-2,1,0.25656,0.12480000000000001,41760,11556,43200,completed
308,35461,1440,1,0-2,1,0.25656,0.12480000000000001,41760,6299,43200,completed
311,35610,1440,1,0-2,1,0.25656,0.12480000000000001,41760,6150,43200,completed
314,35613,1440,1,0-2,1,0.25656,0.12480000000000001,41760,6147,43200,completed
327,36816,1440,3,0-2,3-4,0.76968,0.3744,41760,4944,43200,completed
329,37107,1440,1,0-2,1,0.25656,0.12480000000000001,41760,4653,43200,completed
330,37189,1440,3,0-2,3-4,0.76968,0.3744,41760,4571,43200,completed
332,37535,242,1,0-2,1,0.041829027777777784,0.020973333333333333,41760,4225,42002,completed
333,37640,120,1,0-2,1,0.02074166666666667,0.0104,41760,4120,41880,completed
335,38128,1022,1,0-2,1,0.17986280555555556,0.08857333333333334,41760,3632,42782,completed
336,38669,211,1,0-2,1,0.036470763888888896,0.018286666666666666,41760,3091,41971,completed
337,38721,1060,1,0-2,1,0.18683527777777778,0.09186666666666667,41760,3039,42820,completed
338,38746,134,2,0-2,2,0.046323055555555555,0.023226666666666666,41760,3014,41894,completed
339,38843,136,1,0-2,1,0.023507222222222224,0.011786666666666668,41760,2917,41896,completed
340,38845,327,1,0-2,1,0.05652104166666667,0.02834,41760,2915,42087,completed
341,38894,870,1,0-2,1,0.15197291666666668,0.0754,41760,2866,42630,completed
343,39034,1058,1,0-2,1,0.18646830555555557,0.09169333333333334,41760,2726,42818,completed
347,39155,1284,1,0-2,1,0.22793616666666666,0.11128,41760,2605,43044,completed
348,39174,93,1,0-2,1,0.01607479166666667,0.00806,41760,2586,41853,completed
350,39237,743,1,0-2,1,0.12867018055555557,0.06439333333333333,41760,2523,42503,completed
351,39247,773,1,0-2,1,0.13417476388888888,0.06699333333333334,41760,2513,42533,completed
353,39363,759,1,0-2,1,0.13160595833333333,0.06578,41760,2397,42519,completed
354,39371,409,1,0-2,1,0.0706945138888889,0.03544666666666667,41760,2389,42169,completed
355,39403,1236,1,0-2,1,0.21912883333333333,0.10712,41760,2357,42996,completed
356,39481,462,1,0-2,1,0.07985541666666668,0.04004,41760,2279,42222,completed
357,39491,437,1,0-2,1,0.07553423611111112,0.037873333333333335,41760,2269,42197,completed
358,39886,65,1,0-2,1,0.011235069444444445,0.005633333333333333,41760,1874,41825,completed
359,39922,780,2,0-2,2,0.27091833333333337,0.13520000000000001,41760,1838,42540,completed
360,40319,141,1,0-2,1,0.024371458333333332,0.01222,41760,1441,41901,completed
361,40724,1134,1,0-2,1,0.20041325000000001,0.09828,41760,1036,42894,completed
362,40724,1134,1,0-2,1,0.20041325000000001,0.09828,41760,1036,42894,completed
364,41001,205,1,0-2,1,0.03543368055555557,0.017766666666666667,41760,759,41965,completed
363,41001,173,1,0-2,1,0.02990256944444445,0.014993333333333334,41760,759,41933,completed
365,41312,160,1,0-2,1,0.027655555555555558,0.013866666666666666,41760,448,41920,completed
366,41325,150,1,0-2,1,0.025927083333333333,0.013,41760,435,41910,completed
367,41325,150,1,0-2,1,0.025927083333333333,0.013,41760,435,41910,completed
369,41607,1107,1,0-2,1,0.195459125,0.09594,41760,153,42867,completed
376,43891,430,2,0-2,2,0.1879610833333334,0.07453333333333334,43891,0,44321,completed
375,43891,29,1,0-2,1,0.005793958333333333,0.0,43891,0,43920,completed
377,43910,10,1,0-2,1,0.0019979166666666665,0.0008666666666666666,43910,0,43920,completed
381,44214,329,1,0-2,1,0.07235258333333335,0.0,44214,0,44543,completed
383,44357,66,1,0-2,1,0.014514500000000001,0.00572,44357,0,44423,completed
384,44409,229,1,0-2,1,0.050360916666666686,0.01984666666666667,44409,0,44638,completed
385,44459,181,1,0-2,1,0.039804916666666676,0.015686666666666668,44459,0,44640,completed
386,44536,104,1,0-2,1,0.02287133333333334,0.009013333333333333,44536,0,44640,completed
193,21039,4161,2,6-12,2,1.924441166666667,0.0,46800,25761,50961,completed
224,24763,15840,1,24-48,1,3.06611,0.0,46800,22037,62640,completed
185,20036,813,1,0-2,1,0.17211233333333334,0.0,47520,27484,48333,completed
192,20837,1533,1,2-6,1,0.3338365833333334,0.0,47520,26683,49053,completed
227,25100,2160,1,2-6,1,0.47681,0.0,47520,22420,49680,completed
228,25104,2160,1,2-6,1,0.47681,0.1872,47520,22416,49680,completed
238,26542,695,1,0-2,1,0.14601756944444444,0.06023333333333333,47520,20978,48215,completed
261,28962,720,1,0-2,1,0.15127000000000002,0.062400000000000004,47520,18558,48240,completed
267,29723,2160,1,2-6,1,0.47681,0.1872,47520,17797,49680,completed
281,30697,169,4,0-2,3-4,0.14202572222222223,0.05858666666666667,47520,16823,47689,completed
303,34398,882,2,0-2,2,0.37515200000000004,0.15288000000000002,47520,13122,48402,completed
328,37065,375,1,0-2,1,0.07878645833333334,0.0325,47520,10455,47895,completed
376,43891,720,2,0-2,2,0.30254000000000003,0.12480000000000001,47520,3629,48240,completed
375,43891,126,1,0-2,1,0.026472250000000003,0.010920000000000001,47520,3629,47646,completed
377,43910,170,1,0-2,1,0.035716527777777785,0.014733333333333334,47520,3610,47690,completed
378,43982,171,2,0-2,2,0.07185325000000001,0.02964,47520,3538,47691,completed
379,44138,140,1,0-2,1,0.029413611111111113,0.012133333333333333,47520,3382,47660,completed
381,44214,720,1,0-2,1,0.15127000000000002,0.062400000000000004,47520,3306,48240,completed
382,44268,198,1,0-2,1,0.041599250000000004,0.01716,47520,3252,47718,completed
383,44357,720,1,0-2,1,0.15127000000000002,0.062400000000000004,47520,3163,48240,completed
384,44409,720,1,0-2,1,0.15127000000000002,0.062400000000000004,47520,3111,48240,completed
385,44459,987,1,0-2,1,0.2111076666666667,0.08554,47520,3061,48507,completed
386,44536,720,1,0-2,1,0.15127000000000002,0.062400000000000004,47520,2984,48240,completed
387,44538,185,1,0-2,1,0.038867986111111114,0.016033333333333333,47520,2982,47705,completed
388,44818,689,1,0-2,1,0.1447569861111111,0.059713333333333334,47520,2702,48209,completed
390,44963,535,1,0-2,1,0.11240201388888889,0.04636666666666667,47520,2557,48055,completed
391,45053,472,1,0-2,1,0.09916588888888889,0.04090666666666667,47520,2467,47992,completed
392,45193,394,1,0-2,1,0.08277830555555557,0.034146666666666665,47520,2327,47914,completed
393,45295,1179,1,0-2,1,0.254137,0.10218,47520,2225,48699,completed
394,45498,1080,1,0-2,1,0.23195,0.0936,47520,2022,48600,completed
395,45499,847,1,0-2,1,0.17973211111111112,0.07340666666666666,47520,2021,48367,completed
396,45622,356,1,0-2,1,0.07479461111111112,0.030853333333333333,47520,1898,47876,completed
398,45710,292,1,0-2,1,0.06134838888888888,0.02530666666666667,47520,1810,47812,completed
399,45711,281,1,0-2,1,0.059037319444444444,0.024353333333333334,47520,1809,47801,completed
400,45732,848,1,0-2,1,0.17995622222222224,0.07349333333333334,47520,1788,48368,completed
402,45862,294,1,0-2,1,0.061768583333333335,0.02548,47520,1658,47814,completed
403,46142,593,1,0-2,1,0.12458765277777778,0.05139333333333333,47520,1378,48113,completed
404,46424,350,1,0-2,1,0.07353402777777779,0.030333333333333334,47520,1096,47870,completed
407,46720,71,2,0-2,2,0.02983380555555556,0.012306666666666667,47520,800,47591,completed
408,47229,187,1,0-2,1,0.03928818055555556,0.016206666666666668,47520,291,47707,completed
409,47241,72,1,0-2,1,0.015127,0.00624,47520,279,47592,completed
410,47700,540,1,0-2,1,0.1134525,0.0468,47700,0,48240,completed
412,47824,111,1,0-2,1,0.02332079166666667,0.00962,47824,0,47935,completed
413,47910,61,1,0-2,1,0.012815930555555558,0.005286666666666667,47910,0,47971,completed
415,48123,63,1,0-2,1,0.013236125000000003,0.0054600000000000004,48123,0,48186,completed
416,48154,86,2,0-2,2,0.03613672222222223,0.014906666666666667,48154,0,48240,completed
193,21039,11520,2,12-24,2,4.12774,0.0,51120,30081,62640,completed
227,25100,3259,1,6-12,1,0.7088641250000001,0.0,51840,26740,55099,completed
228,25104,1712,1,2-6,1,0.36534466666666665,0.0,51840,26736,53552,completed
267,29723,10800,1,12-24,1,1.8940299999999999,0.0,51840,22117,62640,completed
303,34398,1440,2,0-2,2,0.5931200000000001,0.24960000000000002,52560,18162,54000,completed
328,37065,1440,1,0-2,1,0.29656000000000005,0.12480000000000001,52560,15495,54000,completed
331,37335,1257,1,0-2,1,0.258503625,0.10894,52560,15225,53817,completed
410,47700,277,1,0-2,1,0.05648876388888889,0.024006666666666666,52560,4860,52837,completed
416,48154,113,2,0-2,2,0.04608830555555556,0.019586666666666665,52560,4406,52673,completed
417,48606,112,1,0-2,1,0.022840222222222227,0.009706666666666667,52560,3954,52672,completed
418,48670,137,1,0-2,1,0.027938486111111112,0.011873333333333333,52560,3890,52697,completed
420,48927,94,1,0-2,1,0.019169472222222216,0.008146666666666667,52560,3633,52654,completed
421,49475,449,1,0-2,1,0.09156481944444446,0.038913333333333334,52560,3085,53009,completed
422,49515,607,3,0-2,3-4,0.3713575416666667,0.15782000000000002,52560,3045,53167,completed
423,49616,589,3,0-2,3-4,0.3603452916666666,0.15314,52560,2944,53149,completed
424,49690,1004,3,0-2,3-4,0.6176705000000001,0.26104,52560,2870,53564,completed
425,49978,169,1,0-2,1,0.03446426388888889,0.014646666666666667,52560,2582,52729,completed
426,49982,138,1,0-2,1,0.02814241666666667,0.01196,52560,2578,52698,completed
427,50035,126,1,0-2,1,0.02569525,0.010920000000000001,52560,2525,52686,completed
428,50136,123,1,0-2,1,0.025083458333333336,0.01066,52560,2424,52683,completed
429,50677,127,1,0-2,1,0.025899180555555554,0.011006666666666666,52560,1883,52687,completed
430,50698,377,1,0-2,1,0.07688181944444444,0.03267333333333333,52560,1862,52937,completed
433,51206,126,4,0-2,3-4,0.102781,0.043680000000000004,52560,1354,52686,completed
435,51572,107,3,0-2,3-4,0.06546170833333334,0.02782,52560,988,52667,completed
436,51611,229,2,0-2,2,0.09340019444444445,0.03969333333333334,52560,949,52789,completed
437,51799,41,1,0-2,1,0.00836115277777778,0.0035533333333333333,52560,761,52601,completed
303,34398,7200,2,12-24,2,2.21458,0.0,55440,21042,62640,completed
319,36204,547,1,0-2,1,0.07616215277777777,0.0,56160,19956,56707,completed
320,36269,67,1,0-2,1,0.009328819444444443,0.0,56160,19891,56227,completed
322,36435,2841,1,2-6,1,0.40587341666666665,0.0,56160,19725,59001,completed
327,36816,2650,3,2-6,3-4,1.1443558333333335,0.6890000000000001,56160,19344,58810,completed
328,37065,5760,1,6-12,1,0.7944200000000001,0.49920000000000003,56160,19095,61920,completed
329,37107,1838,1,2-6,1,0.2660725,0.15929333333333334,56160,19053,57998,completed
330,37189,3724,3,6-12,3-4,1.5157663333333335,0.96824,56160,18971,59884,completed
331,37335,5760,1,6-12,1,0.7944200000000001,0.49920000000000003,56160,18825,61920,completed
334,38060,5760,2,6-12,2,1.5888400000000003,0.9984000000000001,56160,18100,61920,completed
336,38669,1365,1,0-2,1,0.190415625,0.1183,56160,17491,57525,completed
338,38746,2008,2,2-6,2,0.5878199999999999,0.3480533333333333,56160,17414,58168,completed
342,38982,1575,1,2-6,1,0.22300625000000002,0.1365,56160,17178,57735,completed
344,39119,1921,1,2-6,1,0.27966375,0.16648666666666667,56160,17041,58081,completed
345,39130,1910,1,2-6,1,0.2778625,0.16553333333333334,56160,17030,58070,completed
346,39130,1910,1,2-6,1,0.2778625,0.16553333333333334,56160,17030,58070,completed
349,39185,1855,2,2-6,2,0.5377124999999999,0.32153333333333334,56160,16975,58015,completed
352,39249,1697,1,2-6,1,0.24298375,0.14707333333333333,56160,16911,57857,completed
368,41387,47,1,0-2,1,0.00654409722222222,0.004073333333333333,56160,14773,56207,completed
370,42489,1440,1,0-2,1,0.2009,0.12480000000000001,56160,13671,57600,completed
371,42594,1440,1,0-2,1,0.2009,0.12480000000000001,56160,13566,57600,completed
372,42783,496,1,0-2,1,0.0690611111111111,0.042986666666666666,56160,13377,56656,completed
373,42786,849,1,0-2,1,0.11828312499999998,0.07358,56160,13374,57009,completed
374,43771,1440,1,0-2,1,0.2009,0.12480000000000001,56160,12389,57600,completed
380,44187,1440,1,0-2,1,0.2009,0.12480000000000001,56160,11973,57600,completed
389,44928,1440,1,0-2,1,0.2009,0.12480000000000001,56160,11232,57600,completed
397,45674,559,1,0-2,1,0.07783298611111111,0.048446666666666666,56160,10486,56719,completed
401,45811,1440,1,0-2,1,0.2009,0.12480000000000001,56160,10349,57600,completed
405,46610,190,4,0-2,3-4,0.10581944444444441,0.06586666666666667,56160,9550,56350,completed
406,46681,44,1,0-2,1,0.006126388888888888,0.0038133333333333335,56160,9479,56204,completed
436,51611,627,2,0-2,2,0.1746020833333333,0.10868,56160,4549,56787,completed
437,51799,51,1,0-2,1,0.007101041666666666,0.00442,56160,4361,56211,completed
438,52072,1154,1,0-2,1,0.16091958333333334,0.10001333333333333,56160,4088,57314,completed
440,52367,1299,1,0-2,1,0.181189375,0.11258,56160,3793,57459,completed
442,52367,1348,1,0-2,1,0.18803916666666667,0.11682666666666666,56160,3793,57508,completed
447,52368,277,1,0-2,1,0.038568402777777774,0.024006666666666666,56160,3792,56437,completed
448,52368,277,1,0-2,1,0.038568402777777774,0.024006666666666666,56160,3792,56437,completed
452,53549,397,2,0-2,2,0.1105534722222222,0.06881333333333334,56160,2611,56557,completed
453,53555,445,1,0-2,1,0.061960069444444425,0.038566666666666666,56160,2605,56605,completed
454,53584,132,1,0-2,1,0.018379166666666665,0.01144,56160,2576,56292,completed
344,39119,1582,1,2-6,1,0.18898494444444447,0.0,58320,19201,59902,completed
345,39130,2924,1,6-12,1,0.37412611111111116,0.0,58320,19190,61244,completed
346,39130,2924,1,6-12,1,0.37412611111111116,0.2534133333333333,58320,19190,61244,completed
349,39185,684,2,0-2,2,0.17491400000000001,0.11856,58320,19135,59004,completed
368,41387,1440,1,0-2,1,0.16903,0.12480000000000001,58320,16933,59760,completed
370,42489,1501,1,2-6,1,0.17760219444444447,0.13008666666666666,58320,15831,59821,completed
371,42594,3145,1,6-12,1,0.40730680555555565,0.2725666666666667,58320,15726,61465,completed
372,42783,1440,1,0-2,1,0.16903,0.12480000000000001,58320,15537,59760,completed
373,42786,1440,1,0-2,1,0.16903,0.12480000000000001,58320,15534,59760,completed
374,43771,3029,1,6-12,1,0.3898906944444445,0.2625133333333333,58320,14549,61349,completed
380,44187,1450,1,2-6,1,0.17043527777777778,0.12566666666666668,58320,14133,59770,completed
389,44928,2880,1,2-6,1,0.36752000000000007,0.24960000000000002,58320,13392,61200,completed
397,45674,1440,1,0-2,1,0.16903,0.12480000000000001,58320,12646,59760,completed
401,45811,2880,1,2-6,1,0.36752000000000007,0.24960000000000002,58320,12509,61200,completed
405,46610,1440,4,0-2,3-4,0.67612,0.49920000000000003,58320,11710,59760,completed
406,46681,1440,1,0-2,1,0.16903,0.12480000000000001,58320,11639,59760,completed
411,47790,450,4,0-2,3-4,0.23015000000000002,0.156,58320,10530,58770,completed
414,48049,191,1,0-2,1,0.024421472222222226,0.016553333333333333,58320,10271,58511,completed
453,53555,35,1,0-2,1,0.004475138888888888,0.003033333333333333,58320,4765,58355,completed
463,56269,11,1,0-2,1,0.0014064722222222224,0.0009533333333333334,58320,2051,58331,completed
466,56456,199,1,0-2,1,0.02544436111111112,0.017246666666666667,58320,1864,58519,completed
467,56645,203,1,0-2,1,0.02595580555555556,0.017593333333333332,58320,1675,58523,completed
411,47790,720,4,0-2,3-4,0.30788000000000004,0.24960000000000002,59040,11250,59760,completed
414,48049,720,1,0-2,1,0.07697000000000001,0.0,59040,10991,59760,completed
419,48727,720,2,0-2,2,0.15394000000000002,0.12480000000000001,59040,10313,59760,completed
431,51075,720,1,0-2,1,0.07697000000000001,0.062400000000000004,59040,7965,59760,completed
432,51154,720,1,0-2,1,0.07697000000000001,0.062400000000000004,59040,7886,59760,completed
434,51515,720,1,0-2,1,0.07697000000000001,0.062400000000000004,59040,7525,59760,completed
439,52366,720,1,0-2,1,0.07697000000000001,0.062400000000000004,59040,6674,59760,completed
446,52367,720,1,0-2,1,0.07697000000000001,0.062400000000000004,59040,6673,59760,completed
443,52367,720,1,0-2,1,0.07697000000000001,0.062400000000000004,59040,6673,59760,completed
444,52367,720,1,0-2,1,0.07697000000000001,0.062400000000000004,59040,6673,59760,completed
445,52367,720,1,0-2,1,0.07697000000000001,0.062400000000000004,59040,6673,59760,completed
441,52367,720,1,0-2,1,0.07697000000000001,0.062400000000000004,59040,6673,59760,completed
449,52785,720,1,0-2,1,0.07697000000000001,0.062400000000000004,59040,6255,59760,completed
450,53223,720,1,0-2,1,0.07697000000000001,0.062400000000000004,59040,5817,59760,completed
451,53310,720,1,0-2,1,0.07697000000000001,0.062400000000000004,59040,5730,59760,completed
455,55418,720,1,0-2,1,0.07697000000000001,0.062400000000000004,59040,3622,59760,completed
456,55423,720,1,0-2,1,0.07697000000000001,0.062400000000000004,59040,3617,59760,completed
460,55424,720,1,0-2,1,0.07697000000000001,0.062400000000000004,59040,3616,59760,completed
457,55424,720,1,0-2,1,0.07697000000000001,0.062400000000000004,59040,3616,59760,completed
459,55424,720,1,0-2,1,0.07697000000000001,0.062400000000000004,59040,3616,59760,completed
458,55424,720,1,0-2,1,0.07697000000000001,0.062400000000000004,59040,3616,59760,completed
461,55453,707,1,0-2,1,0.07558026388888889,0.06127333333333333,59040,3587,59747,completed
462,56158,691,1,0-2,1,0.07386981944444446,0.059886666666666664,59040,2882,59731,completed
463,56269,720,1,0-2,1,0.07697000000000001,0.062400000000000004,59040,2771,59760,completed
465,56454,257,1,0-2,1,0.02747401388888889,0.022273333333333332,59040,2586,59297,completed
466,56456,720,1,0-2,1,0.07697000000000001,0.062400000000000004,59040,2584,59760,completed
467,56645,720,1,0-2,1,0.07697000000000001,0.062400000000000004,59040,2395,59760,completed
471,57157,306,1,0-2,1,0.03271225,0.026520000000000002,59040,1883,59346,completed
472,57384,160,1,0-2,1,0.017104444444444446,0.013866666666666666,59040,1656,59200,completed
473,57541,91,1,0-2,1,0.009728152777777777,0.007886666666666667,59040,1499,59131,completed
474,57542,318,1,0-2,1,0.03399508333333333,0.02756,59040,1498,59358,completed
475,57699,105,1,0-2,1,0.011224791666666668,0.0091,59040,1341,59145,completed
476,57839,365,1,0-2,1,0.039019513888888885,0.03163333333333333,59040,1201,59405,completed
477,57840,544,1,0-2,1,0.058155111111111116,0.04714666666666667,59040,1200,59584,completed
478,57919,67,1,0-2,1,0.007162486111111112,0.005806666666666667,59040,1121,59107,completed
479,58363,664,1,0-2,1,0.07098344444444446,0.05754666666666667,59040,677,59704,completed
480,58498,257,1,0-2,1,0.02747401388888889,0.022273333333333332,59040,542,59297,completed
481,58787,245,1,0-2,1,0.026191180555555554,0.021233333333333333,59040,253,59285,completed
482,59218,130,1,0-2,1,0.013897361111111112,0.011266666666666666,59218,0,59348,completed
483,59286,474,1,0-2,1,0.05067191666666668,0.04108,59286,0,59760,completed
488,60350,31,1,0-2,1,0.00435636111111111,0.0,60350,0,60381,completed
370,42489,720,1,0-2,1,0.09731000000000004,0.0,60480,17991,61200,completed
372,42783,720,1,0-2,1,0.09731000000000004,0.0,60480,17697,61200,completed
373,42786,720,1,0-2,1,0.09731000000000004,0.062400000000000004,60480,17694,61200,completed
380,44187,720,1,0-2,1,0.09731000000000004,0.062400000000000004,60480,16293,61200,completed
397,45674,720,1,0-2,1,0.09731000000000004,0.062400000000000004,60480,14806,61200,completed
405,46610,720,4,0-2,3-4,0.38924000000000014,0.24960000000000002,60480,13870,61200,completed
406,46681,720,1,0-2,1,0.09731000000000004,0.062400000000000004,60480,13799,61200,completed
483,59286,143,1,0-2,1,0.01932684722222222,0.012393333333333334,60480,1194,60623,completed
488,60350,720,1,0-2,1,0.09731000000000004,0.062400000000000004,60480,130,61200,completed
491,61146,54,1,0-2,1,0.007298249999999998,0.00468,61146,0,61200,completed
492,61158,42,1,0-2,1,0.005676416666666666,0.00364,61158,0,61200,completed
493,61159,41,1,0-2,1,0.005541263888888889,0.0035533333333333333,61159,0,61200,completed
224,24763,16560,1,24-48,1,2.03291,0.0,64080,39317,80640,completed
193,21039,4788,2,6-12,2,1.2440600000000002,0.0,64800,43761,69588,completed
267,29723,5740,1,6-12,1,0.7237322222222222,0.0,64800,35077,70540,completed
303,34398,10129,2,12-24,2,2.637057861111111,0.0,64800,30402,74929,completed
328,37065,1143,1,0-2,1,0.19494175000000002,0.0,64800,27735,65943,completed
374,43771,177,1,0-2,1,0.02557158333333334,0.0,65520,21749,65697,completed
389,44928,217,1,0-2,1,0.03135047222222223,0.0,65520,20592,65737,completed
401,45811,269,1,0-2,1,0.03886302777777778,0.023313333333333335,65520,19709,65789,completed
491,61146,83,1,0-2,1,0.011991194444444448,0.007193333333333334,65520,4374,65603,completed
492,61158,81,1,0-2,1,0.011702250000000003,0.00702,65520,4362,65601,completed
493,61159,80,1,0-2,1,0.01155777777777778,0.006933333333333333,65520,4361,65600,completed
494,61220,427,2,0-2,2,0.1233792777777778,0.07401333333333333,65520,4300,65947,completed
495,61226,156,2,0-2,2,0.04507533333333334,0.02704,65520,4294,65676,completed
497,61312,431,1,0-2,1,0.06226752777777779,0.037353333333333336,65520,4208,65951,completed
496,61312,431,1,0-2,1,0.06226752777777779,0.037353333333333336,65520,4208,65951,completed
498,61330,590,1,0-2,1,0.08523861111111113,0.051133333333333336,65520,4190,66110,completed
500,61602,318,1,0-2,1,0.04594216666666667,0.02756,65520,3918,65838,completed
501,61704,216,1,0-2,1,0.031206000000000005,0.01872,65520,3816,65736,completed
502,61805,115,1,0-2,1,0.01661430555555556,0.009966666666666667,65520,3715,65635,completed
506,62191,449,1,0-2,1,0.06486802777777778,0.038913333333333334,65520,3329,65969,completed
389,44928,5760,1,6-12,1,0.67321,0.0,66240,21312,72000,completed
401,45811,5760,1,6-12,1,0.67321,0.0,66240,20429,72000,completed
405,46610,4181,4,6-12,3-4,1.8924117777777778,1.4494133333333334,66240,19630,70421,completed
411,47790,1089,4,0-2,3-4,0.5244710000000001,0.37752,66240,18450,67329,completed
414,48049,860,1,0-2,1,0.10547611111111113,0.0,66240,18191,67100,completed
419,48727,233,2,0-2,2,0.058120555555555564,0.04038666666666667,66240,17513,66473,completed
455,55418,182,1,0-2,1,0.022699444444444446,0.015773333333333334,66240,10822,66422,completed
456,55423,1,1,0-2,1,0.00012472222222222222,8.666666666666667e-05,66240,10817,66241,completed
458,55424,348,1,0-2,1,0.043403333333333335,0.03016,66240,10816,66588,completed
460,55424,327,1,0-2,1,0.04078416666666666,0.02834,66240,10816,66567,completed
459,55424,267,1,0-2,1,0.033300833333333335,0.02314,66240,10816,66507,completed
498,61330,122,1,0-2,1,0.015216111111111113,0.010573333333333334,66240,4910,66362,completed
500,61602,283,1,0-2,1,0.03529638888888889,0.024526666666666665,66240,4638,66523,completed
501,61704,425,1,0-2,1,0.053006944444444454,0.036833333333333336,66240,4536,66665,completed
502,61805,859,1,0-2,1,0.1053641388888889,0.07444666666666666,66240,4435,67099,completed
503,62001,206,1,0-2,1,0.02569277777777778,0.017853333333333332,66240,4239,66446,completed
504,62001,508,1,0-2,1,0.06335888888888888,0.044026666666666665,66240,4239,66748,completed
506,62191,5760,1,6-12,1,0.67321,0.49920000000000003,66240,4049,72000,completed
507,62292,348,1,0-2,1,0.043403333333333335,0.03016,66240,3948,66588,completed
508,62553,87,1,0-2,1,0.010850833333333334,0.00754,66240,3687,66327,completed
510,63097,5376,1,6-12,1,0.6181166666666666,0.46592,66240,3143,71616,completed
419,48727,3404,2,6-12,2,0.7543635555555557,0.5900266666666667,66960,18233,70364,completed
434,51515,1765,1,2-6,1,0.19863715277777783,0.15296666666666667,66960,15445,68725,completed
446,52367,1440,1,0-2,1,0.16040000000000007,0.12480000000000001,66960,14593,68400,completed
444,52367,1440,1,0-2,1,0.16040000000000007,0.12480000000000001,66960,14593,68400,completed
441,52367,1440,1,0-2,1,0.16040000000000007,0.12480000000000001,66960,14593,68400,completed
449,52785,495,1,0-2,1,0.055426250000000024,0.0429,66960,14175,67455,completed
450,53223,57,1,0-2,1,0.006382416666666669,0.00494,66960,13737,67017,completed
455,55418,4320,1,6-12,1,0.48011000000000004,0.3744,66960,11542,71280,completed
456,55423,4320,1,6-12,1,0.48011000000000004,0.3744,66960,11537,71280,completed
460,55424,4320,1,6-12,1,0.48011000000000004,0.3744,66960,11536,71280,completed
458,55424,4320,1,6-12,1,0.48011000000000004,0.3744,66960,11536,71280,completed
457,55424,2082,1,2-6,1,0.23593308333333338,0.18044,66960,11536,69042,completed
459,55424,4320,1,6-12,1,0.48011000000000004,0.3744,66960,11536,71280,completed
487,60129,53,1,0-2,1,0.005934527777777781,0.004593333333333334,66960,6831,67013,completed
507,62292,271,1,0-2,1,0.03034447222222223,0.023486666666666666,66960,4668,67231,completed
508,62553,302,1,0-2,1,0.03381561111111112,0.026173333333333333,66960,4407,67262,completed
509,62705,655,1,0-2,1,0.07334180555555558,0.05676666666666667,66960,4255,67615,completed
511,63329,31,1,0-2,1,0.003471138888888888,0.0026866666666666666,66960,3631,66991,completed
431,51075,301,1,0-2,1,0.03335247222222223,0.0,67680,16605,67981,completed
445,52367,153,1,0-2,1,0.016953250000000003,0.013260000000000001,67680,15313,67833,completed
449,52785,720,1,0-2,1,0.07978000000000003,0.062400000000000004,67680,14895,68400,completed
450,53223,720,1,0-2,1,0.07978000000000003,0.062400000000000004,67680,14457,68400,completed
451,53310,690,1,0-2,1,0.07645583333333336,0.0598,67680,14370,68370,completed
487,60129,720,1,0-2,1,0.07978000000000003,0.062400000000000004,67680,7551,68400,completed
509,62705,168,1,0-2,1,0.018615333333333338,0.01456,67680,4975,67848,completed
511,63329,186,1,0-2,1,0.02060983333333334,0.01612,67680,4351,67866,completed
512,63601,281,1,0-2,1,0.03113636111111112,0.024353333333333334,67680,4079,67961,completed
513,63622,113,1,0-2,1,0.012521027777777782,0.009793333333333333,67680,4058,67793,completed
514,64516,177,1,0-2,1,0.01961258333333334,0.01534,67680,3164,67857,completed
431,51075,1440,1,0-2,1,0.15311999999999998,0.0,69120,18045,70560,completed
432,51154,1199,1,0-2,1,0.12723927777777777,0.10391333333333333,69120,17966,70319,completed
434,51515,2160,1,2-6,1,0.235,0.1872,69120,17605,71280,completed
439,52366,884,1,0-2,1,0.09341177777777776,0.07661333333333334,69120,16754,70004,completed
445,52367,1440,1,0-2,1,0.15311999999999998,0.12480000000000001,69120,16753,70560,completed
443,52367,1275,1,0-2,1,0.13540083333333336,0.1105,69120,16753,70395,completed
446,52367,1633,1,2-6,1,0.17506838888888887,0.14152666666666666,69120,16753,70753,completed
444,52367,1633,1,2-6,1,0.17506838888888887,0.14152666666666666,69120,16753,70753,completed
441,52367,1633,1,2-6,1,0.17506838888888887,0.14152666666666666,69120,16753,70753,completed
449,52785,1440,1,0-2,1,0.15311999999999998,0.12480000000000001,69120,16335,70560,completed
450,53223,1440,1,0-2,1,0.15311999999999998,0.12480000000000001,69120,15897,70560,completed
451,53310,1440,1,0-2,1,0.15311999999999998,0.12480000000000001,69120,15810,70560,completed
457,55424,2160,1,2-6,1,0.235,0.1872,69120,13696,71280,completed
461,55453,720,1,0-2,1,0.0758,0.062400000000000004,69120,13667,69840,completed
464,56297,583,1,0-2,1,0.06137694444444444,0.050526666666666664,69120,12823,69703,completed
468,56835,45,1,0-2,1,0.0047375,0.0039000000000000003,69120,12285,69165,completed
484,59569,516,3,0-2,3-4,0.16296999999999998,0.13416,69120,9551,69636,completed
487,60129,1440,1,0-2,1,0.15311999999999998,0.12480000000000001,69120,8991,70560,completed
515,65228,557,3,0-2,3-4,0.17591916666666668,0.14482,69120,3892,69677,completed
517,65675,126,1,0-2,1,0.013264999999999994,0.010920000000000001,69120,3445,69246,completed
518,65700,114,1,0-2,1,0.012001666666666664,0.00988,69120,3420,69234,completed
521,65753,459,4,0-2,3-4,0.19328999999999996,0.15912,69120,3367,69579,completed
524,66003,955,1,0-2,1,0.10103638888888887,0.08276666666666667,69120,3117,70075,completed
525,66117,85,1,0-2,1,0.008948611111111109,0.007366666666666667,69120,3003,69205,completed
526,66143,412,1,0-2,1,0.04337444444444444,0.035706666666666664,69120,2977,69532,completed
527,66348,712,1,0-2,1,0.07495777777777779,0.06170666666666667,69120,2772,69832,completed
528,66571,118,1,0-2,1,0.012422777777777772,0.010226666666666667,69120,2549,69238,completed
531,68136,77,1,0-2,1,0.008106388888888889,0.006673333333333333,69120,984,69197,completed
532,68137,90,1,0-2,1,0.009474999999999999,0.0078000000000000005,69120,983,69210,completed
533,68294,753,2,0-2,2,0.15868766666666667,0.13052,69120,826,69873,completed
534,68348,762,1,0-2,1,0.08031033333333333,0.06604,69120,772,69882,completed
536,68479,91,1,0-2,1,0.009580277777777776,0.007886666666666667,69120,641,69211,completed
537,68645,362,1,0-2,1,0.03811055555555555,0.031373333333333336,69120,475,69482,completed
540,69143,2137,1,2-6,1,0.2325786111111111,0.18520666666666666,69143,0,71280,completed
543,69150,690,1,0-2,1,0.07264166666666667,0.0598,69150,0,69840,completed
542,69150,690,1,0-2,1,0.07264166666666667,0.0598,69150,0,69840,completed
545,69150,690,1,0-2,1,0.07264166666666667,0.0598,69150,0,69840,completed
549,69156,684,1,0-2,1,0.07201,0.05928,69156,0,69840,completed
548,69156,684,1,0-2,1,0.07201,0.05928,69156,0,69840,completed
550,69536,176,2,0-2,2,0.03705777777777778,0.030506666666666668,69536,0,69712,completed
401,45811,6293,1,12-24,1,0.5079897083333333,0.0,73440,27629,79733,completed
434,51515,5880,1,12-24,1,0.459445,0.0,73440,21925,79320,completed
444,52367,3505,1,6-12,1,0.2824085416666667,0.0,73440,21073,76945,completed
441,52367,3424,1,6-12,1,0.27653266666666665,0.0,73440,21073,76864,completed
446,52367,148,1,0-2,1,0.016169,0.0,73440,21073,73588,completed
449,52785,2430,1,2-6,1,0.20391375,0.0,73440,20655,75870,completed
450,53223,1294,1,0-2,1,0.1200278611111111,0.11214666666666667,73440,20217,74734,completed
451,53310,1174,1,0-2,1,0.11137952777777776,0.10174666666666667,73440,20130,74614,completed
455,55418,6480,1,12-24,1,0.52997,0.5616,73440,18022,79920,completed
456,55423,6480,1,12-24,1,0.52997,0.5616,73440,18017,79920,completed
458,55424,6480,1,12-24,1,0.52997,0.5616,73440,18016,79920,completed
460,55424,6480,1,12-24,1,0.52997,0.5616,73440,18016,79920,completed
457,55424,6480,1,12-24,1,0.52997,0.5616,73440,18016,79920,completed
459,55424,6480,1,12-24,1,0.52997,0.5616,73440,18016,79920,completed
487,60129,5760,1,6-12,1,0.44534,0.49920000000000003,73440,13311,79200,completed
506,62191,6480,1,12-24,1,0.52997,0.5616,73440,11249,79920,completed
510,63097,6480,1,12-24,1,0.52997,0.5616,73440,10343,79920,completed
540,69143,6480,1,12-24,1,0.52997,0.5616,73440,4297,79920,completed
461,55453,3942,1,6-12,1,0.28228,0.0,74160,18707,78102,completed
464,56297,970,1,0-2,1,0.07045597222222222,0.08406666666666666,74160,17863,75130,completed
468,56835,3112,1,6-12,1,0.226561,0.26970666666666665,74160,17325,77272,completed
469,56909,4358,1,6-12,1,0.3100076944444444,0.3776933333333333,74160,17251,78518,completed
470,57089,1231,3,0-2,3-4,0.2695165416666666,0.32006,74160,17071,75391,completed
484,59569,5040,3,6-12,3-4,1.10004,1.3104,74160,14591,79200,completed
485,59825,967,1,0-2,1,0.07023318055555557,0.08380666666666667,74160,14335,75127,completed
486,59996,1074,1,0-2,1,0.07817941666666667,0.09308,74160,14164,75234,completed
489,60658,306,1,0-2,1,0.02205325,0.026520000000000002,74160,13502,74466,completed
490,61016,132,1,0-2,1,0.009513166666666665,0.01144,74160,13144,74292,completed
499,61384,169,4,0-2,3-4,0.04871894444444445,0.05858666666666667,74160,12776,74329,completed
505,62004,720,1,0-2,1,0.051890000000000006,0.062400000000000004,74160,12156,74880,completed
516,65662,4909,1,6-12,1,0.3557942638888889,0.4254466666666667,74160,8498,79069,completed
519,65748,337,1,0-2,1,0.02428740277777778,0.029206666666666665,74160,8412,74497,completed
520,65752,720,1,0-2,1,0.051890000000000006,0.062400000000000004,74160,8408,74880,completed
522,65754,638,1,0-2,1,0.04598030555555556,0.05529333333333333,74160,8406,74798,completed
523,65776,720,1,0-2,1,0.051890000000000006,0.062400000000000004,74160,8384,74880,completed
529,67484,720,1,0-2,1,0.051890000000000006,0.062400000000000004,74160,6676,74880,completed
530,67621,720,1,0-2,1,0.051890000000000006,0.062400000000000004,74160,6539,74880,completed
535,68351,720,3,0-2,3-4,0.15567000000000003,0.1872,74160,5809,74880,completed
538,68776,60,1,0-2,1,0.0043241666666666645,0.0052,74160,5384,74220,completed
539,68928,88,2,0-2,2,0.012684222222222223,0.015253333333333334,74160,5232,74248,completed
543,69150,704,1,0-2,1,0.050736888888888894,0.061013333333333336,74160,5010,74864,completed
546,69150,69,1,0-2,1,0.004972791666666664,0.00598,74160,5010,74229,completed
541,69150,81,1,0-2,1,0.005837625,0.00702,74160,5010,74241,completed
545,69150,566,1,0-2,1,0.04079130555555555,0.04905333333333333,74160,5010,74726,completed
542,69150,602,1,0-2,1,0.04338580555555556,0.052173333333333335,74160,5010,74762,completed
544,69150,79,1,0-2,1,0.005693486111111108,0.006846666666666667,74160,5010,74239,completed
547,69152,333,1,0-2,1,0.023999125,0.02886,74160,5008,74493,completed
548,69156,366,1,0-2,1,0.026377416666666667,0.03172,74160,5004,74526,completed
549,69156,285,1,0-2,1,0.020539791666666665,0.0247,74160,5004,74445,completed
551,70034,720,1,0-2,1,0.051890000000000006,0.062400000000000004,74160,4126,74880,completed
552,70055,720,1,0-2,1,0.051890000000000006,0.062400000000000004,74160,4105,74880,completed
553,70088,720,1,0-2,1,0.051890000000000006,0.062400000000000004,74160,4072,74880,completed
554,70122,686,2,0-2,2,0.09887927777777777,0.11890666666666667,74160,4038,74846,completed
555,70789,333,2,0-2,2,0.04799825,0.05772,74160,3371,74493,completed
556,70912,435,1,0-2,1,0.03135020833333334,0.0377,74160,3248,74595,completed
557,71499,217,3,0-2,3-4,0.046917208333333335,0.05642,74160,2661,74377,completed
558,72030,526,1,0-2,1,0.03790852777777778,0.045586666666666664,74160,2130,74686,completed
559,72338,105,1,0-2,1,0.0075672916666666675,0.0091,74160,1822,74265,completed
568,73653,407,1,0-2,1,0.02933226388888889,0.03527333333333334,74160,507,74567,completed
575,73838,584,1,0-2,1,0.04208855555555556,0.05061333333333334,74160,322,74744,completed
578,73925,500,1,0-2,1,0.03603472222222222,0.043333333333333335,74160,235,74660,completed
579,73971,536,1,0-2,1,0.03862922222222222,0.04645333333333333,74160,189,74696,completed
580,73972,720,1,0-2,1,0.051890000000000006,0.062400000000000004,74160,188,74880,completed
581,73974,720,1,0-2,1,0.051890000000000006,0.062400000000000004,74160,186,74880,completed
470,57089,2206,3,2-6,3-4,0.47303999999999996,0.57356,75600,18511,77806,completed
485,59825,2880,1,2-6,1,0.20149,0.0,75600,15775,78480,completed
486,59996,2880,1,2-6,1,0.20149,0.0,75600,15604,78480,completed
523,65776,341,1,0-2,1,0.02512506944444444,0.029553333333333334,75600,9824,75941,completed
535,68351,467,3,0-2,3-4,0.10322645833333334,0.12142,75600,7249,76067,completed
505,62004,371,1,0-2,1,0.02691295833333334,0.0,76320,14316,76691,completed
520,65752,368,1,0-2,1,0.02669533333333334,0.031893333333333336,76320,10568,76688,completed
523,65776,2160,1,2-6,1,0.14844,0.1872,76320,10544,78480,completed
529,67484,424,1,0-2,1,0.030757666666666673,0.03674666666666667,76320,8836,76744,completed
530,67621,428,1,0-2,1,0.03104783333333334,0.03709333333333333,76320,8699,76748,completed
535,68351,2160,3,2-6,3-4,0.44531999999999994,0.5616,76320,7969,78480,completed
551,70034,486,1,0-2,1,0.035255250000000016,0.04212,76320,6286,76806,completed
552,70055,437,1,0-2,1,0.03170070833333334,0.037873333333333335,76320,6265,76757,completed
553,70088,378,1,0-2,1,0.027420750000000008,0.03276,76320,6232,76698,completed
580,73972,688,1,0-2,1,0.04990866666666667,0.05962666666666667,76320,2348,77008,completed
581,73974,302,1,0-2,1,0.021907583333333334,0.026173333333333333,76320,2346,76622,completed
590,76739,2461,1,2-6,1,0.17787504166666668,0.0,76739,0,79200,completed
591,76755,1813,1,2-6,1,0.12419693055555553,0.15712666666666666,76755,0,78568,completed
592,76756,2444,1,2-6,1,0.17664183333333333,0.21181333333333333,76756,0,79200,completed
593,76767,3153,1,6-12,1,0.26047387499999997,0.27326,76767,0,79920,completed
595,77026,2174,1,2-6,1,0.15705558333333333,0.0,77026,0,79200,completed
489,60658,1440,1,0-2,1,0.09620999999999999,0.0,77040,16382,78480,completed
490,61016,1440,1,0-2,1,0.09620999999999999,0.12480000000000001,77040,16024,78480,completed
499,61384,1440,4,0-2,3-4,0.38483999999999996,0.49920000000000003,77040,15656,78480,completed
505,62004,1440,1,0-2,1,0.09620999999999999,0.12480000000000001,77040,15036,78480,completed
519,65748,1440,1,0-2,1,0.09620999999999999,0.12480000000000001,77040,11292,78480,completed
520,65752,1440,1,0-2,1,0.09620999999999999,0.12480000000000001,77040,11288,78480,completed
522,65754,1440,1,0-2,1,0.09620999999999999,0.12480000000000001,77040,11286,78480,completed
529,67484,1440,1,0-2,1,0.09620999999999999,0.12480000000000001,77040,9556,78480,completed
530,67621,1440,1,0-2,1,0.09620999999999999,0.12480000000000001,77040,9419,78480,completed
538,68776,1440,1,0-2,1,0.09620999999999999,0.12480000000000001,77040,8264,78480,completed
539,68928,1440,2,0-2,2,0.19241999999999998,0.24960000000000002,77040,8112,78480,completed
541,69150,1440,1,0-2,1,0.09620999999999999,0.12480000000000001,77040,7890,78480,completed
546,69150,1440,1,0-2,1,0.09620999999999999,0.12480000000000001,77040,7890,78480,completed
544,69150,1440,1,0-2,1,0.09620999999999999,0.12480000000000001,77040,7890,78480,completed
547,69152,1440,1,0-2,1,0.09620999999999999,0.12480000000000001,77040,7888,78480,completed
551,70034,1440,1,0-2,1,0.09620999999999999,0.12480000000000001,77040,7006,78480,completed
552,70055,1440,1,0-2,1,0.09620999999999999,0.12480000000000001,77040,6985,78480,completed
553,70088,1440,1,0-2,1,0.09620999999999999,0.12480000000000001,77040,6952,78480,completed
558,72030,1440,1,0-2,1,0.09620999999999999,0.12480000000000001,77040,5010,78480,completed
560,72783,120,1,0-2,1,0.008235,0.0104,77040,4257,77160,completed
561,72897,543,1,0-2,1,0.03726337499999999,0.04706,77040,4143,77583,completed
562,72955,554,1,0-2,1,0.03801824999999999,0.04801333333333333,77040,4085,77594,completed
563,73115,148,1,0-2,1,0.010156499999999999,0.012826666666666667,77040,3925,77188,completed
564,73391,49,1,0-2,1,0.0033626249999999997,0.004246666666666667,77040,3649,77089,completed
565,73422,718,1,0-2,1,0.04927274999999999,0.062226666666666666,77040,3618,77758,completed
568,73653,1440,1,0-2,1,0.09620999999999999,0.12480000000000001,77040,3387,78480,completed
569,73662,144,1,0-2,1,0.009881999999999998,0.01248,77040,3378,77184,completed
570,73759,71,1,0-2,1,0.004872375,0.006153333333333334,77040,3281,77111,completed
571,73764,562,1,0-2,1,0.03856724999999999,0.04870666666666667,77040,3276,77602,completed
572,73770,223,1,0-2,1,0.015303374999999994,0.019326666666666666,77040,3270,77263,completed
573,73794,294,1,0-2,1,0.02017575,0.02548,77040,3246,77334,completed
574,73816,648,1,0-2,1,0.044468999999999995,0.05616,77040,3224,77688,completed
575,73838,1440,1,0-2,1,0.09620999999999999,0.12480000000000001,77040,3202,78480,completed
577,73925,480,1,0-2,1,0.03294,0.0416,77040,3115,77520,completed
578,73925,1440,1,0-2,1,0.09620999999999999,0.12480000000000001,77040,3115,78480,completed
579,73971,1440,1,0-2,1,0.09620999999999999,0.12480000000000001,77040,3069,78480,completed
580,73972,1440,1,0-2,1,0.09620999999999999,0.12480000000000001,77040,3068,78480,completed
581,73974,1440,1,0-2,1,0.09620999999999999,0.12480000000000001,77040,3066,78480,completed
582,74054,654,1,0-2,1,0.04488075,0.05668,77040,2986,77694,completed
585,74877,433,1,0-2,1,0.029714624999999998,0.037526666666666667,77040,2163,77473,completed
586,74878,226,1,0-2,1,0.015509249999999999,0.019586666666666665,77040,2162,77266,completed
561,72897,128,1,0-2,1,0.008319999999999998,0.011093333333333334,77760,4863,77888,completed
562,72955,720,1,0-2,1,0.04679999999999999,0.062400000000000004,77760,4805,78480,completed
564,73391,530,1,0-2,1,0.034449999999999995,0.04593333333333333,77760,4369,78290,completed
565,73422,720,1,0-2,1,0.04679999999999999,0.062400000000000004,77760,4338,78480,completed
566,73571,682,1,0-2,1,0.044329999999999994,0.05910666666666667,77760,4189,78442,completed
567,73593,472,1,0-2,1,0.03067999999999999,0.04090666666666667,77760,4167,78232,completed
569,73662,720,1,0-2,1,0.04679999999999999,0.062400000000000004,77760,4098,78480,completed
570,73759,720,1,0-2,1,0.04679999999999999,0.062400000000000004,77760,4001,78480,completed
571,73764,720,1,0-2,1,0.04679999999999999,0.062400000000000004,77760,3996,78480,completed
572,73770,720,1,0-2,1,0.04679999999999999,0.062400000000000004,77760,3990,78480,completed
573,73794,720,1,0-2,1,0.04679999999999999,0.062400000000000004,77760,3966,78480,completed
574,73816,720,1,0-2,1,0.04679999999999999,0.062400000000000004,77760,3944,78480,completed
576,73878,649,1,0-2,1,0.042184999999999986,0.05624666666666667,77760,3882,78409,completed
577,73925,720,1,0-2,1,0.04679999999999999,0.062400000000000004,77760,3835,78480,completed
582,74054,720,1,0-2,1,0.04679999999999999,0.062400000000000004,77760,3706,78480,completed
583,74174,62,1,0-2,1,0.00403,0.005373333333333333,77760,3586,77822,completed
584,74275,62,1,0-2,1,0.00403,0.005373333333333333,77760,3485,77822,completed
585,74877,720,1,0-2,1,0.04679999999999999,0.062400000000000004,77760,2883,78480,completed
586,74878,720,1,0-2,1,0.04679999999999999,0.062400000000000004,77760,2882,78480,completed
588,75379,198,1,0-2,1,0.012869999999999996,0.01716,77760,2381,77958,completed
587,75379,692,1,0-2,1,0.04497999999999999,0.05997333333333334,77760,2381,78452,completed
589,75854,692,1,0-2,1,0.04497999999999999,0.05997333333333334,77760,1906,78452,completed
594,76796,258,1,0-2,1,0.016769999999999997,0.02236,77760,964,78018,completed
596,77317,392,1,0-2,1,0.025479999999999992,0.033973333333333335,77760,443,78152,completed
597,77736,118,1,0-2,1,0.007669999999999997,0.010226666666666667,77760,24,77878,completed
598,77778,129,1,0-2,1,0.008385,0.01118,77778,0,77907,completed
599,78040,64,1,0-2,1,0.00416,0.005546666666666667,78040,0,78104,completed
600,78044,62,1,0-2,1,0.00403,0.005373333333333333,78044,0,78106,completed
601,78351,849,1,0-2,1,0.06821500000000001,0.0,78351,0,79200,completed
602,78351,1569,1,2-6,1,0.15284499999999998,0.13598,78351,0,79920,completed
603,78423,149,1,0-2,1,0.011349944444444447,0.012913333333333334,78423,0,78572,completed
604,78425,136,1,0-2,1,0.010305875000000003,0.011786666666666668,78425,0,78561,completed
605,78430,162,1,0-2,1,0.012556888888888892,0.01404,78430,0,78592,completed
606,78800,511,1,0-2,1,0.046286013888888894,0.0,78800,0,79311,completed
607,78848,1058,1,0-2,1,0.11223463888888888,0.0,78848,0,79906,completed
608,79013,1119,1,0-2,1,0.1402283472222222,0.0,79013,0,80132,completed
609,79046,83,1,0-2,1,0.006897069444444446,0.007193333333333334,79046,0,79129,completed
610,79049,1342,1,0-2,1,0.18617705555555553,0.11630666666666667,79049,0,80391,completed
611,79067,1104,1,0-2,1,0.1431104722222222,0.09568,79067,0,80171,completed
612,79103,1369,1,0-2,1,0.19699543055555552,0.11864666666666666,79103,0,80472,completed
613,79134,409,1,0-2,1,0.04580120833333332,0.03544666666666667,79134,0,79543,completed
614,79134,320,1,0-2,1,0.035339999999999996,0.027733333333333332,79134,0,79454,completed
615,79145,1191,1,0-2,1,0.16780701388888886,0.10322,79145,0,80336,completed
616,79182,1062,1,0-2,1,0.14734824999999996,0.09204,79182,0,80244,completed
618,79555,853,1,0-2,1,0.135114375,0.0,79555,0,80408,completed
619,80266,119,1,0-2,1,0.022486041666666665,0.0,80266,0,80385,completed
224,24763,1480,1,2-6,1,0.33863,0.0,83520,58757,85000,completed
620,80684,567,1,0-2,1,0.09908325,0.0,84960,4276,85527,completed
621,80690,670,1,0-2,1,0.11708249999999999,0.0,84960,4270,85630,completed
622,81007,353,1,0-2,1,0.06168675,0.0,84960,3953,85313,completed
624,81107,253,1,0-2,1,0.044211749999999994,0.0,84960,3853,85213,completed
626,81326,34,1,0-2,1,0.005941499999999999,0.0,84960,3634,84994,completed
634,82122,3600,1,6-12,1,0.57351,0.0,84960,2838,88560,completed
621,80690,222,1,0-2,1,0.036263083333333335,0.0,85680,4990,85902,completed
622,81007,130,1,0-2,1,0.021235138888888894,0.0,85680,4673,85810,completed
624,81107,117,1,0-2,1,0.019111624999999997,0.0,85680,4573,85797,completed
626,81326,317,1,0-2,1,0.05178106944444446,0.0,85680,4354,85997,completed
627,81444,71,3,0-2,3-4,0.034792958333333346,0.0,85680,4236,85751,completed
628,81518,407,1,0-2,1,0.06648231944444444,0.0,85680,4162,86087,completed
630,81838,183,1,0-2,1,0.029892541666666675,0.01586,85680,3842,85863,completed
631,81861,219,1,0-2,1,0.03577304166666667,0.01898,85680,3819,85899,completed
632,81988,92,1,0-2,1,0.01502794444444445,0.007973333333333334,85680,3692,85772,completed
633,82056,24,1,0-2,1,0.003920333333333333,0.0020800000000000003,85680,3624,85704,completed
629,81691,269,1,0-2,1,0.04036120833333333,0.0,86400,4709,86669,completed
631,81861,259,1,0-2,1,0.03886079166666667,0.0,86400,4539,86659,completed
632,81988,137,1,0-2,1,0.020555708333333332,0.0,86400,4412,86537,completed
633,82056,74,1,0-2,1,0.011103083333333333,0.0,86400,4344,86474,completed
635,82448,133,1,0-2,1,0.019955541666666667,0.0,86400,3952,86533,completed
637,82658,609,4,0-2,3-4,0.3655015,0.21112,86400,3742,87009,completed
651,85178,257,4,0-2,3-4,0.15424283333333333,0.08909333333333333,86400,1222,86657,completed
657,85563,1440,1,0-2,1,0.21069999999999994,0.0,86400,837,87840,completed
660,86045,184,1,0-2,1,0.027607666666666662,0.0,86400,355,86584,completed
506,62191,720,1,0-2,1,0.10266999999999997,0.0,87120,24929,87840,completed
510,63097,720,1,0-2,1,0.10266999999999997,0.0,87120,24023,87840,completed
625,81161,329,1,0-2,1,0.0469144861111111,0.0,87120,5959,87449,completed
629,81691,720,1,0-2,1,0.10266999999999997,0.0,87120,5429,87840,completed
637,82658,720,4,0-2,3-4,0.4106799999999999,0.24960000000000002,87120,4462,87840,completed
640,82817,197,2,0-2,2,0.05618330555555555,0.0,87120,4303,87317,completed
641,83717,60,1,0-2,1,0.008555833333333335,0.0,87120,3403,87180,completed
642,83979,199,1,0-2,1,0.028376847222222217,0.017246666666666667,87120,3141,87319,completed
643,83998,80,2,0-2,2,0.02281555555555555,0.013866666666666666,87120,3122,87200,completed
644,84474,461,3,0-2,3-4,0.19721195833333324,0.11986000000000001,87120,2646,87581,completed
645,84511,517,3,0-2,3-4,0.22116829166666663,0.13442,87120,2609,87637,completed
646,84699,504,1,0-2,1,0.07186899999999999,0.043680000000000004,87120,2421,87624,completed
647,84705,228,2,0-2,2,0.06502433333333331,0.03952,87120,2415,87348,completed
648,84709,261,1,0-2,1,0.037217875,0.02262,87120,2411,87381,completed
649,84751,105,2,0-2,2,0.02994541666666666,0.0182,87120,2369,87225,completed
650,84908,76,2,0-2,2,0.02167477777777778,0.013173333333333334,87120,2212,87196,completed
651,85178,720,4,0-2,3-4,0.4106799999999999,0.24960000000000002,87120,1942,87840,completed
652,85293,270,1,0-2,1,0.03850125,0.0234,87120,1827,87390,completed
653,85354,666,4,0-2,3-4,0.3798789999999999,0.23088,87120,1766,87786,completed
654,85396,61,1,0-2,1,0.008698430555555558,0.005286666666666667,87120,1724,87181,completed
655,85418,63,1,0-2,1,0.008983625000000004,0.0054600000000000004,87120,1702,87183,completed
656,85495,493,1,0-2,1,0.07030043055555554,0.04272666666666667,87120,1625,87613,completed
658,85564,643,1,0-2,1,0.09169001388888887,0.05572666666666667,87120,1556,87763,completed
660,86045,720,1,0-2,1,0.10266999999999997,0.062400000000000004,87120,1075,87840,completed
662,86074,138,1,0-2,1,0.019678416666666664,0.01196,87120,1046,87258,completed
663,86296,125,1,0-2,1,0.01782465277777777,0.010833333333333334,87120,824,87245,completed
664,86522,385,1,0-2,1,0.054899930555555546,0.03336666666666667,87120,598,87505,completed
665,86604,172,1,0-2,1,0.02452672222222222,0.014906666666666667,87120,516,87292,completed
666,86701,93,1,0-2,1,0.013261541666666666,0.00806,87120,419,87213,completed
667,86819,325,2,0-2,2,0.09268819444444443,0.05633333333333333,87120,301,87445,completed
668,86844,231,1,0-2,1,0.03293995833333332,0.02002,87120,276,87351,completed
669,87124,450,1,0-2,1,0.06416874999999998,0.039,87124,0,87574,completed
671,87193,647,1,0-2,1,0.09226040277777775,0.0,87193,0,87840,completed
672,87228,403,1,0-2,1,0.05746668055555554,0.03492666666666667,87228,0,87631,completed
673,87262,578,1,0-2,1,0.08242119444444443,0.05009333333333334,87262,0,87840,completed
674,87361,479,2,0-2,2,0.13660813888888884,0.0,87361,0,87840,completed
675,87453,214,1,0-2,1,0.03051580555555555,0.0,87453,0,87667,completed
678,87484,356,1,0-2,1,0.0507646111111111,0.030853333333333333,87484,0,87840,completed
679,87592,248,1,0-2,1,0.03536411111111111,0.021493333333333333,87592,0,87840,completed
680,87691,146,1,0-2,1,0.020819194444444442,0.0,87691,0,87837,completed
634,82122,678,1,0-2,1,0.13629683333333337,0.0,90720,8598,91398,completed
634,82122,5760,1,6-12,1,0.7156199999999999,0.0,91440,9318,97200,completed
657,85563,5760,1,6-12,1,0.7156199999999999,0.0,91440,5877,97200,completed
671,87193,5760,1,6-12,1,0.7156199999999999,0.0,91440,4247,97200,completed
673,87262,5760,1,6-12,1,0.7156199999999999,0.0,91440,4178,97200,completed
690,88984,296,1,0-2,1,0.045805999999999986,0.0,91440,2456,91736,completed
674,87361,221,2,0-2,2,0.06738044444444444,0.0,92160,4799,92381,completed
678,87484,786,1,0-2,1,0.11864983333333332,0.0,92160,4676,92946,completed
679,87592,137,1,0-2,1,0.02088488888888889,0.0,92160,4568,92297,completed
681,88122,359,1,0-2,1,0.05472755555555556,0.0,92160,4038,92519,completed
682,88187,82,1,0-2,1,0.012500444444444444,0.0071066666666666665,92160,3973,92242,completed
683,88513,47,1,0-2,1,0.007164888888888891,0.004073333333333333,92160,3647,92207,completed
684,88524,36,1,0-2,1,0.0054880000000000016,0.00312,92160,3636,92196,completed
685,88528,32,1,0-2,1,0.004878222222222223,0.0027733333333333334,92160,3632,92192,completed
690,88984,5040,1,6-12,1,0.6042000000000001,0.4368,92160,3176,97200,completed
506,62191,333,1,0-2,1,0.04485325000000001,0.0,92880,30689,93213,completed
510,63097,4320,1,6-12,1,0.4944400000000001,0.0,92880,29783,97200,completed
540,69143,4236,1,6-12,1,0.4827546666666667,0.0,92880,23737,97116,completed
593,76767,45,1,0-2,1,0.00606125,0.0,92880,16113,92925,completed
602,78351,481,1,0-2,1,0.06478802777777778,0.04168666666666667,92880,14529,93361,completed
625,81161,4320,1,6-12,1,0.4944400000000001,0.3744,92880,11719,97200,completed
629,81691,4320,1,6-12,1,0.4944400000000001,0.3744,92880,11189,97200,completed
636,82581,4259,1,6-12,1,0.48595422222222223,0.36911333333333335,92880,10299,97139,completed
683,88513,34,1,0-2,1,0.0045796111111111116,0.002946666666666667,92880,4367,92914,completed
684,88524,585,1,0-2,1,0.07879625000000001,0.0507,92880,4356,93465,completed
685,88528,75,1,0-2,1,0.010102083333333334,0.0065,92880,4352,92955,completed
686,88622,120,1,0-2,1,0.016163333333333335,0.0104,92880,4258,93000,completed
687,88704,343,1,0-2,1,0.04620019444444445,0.02972666666666667,92880,4176,93223,completed
688,88704,345,1,0-2,1,0.04646958333333334,0.0299,92880,4176,93225,completed
689,88794,245,1,0-2,1,0.03300013888888889,0.021233333333333333,92880,4086,93125,completed
691,89062,218,1,0-2,1,0.02936338888888889,0.018893333333333335,92880,3818,93098,completed
692,89169,111,3,0-2,3-4,0.04485325,0.02886,92880,3711,92991,completed
693,89170,110,3,0-2,3-4,0.044449166666666665,0.0286,92880,3710,92990,completed
694,89211,69,1,0-2,1,0.009293916666666667,0.00598,92880,3669,92949,completed
593,76767,2880,1,2-6,1,0.2973,0.0,93600,16833,96480,completed
601,78351,526,1,0-2,1,0.056523083333333335,0.0,93600,15249,94126,completed
602,78351,2880,1,2-6,1,0.2973,0.0,93600,15249,96480,completed
623,81056,483,4,0-2,3-4,0.2076095,0.16744,93600,12544,94083,completed
638,82710,430,3,0-2,3-4,0.13862124999999997,0.1118,93600,10890,94030,completed
661,86070,489,1,0-2,1,0.052547125,0.04238,93600,7530,94089,completed
670,87136,597,1,0-2,1,0.06415262499999999,0.05174,93600,6464,94197,completed
691,89062,155,1,0-2,1,0.016656041666666666,0.013433333333333334,93600,4538,93755,completed
692,89169,56,3,0-2,3-4,0.018053,0.01456,93600,4431,93656,completed
693,89170,59,3,0-2,3-4,0.019020125000000002,0.01534,93600,4430,93659,completed
694,89211,890,1,0-2,1,0.09520347222222222,0.07713333333333333,93600,4389,94490,completed
695,89564,240,2,0-2,2,0.05158,0.0416,93600,4036,93840,completed
696,89577,68,1,0-2,1,0.0073071666666666675,0.005893333333333334,93600,4023,93668,completed
697,89631,369,1,0-2,1,0.039652125,0.03198,93600,3969,93969,completed
729,93257,2880,1,2-6,1,0.2973,0.24960000000000002,93600,343,96480,completed
590,76739,231,1,0-2,1,0.02423254166666667,0.0,94320,17581,94551,completed
592,76756,487,1,0-2,1,0.051087652777777784,0.04220666666666667,94320,17564,94807,completed
595,77026,539,1,0-2,1,0.05654259722222223,0.046713333333333336,94320,17294,94859,completed
601,78351,2160,1,2-6,1,0.21993000000000001,0.1872,94320,15969,96480,completed
617,79247,803,1,0-2,1,0.08436488888888889,0.06959333333333334,94320,15073,95123,completed
623,81056,2160,4,2-6,3-4,0.8797200000000001,0.7488,94320,13264,96480,completed
638,82710,2160,3,2-6,3-4,0.6597900000000001,0.5616,94320,11610,96480,completed
639,82755,2160,3,2-6,3-4,0.6597900000000001,0.5616,94320,11565,96480,completed
659,85675,796,1,0-2,1,0.08361977777777778,0.06898666666666667,94320,8645,95116,completed
661,86070,2160,1,2-6,1,0.21993000000000001,0.1872,94320,8250,96480,completed
670,87136,2160,1,2-6,1,0.21993000000000001,0.1872,94320,7184,96480,completed
676,87483,2160,1,2-6,1,0.21993000000000001,0.1872,94320,6837,96480,completed
677,87484,1307,1,0-2,1,0.1380128888888889,0.11327333333333334,94320,6836,95627,completed
697,89631,353,1,0-2,1,0.037030680555555556,0.030593333333333333,94320,4689,94673,completed
698,89770,935,1,0-2,1,0.09841555555555556,0.08103333333333333,94320,4550,95255,completed
699,90614,442,1,0-2,1,0.04636702777777778,0.03830666666666667,94320,3706,94762,completed
700,90619,460,1,0-2,1,0.048255277777777786,0.03986666666666667,94320,3701,94780,completed
701,90662,67,1,0-2,1,0.00702848611111111,0.005806666666666667,94320,3658,94387,completed
702,90818,823,1,0-2,1,0.08649377777777778,0.07132666666666666,94320,3502,95143,completed
703,90856,584,1,0-2,1,0.06126322222222222,0.05061333333333334,94320,3464,94904,completed
704,90966,474,1,0-2,1,0.04972391666666667,0.04108,94320,3354,94794,completed
705,91015,425,1,0-2,1,0.04458368055555556,0.036833333333333336,94320,3305,94745,completed
706,91063,550,1,0-2,1,0.05769652777777778,0.04766666666666667,94320,3257,94870,completed
707,91145,295,1,0-2,1,0.030946319444444446,0.025566666666666668,94320,3175,94615,completed
708,91221,219,1,0-2,1,0.022973708333333336,0.01898,94320,3099,94539,completed
709,91223,217,1,0-2,1,0.02276390277777778,0.018806666666666666,94320,3097,94537,completed
712,92117,538,1,0-2,1,0.05643769444444444,0.04662666666666667,94320,2203,94858,completed
714,92125,476,1,0-2,1,0.04993372222222223,0.041253333333333336,94320,2195,94796,completed
715,92125,164,1,0-2,1,0.01720405555555556,0.014213333333333333,94320,2195,94484,completed
716,92137,612,1,0-2,1,0.0642005,0.053040000000000004,94320,2183,94932,completed
720,92515,712,1,0-2,1,0.07469077777777777,0.06170666666666667,94320,1805,95032,completed
721,92665,875,1,0-2,1,0.09202888888888888,0.07583333333333334,94320,1655,95195,completed
722,92822,58,1,0-2,1,0.006084361111111111,0.005026666666666667,94320,1498,94378,completed
725,92944,924,1,0-2,1,0.09724466666666666,0.08008,94320,1376,95244,completed
728,93210,267,1,0-2,1,0.028009041666666665,0.02314,94320,1110,94587,completed
732,93778,159,1,0-2,1,0.016679541666666672,0.01378,94320,542,94479,completed
734,93825,649,1,0-2,1,0.06808190277777779,0.05624666666666667,94320,495,94969,completed
742,94690,602,1,0-2,1,0.06353997222222223,0.0,94690,0,95292,completed
747,94835,406,1,0-2,1,0.04290040277777778,0.035186666666666665,94835,0,95241,completed
748,94838,455,1,0-2,1,0.04812080555555555,0.039433333333333334,94838,0,95293,completed
753,95513,216,3,0-2,3-4,0.068976,0.05616,95513,0,95729,completed
590,76739,720,1,0-2,1,0.06775999999999999,0.0,95760,19021,96480,completed
592,76756,720,1,0-2,1,0.06775999999999999,0.062400000000000004,95760,19004,96480,completed
595,77026,720,1,0-2,1,0.06775999999999999,0.062400000000000004,95760,18734,96480,completed
617,79247,720,1,0-2,1,0.06775999999999999,0.062400000000000004,95760,16513,96480,completed
659,85675,720,1,0-2,1,0.06775999999999999,0.062400000000000004,95760,10085,96480,completed
677,87484,720,1,0-2,1,0.06775999999999999,0.062400000000000004,95760,8276,96480,completed
698,89770,720,1,0-2,1,0.06775999999999999,0.062400000000000004,95760,5990,96480,completed
702,90818,720,1,0-2,1,0.06775999999999999,0.062400000000000004,95760,4942,96480,completed
703,90856,6,1,0-2,1,0.0005646666666666667,0.0005200000000000001,95760,4904,95766,completed
704,90966,68,1,0-2,1,0.006399555555555554,0.005893333333333334,95760,4794,95828,completed
705,91015,50,1,0-2,1,0.004705555555555555,0.004333333333333333,95760,4745,95810,completed
706,91063,720,1,0-2,1,0.06775999999999999,0.062400000000000004,95760,4697,96480,completed
707,91145,538,1,0-2,1,0.05063177777777778,0.04662666666666667,95760,4615,96298,completed
708,91221,492,1,0-2,1,0.04630266666666667,0.04264,95760,4539,96252,completed
709,91223,451,1,0-2,1,0.04244411111111111,0.039086666666666665,95760,4537,96211,completed
710,91877,70,1,0-2,1,0.006587777777777776,0.006066666666666666,95760,3883,95830,completed
711,91995,87,1,0-2,1,0.008187666666666664,0.00754,95760,3765,95847,completed
712,92117,720,1,0-2,1,0.06775999999999999,0.062400000000000004,95760,3643,96480,completed
713,92120,627,1,0-2,1,0.05900766666666667,0.05434,95760,3640,96387,completed
714,92125,720,1,0-2,1,0.06775999999999999,0.062400000000000004,95760,3635,96480,completed
715,92125,720,1,0-2,1,0.06775999999999999,0.062400000000000004,95760,3635,96480,completed
716,92137,720,1,0-2,1,0.06775999999999999,0.062400000000000004,95760,3623,96480,completed
717,92143,450,1,0-2,1,0.042350000000000006,0.039,95760,3617,96210,completed
718,92355,459,1,0-2,1,0.043197000000000006,0.03978,95760,3405,96219,completed
719,92426,63,1,0-2,1,0.005928999999999998,0.0054600000000000004,95760,3334,95823,completed
720,92515,720,1,0-2,1,0.06775999999999999,0.062400000000000004,95760,3245,96480,completed
721,92665,720,1,0-2,1,0.06775999999999999,0.062400000000000004,95760,3095,96480,completed
722,92822,720,1,0-2,1,0.06775999999999999,0.062400000000000004,95760,2938,96480,completed
723,92867,188,1,0-2,1,0.017692888888888886,0.016293333333333333,95760,2893,95948,completed
724,92881,481,1,0-2,1,0.04526744444444446,0.04168666666666667,95760,2879,96241,completed
725,92944,720,1,0-2,1,0.06775999999999999,0.062400000000000004,95760,2816,96480,completed
726,92990,720,3,0-2,3-4,0.20327999999999996,0.1872,95760,2770,96480,completed
727,93062,119,1,0-2,1,0.011199222222222222,0.010313333333333334,95760,2698,95879,completed
728,93210,720,1,0-2,1,0.06775999999999999,0.062400000000000004,95760,2550,96480,completed
730,93606,79,1,0-2,1,0.007434777777777775,0.006846666666666667,95760,2154,95839,completed
731,93699,621,1,0-2,1,0.058442999999999995,0.05382,95760,2061,96381,completed
732,93778,720,1,0-2,1,0.06775999999999999,0.062400000000000004,95760,1982,96480,completed
733,93815,505,1,0-2,1,0.047526111111111116,0.04376666666666667,95760,1945,96265,completed
734,93825,720,1,0-2,1,0.06775999999999999,0.062400000000000004,95760,1935,96480,completed
735,93850,470,1,0-2,1,0.04423222222222223,0.04073333333333334,95760,1910,96230,completed
736,94023,88,1,0-2,1,0.008281777777777777,0.007626666666666667,95760,1737,95848,completed
737,94276,626,1,0-2,1,0.05891355555555555,0.054253333333333334,95760,1484,96386,completed
738,94296,93,1,0-2,1,0.00875233333333333,0.00806,95760,1464,95853,completed
739,94301,19,1,0-2,1,0.0017881111111111114,0.0016466666666666667,95760,1459,95779,completed
741,94527,720,1,0-2,1,0.06775999999999999,0.062400000000000004,95760,1233,96480,completed
742,94690,720,1,0-2,1,0.06775999999999999,0.062400000000000004,95760,1070,96480,completed
743,94742,67,1,0-2,1,0.006305444444444443,0.005806666666666667,95760,1018,95827,completed
744,94782,233,1,0-2,1,0.021927888888888893,0.020193333333333334,95760,978,95993,completed
747,94835,720,1,0-2,1,0.06775999999999999,0.062400000000000004,95760,925,96480,completed
748,94838,720,1,0-2,1,0.06775999999999999,0.062400000000000004,95760,922,96480,completed
749,94871,518,1,0-2,1,0.04874955555555556,0.044893333333333334,95760,889,96278,completed
750,95088,682,1,0-2,1,0.06418377777777778,0.05910666666666667,95760,672,96442,completed
751,95429,223,1,0-2,1,0.020986777777777778,0.019326666666666666,95760,331,95983,completed
752,95476,473,1,0-2,1,0.044514555555555564,0.04099333333333333,95760,284,96233,completed
753,95513,720,3,0-2,3-4,0.20327999999999996,0.1872,95760,247,96480,completed
754,95684,720,1,0-2,1,0.06775999999999999,0.062400000000000004,95760,76,96480,completed
755,95692,533,1,0-2,1,0.05016122222222223,0.046193333333333336,95760,68,96293,completed
756,95736,242,1,0-2,1,0.022774888888888893,0.020973333333333333,95760,24,96002,completed
757,95816,181,1,0-2,1,0.017034111111111108,0.015686666666666668,95816,0,95997,completed
758,96075,608,1,0-2,1,0.06635455555555556,0.052693333333333335,96075,0,96683,completed
759,96145,118,1,0-2,1,0.01110511111111111,0.010226666666666667,96145,0,96263,completed
760,96189,64,1,0-2,1,0.006023111111111111,0.005546666666666667,96189,0,96253,completed
761,96223,545,1,0-2,1,0.06425055555555556,0.047233333333333336,96223,0,96768,completed
763,96346,73,1,0-2,1,0.006870111111111111,0.006326666666666667,96346,0,96419,completed
764,96546,64,1,0-2,1,0.008903111111111112,0.0,96546,0,96610,completed
765,96596,1230,1,0-2,1,0.24574847222222226,0.0,96596,0,97826,completed
766,96612,1123,1,0-2,1,0.22001309722222226,0.0,96612,0,97735,completed
767,96624,696,1,0-2,1,0.11112966666666668,0.0,96624,0,97320,completed
768,96632,1284,1,0-2,1,0.2639917222222223,0.11128,96632,0,97916,completed
769,96649,443,1,0-2,1,0.06162622222222222,0.038393333333333335,96649,0,97092,completed
770,96649,436,1,0-2,1,0.060652444444444446,0.03778666666666667,96649,0,97085,completed
771,96779,97,1,0-2,1,0.013493777777777778,0.008406666666666666,96779,0,96876,completed
772,96901,164,1,0-2,1,0.022814222222222222,0.014213333333333333,96901,0,97065,completed
774,97046,1052,1,0-2,1,0.2739334166666667,0.09117333333333333,97046,0,98098,completed
775,97271,313,2,0-2,2,0.16172536111111113,0.0,97271,0,97584,completed
776,97317,1032,1,0-2,1,0.31605658333333336,0.0,97317,0,98349,completed
777,97345,937,1,0-2,1,0.2837918472222223,0.0,97345,0,98282,completed
778,97345,499,1,0-2,1,0.1289152638888889,0.0,97345,0,97844,completed
779,97345,740,1,0-2,1,0.21019319444444445,0.0,97345,0,98085,completed
780,97369,986,1,0-2,1,0.3048641111111111,0.0,97369,0,98355,completed
781,97407,963,1,0-2,1,0.30065087500000004,0.08346,97407,0,98370,completed
782,97443,476,1,0-2,1,0.1229732777777778,0.041253333333333336,97443,0,97919,completed
783,97512,748,1,0-2,1,0.23242872222222227,0.06482666666666667,97512,0,98260,completed
784,97626,444,1,0-2,1,0.13199366666666668,0.0,97626,0,98070,completed
785,97627,274,1,0-2,1,0.0707871388888889,0.0,97627,0,97901,completed
786,97812,817,1,0-2,1,0.29278193055555557,0.0,97812,0,98629,completed
787,97992,648,1,0-2,1,0.242091,0.0,97992,0,98640,completed
788,98475,165,1,0-2,1,0.06164354166666667,0.0,98475,0,98640,completed
789,98476,164,1,0-2,1,0.061269944444444446,0.0,98476,0,98640,completed
790,98581,59,1,0-2,1,0.022042236111111113,0.0,98581,0,98640,completed
791,98597,43,1,0-2,1,0.016064680555555558,0.0,98597,0,98640,completed
787,97992,87,1,0-2,1,0.03912341666666668,0.0,102960,4968,103047,completed
788,98475,139,1,0-2,1,0.06250752777777778,0.0,102960,4485,103099,completed
789,98476,101,1,0-2,1,0.0454191388888889,0.0,102960,4484,103061,completed
790,98581,55,1,0-2,1,0.024733194444444436,0.0,102960,4379,103015,completed
791,98597,263,1,0-2,1,0.11826963888888888,0.0,102960,4363,103223,completed
792,98762,598,1,0-2,1,0.26891727777777774,0.0,102960,4198,103558,completed
793,98763,73,1,0-2,1,0.032827694444444444,0.0,102960,4197,103033,completed
794,99005,64,1,0-2,1,0.028780444444444442,0.0,102960,3955,103024,completed
795,99024,265,1,0-2,1,0.11916902777777777,0.0,102960,3936,103225,completed
797,99205,74,1,0-2,1,0.03327738888888889,0.006413333333333333,102960,3755,103034,completed
796,99205,105,1,0-2,1,0.047217916666666665,0.0091,102960,3755,103065,completed
799,99269,91,1,0-2,1,0.04092219444444445,0.007886666666666667,102960,3691,103051,completed
798,99269,91,1,0-2,1,0.04092219444444445,0.007886666666666667,102960,3691,103051,completed
792,98762,580,1,0-2,1,0.24902138888888897,0.0,103680,4918,104260,completed
799,99269,283,1,0-2,1,0.12150526388888894,0.0,103680,4411,103963,completed
798,99269,52,1,0-2,1,0.022326055555555564,0.0,103680,4411,103732,completed
800,99535,275,4,0-2,3-4,0.4722819444444446,0.0,103680,4145,103955,completed
801,99612,132,1,0-2,1,0.056673833333333354,0.0,103680,4068,103812,completed
803,99779,301,1,0-2,1,0.12923351388888893,0.0,103680,3901,103981,completed
806,99886,194,1,0-2,1,0.08329336111111114,0.016813333333333333,103680,3794,103874,completed
807,99886,194,1,0-2,1,0.08329336111111114,0.016813333333333333,103680,3794,103874,completed
803,99779,777,1,0-2,1,0.27553041666666667,0.0,104400,4621,105177,completed
807,99886,94,1,0-2,1,0.03337261111111113,0.0,104400,4514,104494,completed
806,99886,94,1,0-2,1,0.03337261111111113,0.0,104400,4514,104494,completed
808,100315,167,1,0-2,1,0.0592896388888889,0.0,104400,4085,104567,completed
811,100695,77,1,0-2,1,0.02733713888888889,0.0,104400,3705,104477,completed
812,100875,84,1,0-2,1,0.029341666666666655,0.0,105120,4245,105204,completed
813,100964,63,1,0-2,1,0.022006249999999988,0.0,105120,4156,105183,completed
815,101325,74,1,0-2,1,0.025848611111111103,0.0,105120,3795,105194,completed
817,101670,581,3,0-2,3-4,0.6088395833333331,0.0,105120,3450,105701,completed
819,102027,150,3,0-2,3-4,0.15718749999999995,0.039,105120,3093,105270,completed
820,102501,72,1,0-2,1,0.025149999999999995,0.0,105120,2619,105192,completed
821,102511,200,1,0-2,1,0.0698611111111111,0.0,105120,2609,105320,completed
824,102800,250,1,0-2,1,0.08732638888888888,0.021666666666666667,105120,2320,105370,completed
825,102857,87,1,0-2,1,0.030389583333333317,0.00754,105120,2263,105207,completed
826,102886,518,1,0-2,1,0.18094027777777777,0.044893333333333334,105120,2234,105638,completed
828,102945,401,1,0-2,1,0.14007152777777776,0.03475333333333333,105120,2175,105521,completed
833,103403,277,1,0-2,1,0.09675763888888887,0.024006666666666666,105120,1717,105397,completed
834,103502,178,1,0-2,1,0.06217638888888888,0.015426666666666667,105120,1618,105298,completed
835,103631,49,2,0-2,2,0.03423194444444444,0.008493333333333334,105120,1489,105169,completed
833,103403,316,1,0-2,1,0.09703833333333331,0.0,108000,4597,108316,completed
834,103502,504,1,0-2,1,0.15477000000000002,0.0,108000,4498,108504,completed
835,103631,362,2,0-2,2,0.2223283333333333,0.0,108000,4369,108362,completed
836,103685,642,1,0-2,1,0.19714749999999998,0.0,108000,4315,108642,completed
837,103788,230,2,0-2,2,0.14125833333333332,0.0,108000,4212,108230,completed
838,103830,123,1,0-2,1,0.03777125,0.0,108000,4170,108123,completed
839,103934,466,1,0-2,1,0.14310083333333332,0.0,108000,4066,108466,completed
840,103982,312,3,0-2,3-4,0.28742999999999996,0.08112,108000,4018,108312,completed
841,104065,99,1,0-2,1,0.030401249999999994,0.00858,108000,3935,108099,completed
842,104071,329,2,0-2,2,0.2020608333333333,0.05702666666666667,108000,3929,108329,completed
839,103934,456,1,0-2,1,0.10633666666666663,0.0,108720,4786,109176,completed
842,104071,1049,2,0-2,2,0.43881355555555557,0.0,108720,4649,109769,completed
847,104723,397,1,0-2,1,0.09257819444444443,0.0,108720,3997,109117,completed
850,104872,77,1,0-2,1,0.017955972222222227,0.0,108720,3848,108797,completed
634,82122,887,1,0-2,1,0.13222420833333337,0.0,109440,27318,110327,completed
657,85563,117,1,0-2,1,0.018317000000000003,0.0,109440,23877,109557,completed
671,87193,6480,1,12-24,1,0.69957,0.0,109440,22247,115920,completed
673,87262,4,1,0-2,1,0.0006262222222222222,0.0,109440,22178,109444,completed
847,104723,301,1,0-2,1,0.04712322222222223,0.0,109440,4717,109741,completed
852,105263,402,1,0-2,1,0.06293533333333334,0.0,109440,4177,109842,completed
851,105263,402,1,0-2,1,0.06293533333333334,0.0,109440,4177,109842,completed
853,105454,65,1,0-2,1,0.010176111111111113,0.005633333333333333,109440,3986,109505,completed
854,105528,312,2,0-2,2,0.09769066666666669,0.05408,109440,3912,109752,completed
855,105541,299,2,0-2,2,0.09362022222222224,0.05182666666666667,109440,3899,109739,completed
856,105673,104,1,0-2,1,0.01628177777777778,0.009013333333333333,109440,3767,109544,completed
657,85563,2535,1,2-6,1,0.25250770833333336,0.0,110160,24597,112695,completed
673,87262,5760,1,6-12,1,0.5868500000000001,0.0,110160,22898,115920,completed
690,88984,5760,1,6-12,1,0.5868500000000001,0.0,110160,21176,115920,completed
729,93257,343,1,0-2,1,0.04005954166666666,0.0,110160,16903,110503,completed
854,105528,290,2,0-2,2,0.06773916666666666,0.0,110160,4632,110450,completed
855,105541,498,2,0-2,2,0.11632450000000003,0.08632000000000001,110160,4619,110658,completed
857,105850,85,1,0-2,1,0.009927291666666664,0.0,110160,4310,110245,completed
858,105999,398,1,0-2,1,0.04648308333333334,0.034493333333333334,110160,4161,110558,completed
859,106059,278,1,0-2,1,0.03246808333333333,0.024093333333333335,110160,4101,110438,completed
860,106185,90,1,0-2,1,0.01051125,0.0078000000000000005,110160,3975,110250,completed
861,106198,117,1,0-2,1,0.013664625,0.01014,110160,3962,110277,completed
863,106299,261,1,0-2,1,0.030482625,0.02262,110160,3861,110421,completed
864,106369,191,1,0-2,1,0.02230720833333333,0.016553333333333333,110160,3791,110351,completed
865,106375,185,1,0-2,1,0.021606458333333335,0.016033333333333333,110160,3785,110345,completed
866,106481,79,1,0-2,1,0.009226541666666662,0.006846666666666667,110160,3679,110239,completed
867,106504,56,1,0-2,1,0.006540333333333333,0.004853333333333334,110160,3656,110216,completed
721,92665,4320,1,6-12,1,0.40694,0.0,110880,18215,115200,completed
722,92822,989,1,0-2,1,0.09328854166666667,0.0,110880,18058,111869,completed
725,92944,4320,1,6-12,1,0.40694,0.0,110880,17936,115200,completed
726,92990,3174,3,6-12,3-4,0.8787889999999999,0.82524,110880,17890,114054,completed
729,93257,4320,1,6-12,1,0.40694,0.0,110880,17623,115200,completed
741,94527,34,1,0-2,1,0.003227638888888889,0.0,110880,16353,110914,completed
754,95684,3110,1,6-12,1,0.2865972222222223,0.26953333333333335,110880,15196,113990,completed
773,96962,4320,1,6-12,1,0.40694,0.3744,110880,13918,115200,completed
802,99736,3224,1,6-12,1,0.29787688888888886,0.27941333333333335,110880,11144,114104,completed
805,99879,3081,1,6-12,1,0.28372783333333335,0.26702,110880,11001,113961,completed
809,100423,377,3,0-2,3-4,0.10736645833333332,0.09802,110880,10457,111257,completed
863,106299,954,1,0-2,1,0.09004374999999999,0.08268,110880,4581,111834,completed
864,106369,806,1,0-2,1,0.07632291666666666,0.06985333333333334,110880,4511,111686,completed
865,106375,356,1,0-2,1,0.03379527777777777,0.030853333333333333,110880,4505,111236,completed
866,106481,1082,1,0-2,1,0.10191041666666667,0.09377333333333333,110880,4399,111962,completed
867,106504,38,1,0-2,1,0.003607361111111111,0.0032933333333333334,110880,4376,110918,completed
868,106720,77,1,0-2,1,0.007309652777777778,0.006673333333333333,110880,4160,110957,completed
869,106809,471,1,0-2,1,0.044712291666666654,0.04082,110880,4071,111351,completed
870,106964,102,1,0-2,1,0.00968291666666666,0.00884,110880,3916,110982,completed
871,107138,64,1,0-2,1,0.006075555555555555,0.005546666666666667,110880,3742,110944,completed
731,93699,1825,1,2-6,1,0.16535395833333333,0.0,111600,17901,113425,completed
733,93815,1123,1,0-2,1,0.10255543055555556,0.09732666666666667,111600,17785,112723,completed
735,93850,1114,1,0-2,1,0.10175580555555555,0.09654666666666667,111600,17750,112714,completed
739,94301,2053,1,2-6,1,0.18586445833333332,0.17792666666666668,111600,17299,113653,completed
740,94320,1986,1,2-6,1,0.17983725,0.17212,111600,17280,113586,completed
741,94527,2160,1,2-6,1,0.19549,0.1872,111600,17073,113760,completed
744,94782,2160,1,2-6,1,0.19549,0.1872,111600,16818,113760,completed
745,94791,249,1,0-2,1,0.023084374999999997,0.021580000000000002,111600,16809,111849,completed
746,94826,394,1,0-2,1,0.036527083333333335,0.034146666666666665,111600,16774,111994,completed
750,95088,2160,1,2-6,1,0.19549,0.1872,111600,16512,113760,completed
762,96333,102,1,0-2,1,0.009456250000000001,0.00884,111600,15267,111702,completed
804,99871,693,1,0-2,1,0.064246875,0.06006,111600,11729,112293,completed
809,100423,2160,3,2-6,3-4,0.58647,0.5616,111600,11177,113760,completed
810,100455,511,3,0-2,3-4,0.142121875,0.13286,111600,11145,112111,completed
814,101263,257,1,0-2,1,0.023826041666666666,0.022273333333333332,111600,10337,111857,completed
816,101398,122,1,0-2,1,0.011310416666666667,0.010573333333333334,111600,10202,111722,completed
869,106809,593,1,0-2,1,0.05497604166666666,0.05139333333333333,111600,4791,112193,completed
872,107321,479,1,0-2,1,0.04440729166666667,0.04151333333333333,111600,4279,112079,completed
873,107500,119,1,0-2,1,0.011032291666666668,0.010313333333333334,111600,4100,111719,completed
875,107627,201,1,0-2,1,0.018634375,0.01742,111600,3973,111801,completed
876,107651,349,1,0-2,1,0.03235520833333333,0.030246666666666668,111600,3949,111949,completed
877,107933,67,1,0-2,1,0.006211458333333334,0.005806666666666667,111600,3667,111667,completed
878,107947,53,1,0-2,1,0.004913541666666668,0.004593333333333334,111600,3653,111653,completed
879,107963,37,1,0-2,1,0.0034302083333333346,0.0032066666666666667,111600,3637,111637,completed
745,94791,1354,1,0-2,1,0.12100358333333334,0.0,112320,17529,113674,completed
746,94826,1440,1,0-2,1,0.12874000000000002,0.12480000000000001,112320,17494,113760,completed
762,96333,1440,1,0-2,1,0.12874000000000002,0.12480000000000001,112320,15987,113760,completed
804,99871,1440,1,0-2,1,0.12874000000000002,0.12480000000000001,112320,12449,113760,completed
810,100455,1440,3,0-2,3-4,0.38622000000000006,0.3744,112320,11865,113760,completed
814,101263,1440,1,0-2,1,0.12874000000000002,0.12480000000000001,112320,11057,113760,completed
816,101398,1440,1,0-2,1,0.12874000000000002,0.12480000000000001,112320,10922,113760,completed
818,101850,1110,1,0-2,1,0.09905375000000001,0.09620000000000001,112320,10470,113430,completed
822,102513,447,2,0-2,2,0.07942941666666667,0.07748000000000001,112320,9807,112767,completed
823,102651,309,1,0-2,1,0.027453791666666668,0.02678,112320,9669,112629,completed
827,102904,56,1,0-2,1,0.004975444444444445,0.004853333333333334,112320,9416,112376,completed
876,107651,359,1,0-2,1,0.031896152777777784,0.031113333333333333,112320,4669,112679,completed
877,107933,636,1,0-2,1,0.05650683333333334,0.05512,112320,4387,112956,completed
878,107947,397,1,0-2,1,0.03527234722222222,0.03440666666666667,112320,4373,112717,completed
879,107963,747,1,0-2,1,0.066398875,0.06474,112320,4357,113067,completed
880,108094,369,1,0-2,1,0.032784625000000005,0.03198,112320,4226,112689,completed
881,108133,1275,2,0-2,2,0.22779375000000002,0.221,112320,4187,113595,completed
882,108157,75,1,0-2,1,0.006663541666666667,0.0065,112320,4163,112395,completed
883,108172,290,1,0-2,1,0.025765694444444445,0.025133333333333334,112320,4148,112610,completed
884,108215,95,1,0-2,1,0.008440486111111116,0.008233333333333334,112320,4105,112415,completed
885,108216,204,1,0-2,1,0.018124833333333333,0.01768,112320,4104,112524,completed
886,108220,264,1,0-2,1,0.023455666666666666,0.02288,112320,4100,112584,completed
887,108250,1234,2,0-2,2,0.2204171666666667,0.21389333333333332,112320,4070,113554,completed
888,108320,75,1,0-2,1,0.006663541666666667,0.0065,112320,4000,112395,completed
889,108373,1398,1,0-2,1,0.12496175000000001,0.12116,112320,3947,113718,completed
890,108435,742,1,0-2,1,0.06594908333333334,0.06430666666666666,112320,3885,113062,completed
891,108648,456,1,0-2,1,0.040514333333333326,0.03952,112320,3672,112776,completed
892,108706,1418,1,0-2,1,0.12676091666666667,0.12289333333333334,112320,3614,113738,completed
893,108817,136,1,0-2,1,0.012083222222222224,0.011786666666666668,112320,3503,112456,completed
894,108931,427,1,0-2,1,0.03793776388888889,0.03700666666666667,112320,3389,112747,completed
895,108946,299,1,0-2,1,0.026565319444444447,0.025913333333333333,112320,3374,112619,completed
896,108951,562,1,0-2,1,0.049932138888888894,0.04870666666666667,112320,3369,112882,completed
899,108952,814,1,0-2,1,0.07242608333333332,0.07054666666666667,112320,3368,113134,completed
897,108952,962,1,0-2,1,0.08573991666666667,0.08337333333333334,112320,3368,113282,completed
898,108952,499,1,0-2,1,0.044334763888888885,0.04324666666666667,112320,3368,112819,completed
900,109011,526,1,0-2,1,0.04673363888888888,0.045586666666666664,112320,3309,112846,completed
901,109016,586,1,0-2,1,0.05206447222222223,0.05078666666666667,112320,3304,112906,completed
902,109119,91,1,0-2,1,0.008085097222222224,0.007886666666666667,112320,3201,112411,completed
903,109316,1186,1,0-2,1,0.10589058333333334,0.10278666666666667,112320,3004,113506,completed
904,109316,79,1,0-2,1,0.007018930555555554,0.006846666666666667,112320,3004,112399,completed
906,109456,468,1,0-2,1,0.04158049999999999,0.04056,112320,2864,112788,completed
907,109519,74,1,0-2,1,0.006574694444444445,0.006413333333333333,112320,2801,112394,completed
909,109651,78,1,0-2,1,0.006930083333333332,0.00676,112320,2669,112398,completed
910,109655,66,1,0-2,1,0.005863916666666667,0.00572,112320,2665,112386,completed
911,109655,86,1,0-2,1,0.00764086111111111,0.0074533333333333335,112320,2665,112406,completed
913,109785,927,1,0-2,1,0.082591375,0.08034,112320,2535,113247,completed
914,109861,88,1,0-2,1,0.007818555555555556,0.007626666666666667,112320,2459,112408,completed
915,109862,278,1,0-2,1,0.02469952777777778,0.024093333333333335,112320,2458,112598,completed
916,109884,87,1,0-2,1,0.007729708333333332,0.00754,112320,2436,112407,completed
917,109965,505,1,0-2,1,0.044867847222222215,0.04376666666666667,112320,2355,112825,completed
919,110105,100,1,0-2,1,0.008884722222222224,0.008666666666666666,112320,2215,112420,completed
920,110182,83,1,0-2,1,0.007374319444444445,0.007193333333333334,112320,2138,112403,completed
921,110362,183,1,0-2,1,0.01625904166666667,0.01586,112320,1958,112503,completed
923,110601,105,1,0-2,1,0.009328958333333333,0.0091,112320,1719,112425,completed
924,110703,72,1,0-2,1,0.006397000000000001,0.00624,112320,1617,112392,completed
925,111374,402,1,0-2,1,0.03571658333333333,0.03484,112320,946,112722,completed
928,112349,550,1,0-2,1,0.04886597222222223,0.04766666666666667,112349,0,112899,completed
929,112639,1270,3,0-2,3-4,0.34542137500000003,0.3302,112639,0,113909,completed
930,112696,1214,3,0-2,3-4,0.33052533333333334,0.31564000000000003,112696,0,113910,completed
931,112702,1114,3,0-2,3-4,0.30102375000000003,0.28964,112702,0,113816,completed
933,112811,720,1,0-2,1,0.06451555555555556,0.0,112811,0,113531,completed
935,112900,116,1,0-2,1,0.010306277777777779,0.010053333333333334,112900,0,113016,completed
936,113017,70,4,0-2,3-4,0.025086111111111115,0.024266666666666666,113017,0,113087,completed
937,113040,148,2,0-2,2,0.026627666666666668,0.025653333333333334,113040,0,113188,completed
938,113060,103,1,0-2,1,0.009265708333333329,0.008926666666666666,113060,0,113163,completed
939,113238,83,1,0-2,1,0.007466541666666667,0.007193333333333334,113238,0,113321,completed
940,113302,958,1,0-2,1,0.09067313888888891,0.08302666666666667,113302,0,114260,completed
941,113340,102,1,0-2,1,0.009175749999999996,0.00884,113340,0,113442,completed
942,113354,165,1,0-2,1,0.014843125000000002,0.0143,113354,0,113519,completed
943,113357,320,1,0-2,1,0.02878666666666667,0.027733333333333332,113357,0,113677,completed
944,113364,850,1,0-2,1,0.08054427777777778,0.07366666666666667,113364,0,114214,completed
945,113465,754,1,0-2,1,0.07195320833333334,0.0,113465,0,114219,completed
946,113465,826,1,0-2,1,0.07907720833333334,0.07158666666666667,113465,0,114291,completed
947,113514,81,1,0-2,1,0.007286625000000001,0.00702,113514,0,113595,completed
948,113564,877,1,0-2,1,0.085013,0.0,113564,0,114441,completed
949,113700,451,1,0-2,1,0.04408477777777778,0.0,113700,0,114151,completed
950,113809,235,1,0-2,1,0.02325194444444445,0.02036666666666667,113809,0,114044,completed
951,114110,479,1,0-2,1,0.04748825,0.04151333333333333,114110,0,114589,completed
952,114424,776,1,0-2,1,0.07740088888888887,0.0,114424,0,115200,completed
954,114786,108,1,0-2,1,0.010778999999999999,0.0,114786,0,114894,completed
955,114816,210,1,0-2,1,0.02095916666666666,0.0,114816,0,115026,completed
956,115124,76,1,0-2,1,0.007585222222222221,0.0,115124,0,115200,completed
671,87193,4629,1,6-12,1,0.41961708333333325,0.0,117360,30167,121989,completed
690,88984,6140,1,12-24,1,0.5002919444444445,0.0,117360,28376,123500,completed
729,93257,2172,1,2-6,1,0.23099666666666663,0.0,118080,24823,120252,completed
773,96962,238,1,0-2,1,0.025770111111111105,0.0,118080,21118,118318,completed
773,96962,3226,1,6-12,1,0.2439052777777778,0.0,118800,21838,122026,completed
952,114424,489,1,0-2,1,0.050957875,0.0,119520,5096,120009,completed
956,115124,529,1,0-2,1,0.055126208333333336,0.0,119520,4396,120049,completed
802,99736,121,1,0-2,1,0.0060163888888888906,0.0,120240,20504,120361,completed
805,99879,8908,1,12-24,1,0.487157,0.0,120240,20361,129148,completed
809,100423,1311,3,0-2,3-4,0.19915275,0.0,120240,19817,121551,completed
814,101263,336,1,0-2,1,0.01670666666666667,0.02912,120240,18977,120576,completed
816,101398,143,1,0-2,1,0.007110277777777778,0.012393333333333334,120240,18842,120383,completed
818,101850,1120,1,0-2,1,0.056499999999999995,0.09706666666666666,120240,18390,121360,completed
822,102513,7131,2,12-24,2,0.7612056666666667,1.23604,120240,17727,127371,completed
823,102651,1568,1,2-6,1,0.0798688888888889,0.13589333333333334,120240,17589,121808,completed
827,102904,9578,1,12-24,1,0.5300533333333334,0.8300933333333333,120240,17336,129818,completed
829,103379,2461,1,2-6,1,0.12786901388888888,0.21328666666666668,120240,16861,122701,completed
830,103380,4649,1,6-12,1,0.24222956944444446,0.40291333333333335,120240,16860,124889,completed
832,103381,4792,1,6-12,1,0.25009655555555554,0.41530666666666666,120240,16859,125032,completed
831,103381,4862,1,6-12,1,0.25394752777777774,0.4213733333333333,120240,16859,125102,completed
843,104279,4441,2,6-12,2,0.46157336111111114,0.7697733333333333,120240,15961,124681,completed
844,104413,2867,1,2-6,1,0.1501369861111111,0.24847333333333332,120240,15827,123107,completed
846,104607,1233,1,0-2,1,0.06234774999999999,0.10686,120240,15633,121473,completed
845,104607,1233,1,0-2,1,0.06234774999999999,0.10686,120240,15633,121473,completed
848,104727,2372,1,2-6,1,0.12298761111111112,0.20557333333333333,120240,15513,122612,completed
849,104793,9360,1,12-24,1,0.51552,0.8112,120240,15447,129600,completed
862,106229,9360,1,12-24,1,0.51552,0.8112,120240,14011,129600,completed
874,107593,1192,2,0-2,2,0.120452,0.20661333333333334,120240,12647,121432,completed
905,109421,12960,1,24-48,1,0.7656499999999999,1.1232,120240,10819,133200,completed
908,109597,2160,1,2-6,1,0.11135999999999999,0.1872,120240,10643,122400,completed
912,109740,720,1,0-2,1,0.035800000000000005,0.062400000000000004,120240,10500,120960,completed
918,109971,5040,3,6-12,3-4,0.7912199999999999,1.3104,120240,10269,125280,completed
922,110491,720,1,0-2,1,0.035800000000000005,0.062400000000000004,120240,9749,120960,completed
926,111690,720,1,0-2,1,0.035800000000000005,0.062400000000000004,120240,8550,120960,completed
927,111967,2160,2,2-6,2,0.22271999999999997,0.3744,120240,8273,122400,completed
932,112707,1043,1,0-2,1,0.05251525000000001,0.09039333333333334,120240,7533,121283,completed
934,112813,5383,1,6-12,1,0.2833815138888889,0.4665266666666667,120240,7427,125623,completed
953,114680,2160,1,2-6,1,0.11135999999999999,0.1872,120240,5560,122400,completed
958,115594,2160,1,2-6,1,0.11135999999999999,0.1872,120240,4646,122400,completed
957,115594,2160,1,2-6,1,0.11135999999999999,0.1872,120240,4646,122400,completed
959,115742,2160,1,2-6,1,0.11135999999999999,0.1872,120240,4498,122400,completed
960,116147,2160,2,2-6,2,0.22271999999999997,0.3744,120240,4093,122400,completed
961,116179,107,1,0-2,1,0.005320277777777778,0.009273333333333333,120240,4061,120347,completed
962,116366,422,1,0-2,1,0.02098277777777778,0.03657333333333333,120240,3874,120662,completed
963,116384,504,1,0-2,1,0.02506000000000001,0.043680000000000004,120240,3856,120744,completed
964,116389,860,1,0-2,1,0.043045000000000014,0.07453333333333334,120240,3851,121100,completed
965,116391,166,1,0-2,1,0.008253888888888887,0.014386666666666667,120240,3849,120406,completed
966,116396,529,1,0-2,1,0.02630305555555556,0.04584666666666667,120240,3844,120769,completed
967,116425,2160,1,2-6,1,0.11135999999999999,0.1872,120240,3815,122400,completed
968,116852,77,1,0-2,1,0.003828611111111111,0.006673333333333333,120240,3388,120317,completed
969,116940,82,1,0-2,1,0.004077222222222222,0.0071066666666666665,120240,3300,120322,completed
970,117908,197,4,0-2,3-4,0.03918111111111111,0.06829333333333333,120240,2332,120437,completed
971,118075,1445,1,2-6,1,0.07332597222222223,0.12523333333333334,120240,2165,121685,completed
972,118415,524,3,0-2,3-4,0.07816333333333335,0.13624,120240,1825,120764,completed
973,118433,1440,1,0-2,1,0.07306000000000001,0.12480000000000001,120240,1807,121680,completed
974,118440,1440,1,0-2,1,0.07306000000000001,0.12480000000000001,120240,1800,121680,completed
975,118737,60,1,0-2,1,0.0029833333333333335,0.0052,120240,1503,120300,completed
976,119044,492,1,0-2,1,0.02446333333333334,0.04264,120240,1196,120732,completed
977,119133,720,1,0-2,1,0.035800000000000005,0.062400000000000004,120240,1107,120960,completed
978,119139,11202,2,12-24,2,1.2761561666666668,1.94168,120240,1101,131442,completed
979,119140,11208,2,12-24,2,1.2769713333333335,1.94272,120240,1100,131448,completed
980,119164,720,1,0-2,1,0.035800000000000005,0.062400000000000004,120240,1076,120960,completed
981,119416,720,1,0-2,1,0.035800000000000005,0.062400000000000004,120240,824,120960,completed
982,119581,439,1,0-2,1,0.02182805555555556,0.038046666666666666,120240,659,120679,completed
983,119818,720,1,0-2,1,0.035800000000000005,0.062400000000000004,120240,422,120960,completed
984,119826,435,1,0-2,1,0.02162916666666667,0.0377,120240,414,120675,completed
985,119964,2160,1,2-6,1,0.11135999999999999,0.1872,120240,276,122400,completed
986,119977,90,1,0-2,1,0.004475,0.0078000000000000005,120240,263,120330,completed
987,120082,406,1,0-2,1,0.020187222222222224,0.035186666666666665,120240,158,120646,completed
988,120092,80,1,0-2,1,0.003977777777777778,0.006933333333333333,120240,148,120320,completed
989,120141,428,1,0-2,1,0.021281111111111115,0.03709333333333333,120240,99,120668,completed
990,120214,720,1,0-2,1,0.035800000000000005,0.062400000000000004,120240,26,120960,completed
992,120215,720,1,0-2,1,0.035800000000000005,0.062400000000000004,120240,25,120960,completed
991,120215,720,1,0-2,1,0.035800000000000005,0.062400000000000004,120240,25,120960,completed
993,120305,98,1,0-2,1,0.004872777777777778,0.0,120305,0,120403,completed
994,120358,97,1,0-2,1,0.004823055555555556,0.008406666666666666,120358,0,120455,completed
995,120458,63,1,0-2,1,0.0031325000000000003,0.0,120458,0,120521,completed
996,120649,227,1,0-2,1,0.011286944444444447,0.0,120649,0,120876,completed
997,120665,67,1,0-2,1,0.003331388888888889,0.0,120665,0,120732,completed
998,120678,132,1,0-2,1,0.006563333333333333,0.01144,120678,0,120810,completed
999,120951,9,1,0-2,1,0.0004475,0.0,120951,0,120960,completed
829,103379,577,1,0-2,1,0.029338847222222214,0.0,123120,19741,123697,completed
844,104413,1440,1,0-2,1,0.07328,0.0,123120,18707,124560,completed
845,104607,461,1,0-2,1,0.023440569444444437,0.0,123120,18513,123581,completed
846,104607,305,1,0-2,1,0.015508402777777774,0.0,123120,18513,123425,completed
848,104727,1440,1,0-2,1,0.07328,0.0,123120,18393,124560,completed
874,107593,1440,2,0-2,2,0.14656,0.0,123120,15527,124560,completed
908,109597,1440,1,0-2,1,0.07328,0.12480000000000001,123120,13523,124560,completed
912,109740,1213,1,0-2,1,0.06171876388888889,0.10512666666666667,123120,13380,124333,completed
922,110491,742,1,0-2,1,0.037730472222222214,0.06430666666666666,123120,12629,123862,completed
926,111690,1243,1,0-2,1,0.06324668055555555,0.10772666666666667,123120,11430,124363,completed
927,111967,1440,2,0-2,2,0.14656,0.24960000000000002,123120,11153,124560,completed
932,112707,1440,1,0-2,1,0.07328,0.12480000000000001,123120,10413,124560,completed
953,114680,1440,1,0-2,1,0.07328,0.12480000000000001,123120,8440,124560,completed
958,115594,1440,1,0-2,1,0.07328,0.12480000000000001,123120,7526,124560,completed
957,115594,1440,1,0-2,1,0.07328,0.12480000000000001,123120,7526,124560,completed
959,115742,1440,1,0-2,1,0.07328,0.12480000000000001,123120,7378,124560,completed
960,116147,1440,2,0-2,2,0.14656,0.24960000000000002,123120,6973,124560,completed
967,116425,1440,1,0-2,1,0.07328,0.12480000000000001,123120,6695,124560,completed
971,118075,1440,1,0-2,1,0.07328,0.12480000000000001,123120,5045,124560,completed
973,118433,1440,1,0-2,1,0.07328,0.12480000000000001,123120,4687,124560,completed
974,118440,1440,1,0-2,1,0.07328,0.12480000000000001,123120,4680,124560,completed
977,119133,581,1,0-2,1,0.0295422361111111,0.05035333333333333,123120,3987,123701,completed
980,119164,675,1,0-2,1,0.034321874999999995,0.0585,123120,3956,123795,completed
981,119416,80,1,0-2,1,0.004067777777777777,0.006933333333333333,123120,3704,123200,completed
983,119818,363,1,0-2,1,0.01845754166666666,0.03146,123120,3302,123483,completed
985,119964,1440,1,0-2,1,0.07328,0.12480000000000001,123120,3156,124560,completed
990,120214,1047,1,0-2,1,0.053264291666666665,0.09074,123120,2906,124167,completed
991,120215,617,1,0-2,1,0.031372736111111105,0.05347333333333333,123120,2905,123737,completed
992,120215,501,1,0-2,1,0.025474458333333325,0.04342,123120,2905,123621,completed
999,120951,263,1,0-2,1,0.01337281944444444,0.022793333333333332,123120,2169,123383,completed
843,104279,139,2,0-2,2,0.015224361111111116,0.0,126000,21721,126139,completed
844,104413,376,1,0-2,1,0.02059122222222223,0.0,126000,21587,126376,completed
908,109597,214,1,0-2,1,0.011719472222222227,0.0,126000,16403,126214,completed
918,109971,1095,3,0-2,3-4,0.18085250000000003,0.0,126000,16029,127095,completed
927,111967,319,2,0-2,2,0.03493936111111112,0.05529333333333333,126000,14033,126319,completed
934,112813,1440,1,0-2,1,0.07947000000000001,0.0,126000,13187,127440,completed
953,114680,647,1,0-2,1,0.035432236111111126,0.056073333333333336,126000,11320,126647,completed
959,115742,178,1,0-2,1,0.009747972222222226,0.015426666666666667,126000,10258,126178,completed
985,119964,469,1,0-2,1,0.0256842638888889,0.040646666666666664,126000,6036,126469,completed
849,104793,327,1,0-2,1,0.021459375,0.0,130320,25527,130647,completed
849,104793,242,1,0-2,1,0.015427499999999999,0.0,131760,26967,132002,completed
862,106229,121,1,0-2,1,0.007713749999999999,0.0,131760,25531,131881,completed
978,119139,720,2,0-2,2,0.09179999999999999,0.0,131760,12621,132480,completed
979,119140,720,2,0-2,2,0.09179999999999999,0.0,131760,12620,132480,completed
905,109421,13422,1,24-48,1,0.91193025,0.0,133920,24499,147342,completed
934,112813,720,1,0-2,1,0.03926000000000001,0.0,134640,21827,135360,completed
953,114680,720,1,0-2,1,0.03926000000000001,0.0,134640,19960,135360,completed
957,115594,265,1,0-2,1,0.014449861111111115,0.0,134640,19046,134905,completed
958,115594,397,1,0-2,1,0.02164752777777778,0.0,134640,19046,135037,completed
959,115742,720,1,0-2,1,0.03926000000000001,0.0,134640,18898,135360,completed
960,116147,321,2,0-2,2,0.035006833333333334,0.0,134640,18493,134961,completed
967,116425,54,1,0-2,1,0.002944500000000001,0.0,134640,18215,134694,completed
978,119139,7200,2,12-24,2,0.8347600000000001,1.248,134640,15501,141840,completed
979,119140,7200,2,12-24,2,0.8347600000000001,1.248,134640,15500,141840,completed
985,119964,720,1,0-2,1,0.03926000000000001,0.062400000000000004,134640,14676,135360,completed
934,112813,2880,1,2-6,1,0.15094000000000002,0.0,137520,24707,140400,completed
959,115742,556,1,0-2,1,0.029722833333333327,0.0,137520,21778,138076,completed
985,119964,2880,1,2-6,1,0.15094000000000002,0.0,137520,17556,140400,completed
971,118075,682,1,0-2,1,0.035653444444444446,0.0,138240,20165,138922,completed
973,118433,668,1,0-2,1,0.03492155555555556,0.0,138240,19807,138908,completed
974,118440,511,1,0-2,1,0.026713944444444453,0.0,138240,19800,138751,completed
973,118433,1440,1,0-2,1,0.07481000000000002,0.0,138960,20527,140400,completed
974,118440,1440,1,0-2,1,0.07481000000000002,0.0,138960,20520,140400,completed
905,109421,2160,1,2-6,1,0.16453,0.0,147600,38179,149760,completed
978,119139,720,2,0-2,2,0.09626000000000001,0.0,149040,29901,149760,completed
979,119140,720,2,0-2,2,0.09626000000000001,0.0,149040,29900,149760,completed
-1,0,0,0,0,0,0.0,46.50048,0,0,0,0
