ID,arrival_time,length,cpus,length_class,resource_class,carbon_cost,dollar_cost,start_time,waiting_time,exit_time,reason
0,0,1260,1,0-2,1,0.17048750000000001,0.0,0,0,1260,completed
1,13,200,1,0-2,1,0.02670555555555556,0.0,13,0,213,completed
2,92,314,3,0-2,3-4,0.12578316666666667,0.0,92,0,406,completed
3,167,4709,1,6-12,1,0.6804191388888889,0.0,167,0,4876,completed
4,397,133,1,0-2,1,0.017759194444444446,0.0,397,0,530,completed
5,523,125,2,0-2,2,0.03338194444444444,0.0,523,0,648,completed
6,523,125,2,0-2,2,0.03338194444444444,0.0,523,0,648,completed
7,587,10992,1,12-24,1,1.524372486111111,0.0,587,0,11579,completed
8,601,10569,1,12-24,1,1.4182971666666666,0.0,601,0,11170,completed
9,810,4732,3,6-12,3-4,1.9985689166666665,0.0,810,0,5542,completed
10,958,350,2,0-2,2,0.09637638888888891,0.0,958,0,1308,completed
11,1159,565,1,0-2,1,0.07952651388888889,0.0,1261,102,1826,completed
12,1284,5424,1,6-12,1,0.6962084583333333,0.0,1309,25,6733,completed
14,1515,408,1,0-2,1,0.05800966666666667,0.0,1515,0,1923,completed
15,1725,222,1,0-2,1,0.031564083333333326,0.0,1827,102,2049,completed
16,1725,222,1,0-2,1,0.031564083333333326,0.0,1924,199,2146,completed
17,1997,1667,1,2-6,1,0.2489823611111111,0.0,2050,53,3717,completed
18,2096,83,1,0-2,1,0.011872930555555555,0.0,2147,51,2230,completed
19,2253,494,1,0-2,1,0.07074491666666666,0.0,2253,0,2747,completed
20,2299,112,1,0-2,1,0.016039333333333333,0.0,2748,449,2860,completed
21,2555,3388,1,6-12,1,0.4358354166666667,0.0,2861,306,6249,completed
22,2660,97,1,0-2,1,0.014792500000000002,0.0,3718,1058,3815,completed
24,3055,65,1,0-2,1,0.0099125,0.0,3816,761,3881,completed
26,3178,74,1,0-2,1,0.011285,0.0,3882,704,3956,completed
27,3179,68,1,0-2,1,0.010369999999999999,0.0,3957,778,4025,completed
28,3284,2472,1,2-6,1,0.2752905,0.0,4026,742,6498,completed
30,3349,704,1,0-2,1,0.07562479166666666,0.0,4877,1528,5581,completed
13,1389,2434,2,2-6,2,0.41810719444444444,0.0,5543,4154,7977,completed
32,3505,2215,1,2-6,1,0.18912430555555557,0.0,5543,2038,7758,completed
33,4268,61,1,0-2,1,0.005889888888888888,0.0,5582,1314,5643,completed
34,4465,709,1,0-2,1,0.057396791666666655,0.0,5644,1179,6353,completed
35,4543,2548,1,2-6,1,0.23008725000000002,0.0,6250,1707,8798,completed
36,4712,5939,1,12-24,1,0.9973147777777778,0.0,6354,1642,12293,completed
41,5540,4093,1,6-12,1,0.5121925277777778,0.0,6499,959,10592,completed
42,6242,427,1,0-2,1,0.03642547222222223,0.0,6734,492,7161,completed
44,6646,707,1,0-2,1,0.06398123611111112,0.0,7162,516,7869,completed
23,2887,183,4,0-2,3-4,0.06645949999999999,0.06344,7207,4320,7390,completed
29,3291,95,2,0-2,2,0.01725041666666666,0.016466666666666668,7611,4320,7706,completed
45,6666,2386,1,2-6,1,0.3087020416666667,0.0,7759,1093,10145,completed
31,3487,285,3,0-2,3-4,0.07804254166666666,0.0741,7807,4320,8092,completed
46,6676,4359,1,6-12,1,0.8426282916666666,0.0,7870,1194,12229,completed
25,3134,34571,2,48+,2,23.410695805555555,0.0,7978,4844,42549,completed
48,6819,3748,1,6-12,1,0.8662583888888887,0.0,8799,1980,12547,completed
37,4901,471,2,0-2,2,0.15046005555555558,0.08164,9221,4320,9692,completed
38,5372,118,2,0-2,2,0.04132622222222223,0.020453333333333334,9692,4320,9810,completed
39,5372,118,2,0-2,2,0.04132622222222223,0.020453333333333334,9692,4320,9810,completed
40,5375,67,4,0-2,3-4,0.046929777777777765,0.023226666666666666,9695,4320,9762,completed
49,6921,77,1,0-2,1,0.01600958333333333,0.0,10146,3225,10223,completed
51,7487,296,1,0-2,1,0.061543333333333325,0.0,10224,2737,10520,completed
53,7879,4327,1,6-12,1,1.315367861111111,0.0,10521,2642,14848,completed
54,7991,77,1,0-2,1,0.01600958333333333,0.0,10593,2602,10670,completed
55,8059,7351,1,12-24,1,2.3424743055555552,0.0,10671,2612,18022,completed
43,6624,320,2,0-2,2,0.1550311111111111,0.055466666666666664,10944,4320,11264,completed
47,6699,67,2,0-2,2,0.03245963888888888,0.011613333333333333,11019,4320,11086,completed
56,8115,6930,1,12-24,1,2.2558144305555556,0.0,11171,3056,18101,completed
57,8139,2558,1,2-6,1,0.86508625,0.0,11580,3441,14138,completed
52,7691,88,3,0-2,3-4,0.08691099999999999,0.02288,12011,4320,12099,completed
58,8157,6180,1,12-24,1,2.054999027777778,0.0,12230,4073,18410,completed
59,8170,69,1,0-2,1,0.02473458333333333,0.0,12294,4124,12363,completed
60,8215,254,1,0-2,1,0.09105194444444442,0.0,12364,4149,12618,completed
61,8229,2321,1,2-6,1,0.7409658749999999,0.0,12548,4319,14869,completed
62,8277,7144,1,12-24,1,2.537914180555555,0.0,12619,4342,19763,completed
69,9287,328,1,0-2,1,0.10455800000000001,0.028426666666666666,13607,4320,13935,completed
72,9366,756,1,0-2,1,0.23359116666666668,0.06552,13686,4320,14442,completed
74,9486,131,1,0-2,1,0.040855625000000007,0.011353333333333333,13806,4320,13937,completed
76,9583,85,1,0-2,1,0.026509375,0.007366666666666667,13903,4320,13988,completed
77,9585,69,1,0-2,1,0.021519375,0.00598,13905,4320,13974,completed
78,9614,117,1,0-2,1,0.03648937500000002,0.01014,13934,4320,14051,completed
80,9670,1169,3,0-2,3-4,0.97755025,0.30394,13990,4320,15159,completed
63,8304,7286,1,12-24,1,2.910546597222222,0.0,14139,5835,21425,completed
85,10387,1318,2,0-2,2,0.7527053055555554,0.22845333333333334,14707,4320,16025,completed
64,8680,4991,1,6-12,1,1.8692799583333335,0.0,14849,6169,19840,completed
65,8791,2081,1,2-6,1,0.667097986111111,0.0,14870,6079,16951,completed
89,11103,302,1,0-2,1,0.08449288888888887,0.026173333333333333,15423,4320,15725,completed
90,11213,175,1,0-2,1,0.0489611111111111,0.015166666666666667,15533,4320,15708,completed
91,11404,79,1,0-2,1,0.022102444444444442,0.006846666666666667,15724,4320,15803,completed
92,11435,465,1,0-2,1,0.16264999999999996,0.0403,15755,4320,16220,completed
93,11821,91,1,0-2,1,0.03325544444444445,0.007886666666666667,16141,4320,16232,completed
94,11855,68,1,0-2,1,0.024850222222222232,0.005893333333333334,16175,4320,16243,completed
95,11860,1379,3,0-2,3-4,1.480476041666667,0.35854,16180,4320,17559,completed
96,11952,277,1,0-2,1,0.10122811111111113,0.024006666666666666,16272,4320,16549,completed
97,11979,62,1,0-2,1,0.02265755555555557,0.005373333333333333,16299,4320,16361,completed
99,12477,220,1,0-2,1,0.07741250000000002,0.019066666666666666,16797,4320,17017,completed
66,9037,6248,1,12-24,1,2.608542777777778,0.0,16952,7915,23200,completed
110,12955,1388,3,0-2,3-4,1.545424375,0.36088,17275,4320,18663,completed
111,13242,189,1,0-2,1,0.068604375,0.01638,17562,4320,17751,completed
112,13597,1366,3,0-2,3-4,1.6841306666666669,0.35516000000000003,17917,4320,19283,completed
67,9049,4386,1,6-12,1,2.0189245277777776,0.0,18023,8974,22409,completed
68,9224,9360,1,12-24,1,2.912648,0.0,18102,8878,27462,completed
114,13823,61,1,0-2,1,0.02318847222222222,0.005286666666666667,18143,4320,18204,completed
70,9317,9595,1,12-24,1,2.8862899722222224,0.0,18411,9094,28006,completed
116,14272,471,2,0-2,2,0.4111319722222222,0.08164,18592,4320,19063,completed
117,14363,970,1,0-2,1,0.45874209722222214,0.08406666666666666,18683,4320,19653,completed
118,14370,67,1,0-2,1,0.028330124999999998,0.005806666666666667,18690,4320,18757,completed
119,14525,96,1,0-2,1,0.04391599999999999,0.008320000000000001,18845,4320,18941,completed
121,14823,81,3,0-2,3-4,0.11116237499999998,0.02106,19143,4320,19224,completed
123,15017,98,1,0-2,1,0.04483091666666666,0.008493333333333334,19337,4320,19435,completed
124,15068,1330,1,0-2,1,0.7328190833333333,0.11526666666666667,19388,4320,20718,completed
126,15263,125,1,0-2,1,0.0676684027777778,0.010833333333333334,19583,4320,19708,completed
127,15338,105,1,0-2,1,0.05684145833333335,0.0091,19658,4320,19763,completed
71,9334,10055,1,12-24,1,2.823718472222222,0.0,19764,10430,29819,completed
73,9461,6613,1,12-24,1,1.981187097222222,0.0,19841,10380,26454,completed
132,15766,67,1,0-2,1,0.0362702638888889,0.005806666666666667,20086,4320,20153,completed
134,16100,884,1,0-2,1,0.46393072222222215,0.07661333333333334,20420,4320,21304,completed
136,16330,104,1,0-2,1,0.05950388888888887,0.009013333333333333,20650,4320,20754,completed
137,16372,415,1,0-2,1,0.2150366111111111,0.03596666666666667,20692,4320,21107,completed
138,16667,292,1,0-2,1,0.13824577777777777,0.02530666666666667,20987,4320,21279,completed
139,16918,91,1,0-2,1,0.043083444444444445,0.007886666666666667,21238,4320,21329,completed
140,16919,621,1,0-2,1,0.26415594444444446,0.05382,21239,4320,21860,completed
142,16963,60,1,0-2,1,0.02840666666666666,0.0052,21283,4320,21343,completed
75,9489,7096,1,12-24,1,1.4868557777777776,0.0,21426,11937,28522,completed
144,17338,1163,1,0-2,1,0.37131591666666663,0.10079333333333333,21658,4320,22821,completed
145,17338,1168,1,0-2,1,0.3726523055555555,0.10122666666666667,21658,4320,22826,completed
143,17338,1175,1,0-2,1,0.37452325,0.10183333333333333,21658,4320,22833,completed
147,17682,861,3,0-2,3-4,0.77752375,0.22386,22002,4320,22863,completed
148,17703,378,1,0-2,1,0.128161125,0.03276,22023,4320,22401,completed
151,17888,69,1,0-2,1,0.024745125000000007,0.00598,22208,4320,22277,completed
152,17930,62,1,0-2,1,0.022234750000000008,0.005373333333333333,22250,4320,22312,completed
79,9665,4987,1,6-12,1,0.9126014722222222,0.0,22410,12745,27397,completed
158,18145,1042,1,0-2,1,0.2571771111111112,0.09030666666666667,22465,4320,23507,completed
159,18145,358,1,0-2,1,0.09568544444444446,0.031026666666666668,22465,4320,22823,completed
156,18145,949,1,0-2,1,0.2365672777777778,0.08224666666666666,22465,4320,23414,completed
155,18145,1322,1,0-2,1,0.3183754722222223,0.11457333333333333,22465,4320,23787,completed
154,18145,1347,1,0-2,1,0.3231261666666667,0.11674,22465,4320,23812,completed
153,18145,1319,1,0-2,1,0.31780538888888893,0.11431333333333334,22465,4320,23784,completed
164,18222,581,1,0-2,1,0.15149805555555557,0.05035333333333333,22542,4320,23123,completed
167,18357,1426,1,0-2,1,0.3217613611111112,0.12358666666666666,22677,4320,24103,completed
168,18471,374,2,0-2,2,0.18850711111111113,0.06482666666666667,22791,4320,23165,completed
169,18508,193,4,0-2,3-4,0.20633844444444444,0.06690666666666667,22828,4320,23021,completed
81,9793,5813,1,12-24,1,1.0569709444444446,0.0,23201,13408,29014,completed
171,18888,157,4,0-2,3-4,0.13917177777777778,0.054426666666666665,23208,4320,23365,completed
172,18909,195,1,0-2,1,0.04321416666666668,0.016900000000000002,23229,4320,23424,completed
173,19019,327,1,0-2,1,0.07246683333333334,0.02834,23339,4320,23666,completed
174,19063,71,1,0-2,1,0.015734388888888895,0.006153333333333334,23383,4320,23454,completed
175,19128,880,4,0-2,3-4,0.7083137777777777,0.30506666666666665,23448,4320,24328,completed
176,19151,156,4,0-2,3-4,0.13828533333333337,0.05408,23471,4320,23627,completed
177,19153,64,1,0-2,1,0.014183111111111115,0.005546666666666667,23473,4320,23537,completed
178,19312,230,2,0-2,2,0.09549811111111112,0.03986666666666667,23632,4320,23862,completed
179,19580,255,4,0-2,3-4,0.19382833333333332,0.0884,23900,4320,24155,completed
180,19717,80,1,0-2,1,0.015202222222222221,0.006933333333333333,24037,4320,24117,completed
181,19736,176,1,0-2,1,0.033444888888888885,0.015253333333333334,24056,4320,24232,completed
182,19900,375,1,0-2,1,0.06888694444444443,0.0325,24220,4320,24595,completed
183,19962,388,1,0-2,1,0.06980938888888888,0.033626666666666666,24282,4320,24670,completed
184,19996,103,1,0-2,1,0.019572861111111114,0.008926666666666666,24316,4320,24419,completed
186,20149,440,1,0-2,1,0.07475813888888888,0.03813333333333333,24469,4320,24909,completed
187,20173,261,1,0-2,1,0.0442105,0.02262,24493,4320,24754,completed
50,7474,11448,4,12-24,3-4,15.925011333333332,3.96864,24754,17280,36202,completed
188,20527,93,1,0-2,1,0.015753166666666665,0.00806,24847,4320,24940,completed
189,20538,884,1,0-2,1,0.13999130555555556,0.07661333333333334,24858,4320,25742,completed
194,21484,69,1,0-2,1,0.010446791666666668,0.00598,25804,4320,25873,completed
195,21563,745,1,0-2,1,0.10857656944444442,0.06456666666666666,25883,4320,26628,completed
196,21591,610,1,0-2,1,0.0887747361111111,0.052866666666666666,25911,4320,26521,completed
197,21637,784,1,0-2,1,0.11420098611111108,0.06794666666666667,25957,4320,26741,completed
198,21673,782,1,0-2,1,0.11396818055555552,0.06777333333333334,25993,4320,26775,completed
199,21778,1145,1,0-2,1,0.16756401388888886,0.09923333333333334,26098,4320,27243,completed
200,21946,611,1,0-2,1,0.08927143055555554,0.05295333333333333,26266,4320,26877,completed
201,22124,84,1,0-2,1,0.012217333333333332,0.00728,26444,4320,26528,completed
82,9840,6355,1,12-24,1,1.961103888888889,0.0,26455,16615,32810,completed
202,22438,277,1,0-2,1,0.04076131944444444,0.024006666666666666,26758,4320,27035,completed
204,22509,122,1,0-2,1,0.017952638888888886,0.010573333333333334,26829,4320,26951,completed
203,22509,78,1,0-2,1,0.011477916666666662,0.00676,26829,4320,26907,completed
205,22647,224,1,0-2,1,0.03296222222222222,0.019413333333333335,26967,4320,27191,completed
206,22818,61,1,0-2,1,0.008976319444444441,0.005286666666666667,27138,4320,27199,completed
208,22931,197,1,0-2,1,0.030777208333333327,0.017073333333333333,27251,4320,27448,completed
209,22988,199,1,0-2,1,0.03227036111111111,0.017246666666666667,27308,4320,27507,completed
83,10187,8318,1,12-24,1,3.3162975,0.0,27398,17211,35716,completed
210,23087,542,1,0-2,1,0.09076994444444444,0.04697333333333333,27407,4320,27949,completed
84,10348,2954,1,6-12,1,0.8966336527777778,0.0,27463,17115,30417,completed
86,10396,9304,1,12-24,1,3.9663468333333336,0.8063466666666667,27676,17280,36980,completed
87,10457,7078,1,12-24,1,2.766785263888889,0.6134266666666667,27737,17280,34815,completed
88,10477,12607,1,24-48,1,5.521242194444444,1.0926066666666667,27757,17280,40364,completed
212,23478,251,1,0-2,1,0.042035527777777776,0.021753333333333333,27798,4320,28049,completed
98,12054,2661,1,2-6,1,0.9016791944444444,0.0,28007,15953,30668,completed
213,23710,897,1,0-2,1,0.21033544444444444,0.07774,28030,4320,28927,completed
214,23725,67,1,0-2,1,0.012755750000000003,0.005806666666666667,28045,4320,28112,completed
216,23810,879,1,0-2,1,0.22143394444444442,0.07618,28130,4320,29009,completed
217,23906,337,1,0-2,1,0.0726047777777778,0.029206666666666665,28226,4320,28563,completed
218,24058,65,1,0-2,1,0.014003888888888892,0.005633333333333333,28378,4320,28443,completed
101,12539,3275,1,6-12,1,1.211861138888889,0.0,28523,15984,31798,completed
219,24289,203,1,0-2,1,0.04557588888888889,0.017593333333333332,28609,4320,28812,completed
220,24359,96,1,0-2,1,0.02068266666666667,0.008320000000000001,28679,4320,28775,completed
221,24363,87,1,0-2,1,0.018743666666666676,0.00754,28683,4320,28770,completed
222,24481,378,1,0-2,1,0.13941900000000002,0.03276,28801,4320,29179,completed
100,12539,3768,1,6-12,1,1.4616555,0.0,29015,16476,32783,completed
225,24890,103,1,0-2,1,0.03798983333333333,0.008926666666666666,29210,4320,29313,completed
226,25081,67,1,0-2,1,0.024711833333333332,0.005806666666666667,29401,4320,29468,completed
102,12549,1730,1,2-6,1,0.6683325,0.0,29820,17271,31550,completed
103,12549,1730,1,2-6,1,0.6677975,0.14993333333333334,29829,17280,31559,completed
230,25585,1313,1,0-2,1,0.5115264722222221,0.11379333333333333,29905,4320,31218,completed
232,25598,189,2,0-2,2,0.16003049999999996,0.03276,29918,4320,30107,completed
231,25598,189,2,0-2,2,0.16003049999999996,0.03276,29918,4320,30107,completed
104,12664,5781,1,12-24,1,2.6067505833333335,0.50102,29944,17280,35725,completed
234,25678,125,1,0-2,1,0.052920138888888885,0.010833333333333334,29998,4320,30123,completed
235,25725,83,2,0-2,2,0.07027794444444442,0.014386666666666667,30045,4320,30128,completed
106,12851,4743,1,6-12,1,2.0626705555555556,0.41106,30131,17280,34874,completed
105,12851,4752,1,6-12,1,2.0676559305555555,0.41184,30131,17280,34883,completed
107,12852,4772,1,6-12,1,2.078865111111111,0.41357333333333335,30132,17280,34904,completed
108,12857,4809,1,6-12,1,2.1000133888888888,0.41678,30137,17280,34946,completed
109,12877,3134,1,6-12,1,1.237663597222222,0.2716133333333333,30157,17280,33291,completed
113,13795,1553,1,2-6,1,0.5780855972222222,0.0,30418,16623,31971,completed
236,26334,88,1,0-2,1,0.033710111111111114,0.007626666666666667,30654,4320,30742,completed
120,14545,4946,1,6-12,1,2.257769180555555,0.0,30669,16124,35615,completed
237,26539,534,1,0-2,1,0.19626593055555552,0.04628,30859,4320,31393,completed
239,26559,592,1,0-2,1,0.21699004166666663,0.05130666666666667,30879,4320,31471,completed
240,26611,73,1,0-2,1,0.027121347222222217,0.006326666666666667,30931,4320,31004,completed
241,26639,197,1,0-2,1,0.07171073611111109,0.017073333333333333,30959,4320,31156,completed
242,26777,143,1,0-2,1,0.052040083333333306,0.012393333333333334,31097,4320,31240,completed
243,26797,231,1,0-2,1,0.08406475,0.02002,31117,4320,31348,completed
244,26884,67,1,0-2,1,0.024382416666666656,0.005806666666666667,31204,4320,31271,completed
245,26885,65,1,0-2,1,0.023654583333333326,0.005633333333333333,31205,4320,31270,completed
246,26889,283,1,0-2,1,0.10298841666666664,0.024526666666666665,31209,4320,31492,completed
247,26892,107,1,0-2,1,0.038939083333333326,0.009273333333333333,31212,4320,31319,completed
248,26993,784,1,0-2,1,0.288953625,0.06794666666666667,31313,4320,32097,completed
249,27169,459,1,0-2,1,0.1693790277777778,0.03978,31489,4320,31948,completed
115,14245,4271,2,6-12,2,4.076614833333333,0.7403066666666667,31525,17280,35796,completed
122,14830,1875,1,2-6,1,0.780533,0.0,31551,16721,33426,completed
250,27246,67,1,0-2,1,0.024382416666666656,0.005806666666666667,31566,4320,31633,completed
251,27251,114,1,0-2,1,0.04153018055555556,0.00988,31571,4320,31685,completed
252,27321,949,1,0-2,1,0.3640760833333334,0.08224666666666666,31641,4320,32590,completed
128,15562,1740,1,2-6,1,0.7469081666666667,0.0,31799,16237,33539,completed
129,15565,1927,1,2-6,1,0.8655371944444445,0.0,31972,16407,33899,completed
255,27921,1215,1,0-2,1,0.539839125,0.1053,32241,4320,33456,completed
125,15128,3727,2,6-12,2,3.7876481666666666,0.6460133333333333,32408,17280,36135,completed
256,28282,798,1,0-2,1,0.36528411111111114,0.06916,32602,4320,33400,completed
257,28287,753,1,0-2,1,0.3427246666666667,0.06526,32607,4320,33360,completed
258,28360,133,1,0-2,1,0.05710133333333332,0.011526666666666668,32680,4320,32813,completed
130,15724,3285,1,6-12,1,1.6963935833333332,0.0,32784,17060,36069,completed
131,15730,3684,1,6-12,1,1.9171727499999998,0.0,32811,17081,36495,completed
259,28672,1075,1,0-2,1,0.5358531388888889,0.09316666666666666,32992,4320,34067,completed
133,15873,22293,1,24-48,1,6.966525458333333,1.93206,33153,17280,55446,completed
260,28863,317,1,0-2,1,0.16177126388888888,0.027473333333333332,33183,4320,33500,completed
262,29069,1100,4,0-2,3-4,2.2182557222222217,0.38133333333333336,33389,4320,34489,completed
135,16234,2495,1,2-6,1,1.3157617638888888,0.0,33427,17193,35922,completed
263,29169,160,1,0-2,1,0.0816511111111111,0.013866666666666666,33489,4320,33649,completed
146,17611,2681,1,2-6,1,1.4207151944444445,0.0,33540,15929,36221,completed
264,29282,1011,3,0-2,3-4,1.532143041666666,0.26286,33602,4320,34613,completed
265,29298,70,1,0-2,1,0.035722361111111094,0.006066666666666666,33618,4320,33688,completed
266,29466,77,1,0-2,1,0.03905405555555555,0.006673333333333333,33786,4320,33863,completed
149,17795,1518,1,2-6,1,0.8031701666666666,0.0,33900,16105,35418,completed
268,29728,247,1,0-2,1,0.12346569444444438,0.021406666666666668,34048,4320,34295,completed
141,16929,6422,2,12-24,2,6.289906833333333,1.1131466666666667,34209,17280,40631,completed
270,29934,288,1,0-2,1,0.14395999999999998,0.02496,34254,4320,34542,completed
271,29949,186,1,0-2,1,0.09297416666666664,0.01612,34269,4320,34455,completed
272,30024,284,1,0-2,1,0.14563727777777777,0.024613333333333334,34344,4320,34628,completed
273,30093,457,1,0-2,1,0.24519805555555557,0.039606666666666665,34413,4320,34870,completed
275,30345,124,1,0-2,1,0.0686873888888889,0.010746666666666667,34665,4320,34789,completed
276,30346,324,1,0-2,1,0.17947350000000004,0.02808,34666,4320,34990,completed
277,30347,142,1,0-2,1,0.0786581388888889,0.012306666666666667,34667,4320,34809,completed
278,30349,123,1,0-2,1,0.06813345833333334,0.01066,34669,4320,34792,completed
279,30353,370,1,0-2,1,0.2049543055555556,0.03206666666666667,34673,4320,35043,completed
280,30629,586,1,0-2,1,0.3208880972222222,0.05078666666666667,34949,4320,35535,completed
150,17871,2813,1,2-6,1,1.5720513194444443,0.24379333333333333,35151,17280,37964,completed
157,18145,1479,1,2-6,1,0.8092721666666666,0.0,35419,17274,36898,completed
160,18146,1686,1,2-6,1,0.9295244999999999,0.14612,35426,17280,37112,completed
161,18146,1643,1,2-6,1,0.9046030138888888,0.14239333333333334,35426,17280,37069,completed
162,18172,1862,1,2-6,1,1.0325741388888887,0.16137333333333334,35452,17280,37314,completed
163,18178,1994,1,2-6,1,1.1092848888888887,0.17281333333333335,35458,17280,37452,completed
165,18273,1440,1,2-6,1,0.7920568749999999,0.12480000000000001,35553,17280,36993,completed
282,31235,110,1,0-2,1,0.0593297222222222,0.009533333333333333,35555,4320,35665,completed
166,18309,1759,1,2-6,1,0.9783870277777778,0.15244666666666667,35589,17280,37348,completed
185,20036,11017,1,12-24,1,3.672170402777778,0.0,35616,15580,46633,completed
190,20543,1531,1,2-6,1,0.8513918611111111,0.0,35717,15174,37248,completed
191,20566,1466,1,2-6,1,0.8220027638888887,0.0,35923,15357,37389,completed
170,18652,9340,3,12-24,3-4,9.504951,2.4284,35932,17280,45272,completed
192,20837,10936,1,12-24,1,3.5198610833333333,0.0,36070,15233,47006,completed
207,22888,1607,1,2-6,1,0.9132963194444443,0.0,36222,13334,37829,completed
283,31921,268,1,0-2,1,0.1461865555555556,0.023226666666666666,36241,4320,36509,completed
211,23227,2388,1,2-6,1,1.3132846666666664,0.0,36496,13269,38884,completed
284,32262,1421,1,0-2,1,0.8172832361111109,0.12315333333333334,36582,4320,38003,completed
285,32302,67,1,0-2,1,0.0365466388888889,0.005806666666666667,36622,4320,36689,completed
287,32401,403,1,0-2,1,0.23356648611111103,0.03492666666666667,36721,4320,37124,completed
288,32442,68,1,0-2,1,0.0394107222222222,0.005893333333333334,36762,4320,36830,completed
289,32572,127,2,0-2,2,0.14721063888888883,0.022013333333333333,36892,4320,37019,completed
223,24590,1898,1,2-6,1,1.0447690694444445,0.0,36899,12309,38797,completed
291,32694,108,1,0-2,1,0.06259349999999997,0.00936,37014,4320,37122,completed
224,24763,42957,1,48+,1,8.236329847222223,0.0,37249,12486,80206,completed
227,25100,12719,1,24-48,1,3.4792507222222224,0.0,37390,12290,50109,completed
292,33074,95,2,0-2,2,0.10984324999999995,0.016466666666666668,37394,4320,37489,completed
293,33083,95,2,0-2,2,0.10979274999999997,0.016466666666666668,37403,4320,37498,completed
228,25104,11168,1,12-24,1,2.9674671388888894,0.0,37830,12726,48998,completed
294,33652,190,1,0-2,1,0.1094236111111111,0.016466666666666668,37972,4320,38162,completed
295,33694,82,1,0-2,1,0.04729463888888888,0.0071066666666666665,38014,4320,38096,completed
296,33771,77,1,0-2,1,0.043764708333333346,0.006673333333333333,38091,4320,38168,completed
297,33838,68,4,0-2,3-4,0.13555811111111116,0.023573333333333335,38158,4320,38226,completed
298,33978,91,3,0-2,3-4,0.13540800000000003,0.02366,38298,4320,38389,completed
193,21039,31269,2,24-48,2,12.970352000000002,5.41996,38319,17280,69588,completed
300,34153,65,1,0-2,1,0.032240000000000005,0.005633333333333333,38473,4320,38538,completed
301,34156,83,2,0-2,2,0.08233600000000002,0.014386666666666667,38476,4320,38559,completed
302,34382,133,1,0-2,1,0.06596800000000003,0.011526666666666668,38702,4320,38835,completed
229,25139,3460,1,6-12,1,0.9701399166666668,0.0,38798,13659,42258,completed
304,34486,1338,1,0-2,1,0.4904071111111112,0.11596000000000001,38806,4320,40144,completed
233,25676,3049,1,6-12,1,0.8716918055555556,0.0,38885,13209,41934,completed
305,34840,62,1,0-2,1,0.021992777777777778,0.005373333333333333,39160,4320,39222,completed
306,35170,62,1,0-2,1,0.021992777777777778,0.005373333333333333,39490,4320,39552,completed
307,35197,67,1,0-2,1,0.023766388888888892,0.005806666666666667,39517,4320,39584,completed
309,35609,1228,1,0-2,1,0.35452048611111114,0.10642666666666667,39929,4320,41157,completed
310,35609,1047,1,0-2,1,0.3156050277777778,0.09074,39929,4320,40976,completed
312,35610,1122,1,0-2,1,0.33438533333333337,0.09724000000000001,39930,4320,41052,completed
313,35610,1108,1,0-2,1,0.3315981666666667,0.09602666666666666,39930,4320,41038,completed
315,35760,69,1,0-2,1,0.02515241666666666,0.00598,40080,4320,40149,completed
316,35765,721,1,0-2,1,0.2138870277777778,0.06248666666666667,40085,4320,40806,completed
317,36083,192,1,0-2,1,0.05065600000000001,0.016640000000000002,40403,4320,40595,completed
318,36201,63,1,0-2,1,0.016621500000000004,0.0054600000000000004,40521,4320,40584,completed
321,36280,801,1,0-2,1,0.18405995833333333,0.06942,40600,4320,41401,completed
323,36471,658,4,0-2,3-4,0.5708231666666668,0.22810666666666668,40791,4320,41449,completed
324,36530,282,1,0-2,1,0.06745116666666667,0.02444,40850,4320,41132,completed
325,36581,217,2,0-2,2,0.10271916666666667,0.03761333333333333,40901,4320,41118,completed
326,36684,94,1,0-2,1,0.02041891666666666,0.008146666666666667,41004,4320,41098,completed
215,23773,3220,4,6-12,3-4,2.4446511666666666,1.1162666666666667,41053,17280,44273,completed
332,37535,242,1,0-2,1,0.041829027777777784,0.020973333333333333,41855,4320,42097,completed
238,26542,5113,1,6-12,1,1.1120442916666666,0.0,41935,15393,47048,completed
333,37640,120,1,0-2,1,0.02074166666666667,0.0104,41960,4320,42080,completed
253,27340,2085,1,2-6,1,0.4074039027777778,0.0,42259,14919,44344,completed
335,38128,1022,1,0-2,1,0.19158486111111114,0.08857333333333334,42448,4320,43470,completed
254,27826,1840,2,2-6,2,0.7329536111111112,0.0,42550,14724,44390,completed
337,38721,1060,1,0-2,1,0.21282920833333335,0.09186666666666667,43041,4320,44101,completed
339,38843,136,1,0-2,1,0.026568361111111112,0.011786666666666668,43163,4320,43299,completed
340,38845,327,1,0-2,1,0.06476118055555556,0.02834,43165,4320,43492,completed
341,38894,870,1,0-2,1,0.17711925,0.0754,43214,4320,44084,completed
343,39034,1058,1,0-2,1,0.22128108333333335,0.09169333333333334,43354,4320,44412,completed
347,39155,1284,1,0-2,1,0.2749412361111111,0.11128,43475,4320,44759,completed
348,39174,93,1,0-2,1,0.018580625000000003,0.00806,43494,4320,43587,completed
350,39237,743,1,0-2,1,0.15609270833333336,0.06439333333333333,43557,4320,44300,completed
351,39247,773,1,0-2,1,0.16289145833333335,0.06699333333333334,43567,4320,44340,completed
353,39363,759,1,0-2,1,0.16214712500000003,0.06578,43683,4320,44442,completed
354,39371,409,1,0-2,1,0.08533729166666668,0.03544666666666667,43691,4320,44100,completed
355,39403,1236,1,0-2,1,0.27193734722222224,0.10712,43723,4320,44959,completed
356,39481,462,1,0-2,1,0.09920662500000002,0.04004,43801,4320,44263,completed
357,39491,437,1,0-2,1,0.09390995833333336,0.037873333333333335,43811,4320,44248,completed
358,39886,65,1,0-2,1,0.014294583333333334,0.005633333333333333,44206,4320,44271,completed
359,39922,780,2,0-2,2,0.3528534444444445,0.13520000000000001,44242,4320,45022,completed
261,28962,4050,1,6-12,1,0.9474626388888889,0.0,44345,15383,48395,completed
267,29723,23537,1,24-48,1,4.673259027777778,0.0,44391,14668,67928,completed
274,30204,1703,1,2-6,1,0.3943588888888888,0.0,44391,14187,46094,completed
360,40319,141,1,0-2,1,0.03280102777777777,0.01222,44639,4320,44780,completed
362,40724,1134,1,0-2,1,0.2675376944444444,0.09828,45044,4320,46178,completed
361,40724,1134,1,0-2,1,0.2675376944444444,0.09828,45044,4320,46178,completed
364,41001,205,1,0-2,1,0.0478971111111111,0.017766666666666667,45321,4320,45526,completed
363,41001,173,1,0-2,1,0.04041355555555555,0.014993333333333334,45321,4320,45494,completed
365,41312,160,1,0-2,1,0.03741777777777777,0.013866666666666666,45632,4320,45792,completed
367,41325,150,1,0-2,1,0.03507916666666667,0.013,45645,4320,45795,completed
366,41325,150,1,0-2,1,0.03507916666666667,0.013,45645,4320,45795,completed
369,41607,1107,1,0-2,1,0.28003050000000007,0.09594,45927,4320,47034,completed
286,32304,2799,1,2-6,1,0.6545576250000001,0.0,46095,13791,48894,completed
299,34091,2289,1,2-6,1,0.5201607500000001,0.0,46634,12543,48923,completed
308,35461,1514,1,2-6,1,0.33710159722222227,0.0,47007,11546,48521,completed
311,35610,1576,1,2-6,1,0.3503507361111111,0.0,47049,11439,48625,completed
269,29797,1819,2,2-6,2,0.8087584722222223,0.3152933333333333,47077,17280,48896,completed
281,30697,3049,4,6-12,3-4,2.840545166666667,1.0569866666666667,47977,17280,51026,completed
376,43891,1150,2,0-2,2,0.5177839166666667,0.19933333333333333,48211,4320,49361,completed
375,43891,155,1,0-2,1,0.03433081944444445,0.013433333333333334,48211,4320,48366,completed
377,43910,180,1,0-2,1,0.040199861111111124,0.015600000000000001,48230,4320,48410,completed
378,43982,171,2,0-2,2,0.07664600000000002,0.02964,48302,4320,48473,completed
314,35613,2060,1,2-6,1,0.4764535555555556,0.0,48396,12783,50456,completed
379,44138,140,1,0-2,1,0.03137555555555556,0.012133333333333333,48458,4320,48598,completed
319,36204,3223,1,6-12,1,0.7627712222222223,0.0,48522,12318,51745,completed
381,44214,1049,1,0-2,1,0.23753263888888893,0.09091333333333333,48534,4320,49583,completed
382,44268,198,1,0-2,1,0.04437400000000001,0.01716,48588,4320,48786,completed
320,36269,2678,1,2-6,1,0.6354366666666666,0.0,48626,12357,51304,completed
383,44357,786,1,0-2,1,0.1781214166666667,0.06812,48677,4320,49463,completed
384,44409,949,1,0-2,1,0.21549361111111118,0.08224666666666666,48729,4320,49678,completed
385,44459,1168,1,0-2,1,0.26844586111111113,0.10122666666666667,48779,4320,49947,completed
386,44536,824,1,0-2,1,0.1874875555555556,0.07141333333333333,48856,4320,49680,completed
387,44538,185,1,0-2,1,0.04178563888888889,0.016033333333333333,48858,4320,49043,completed
322,36435,5286,1,6-12,1,1.2012747222222222,0.0,48895,12460,54181,completed
328,37065,11598,1,24-48,1,2.2368344166666665,0.0,48924,11859,60522,completed
329,37107,3611,1,6-12,1,0.8502734444444444,0.0,48999,11892,52610,completed
388,44818,689,1,0-2,1,0.15866280555555556,0.059713333333333334,49138,4320,49827,completed
390,44963,535,1,0-2,1,0.12345152777777779,0.04636666666666667,49283,4320,49818,completed
391,45053,472,1,0-2,1,0.10937077777777779,0.04090666666666667,49373,4320,49845,completed
392,45193,394,1,0-2,1,0.09223905555555556,0.034146666666666665,49513,4320,49907,completed
393,45295,1179,1,0-2,1,0.28576941666666666,0.10218,49615,4320,50794,completed
394,45498,1080,1,0-2,1,0.2641993333333333,0.0936,49818,4320,50898,completed
395,45499,847,1,0-2,1,0.20556763888888888,0.07340666666666666,49819,4320,50666,completed
396,45622,356,1,0-2,1,0.08493566666666666,0.030853333333333333,49942,4320,50298,completed
290,32670,2561,4,2-6,3-4,2.437403611111111,0.8878133333333333,49950,17280,52511,completed
398,45710,292,1,0-2,1,0.06966633333333333,0.02530666666666667,50030,4320,50322,completed
399,45711,281,1,0-2,1,0.06704191666666666,0.024353333333333334,50031,4320,50312,completed
400,45732,848,1,0-2,1,0.20887422222222224,0.07349333333333334,50052,4320,50900,completed
331,37335,9897,1,12-24,1,1.8898495277777776,0.0,50110,12775,60007,completed
402,45862,294,1,0-2,1,0.07113994444444444,0.02548,50182,4320,50476,completed
336,38669,1576,1,2-6,1,0.38012501388888886,0.0,50457,11788,52033,completed
403,46142,593,1,0-2,1,0.14925480555555554,0.05139333333333333,50462,4320,51055,completed
404,46424,350,1,0-2,1,0.08809305555555555,0.030333333333333334,50744,4320,51094,completed
407,46720,71,2,0-2,2,0.03574061111111109,0.012306666666666667,51040,4320,51111,completed
342,38982,1575,1,2-6,1,0.35340833333333327,0.0,51305,12323,52880,completed
408,47229,187,1,0-2,1,0.04411122222222221,0.016206666666666668,51549,4320,51736,completed
409,47241,72,1,0-2,1,0.016983999999999996,0.00624,51561,4320,51633,completed
303,34398,23251,2,24-48,2,7.686525861111111,4.030173333333334,51678,17280,74929,completed
344,39119,3503,1,6-12,1,0.7652939305555555,0.0,51746,12627,55249,completed
410,47700,817,1,0-2,1,0.17795126388888888,0.07080666666666667,52020,4320,52837,completed
345,39130,4834,1,6-12,1,1.002002638888889,0.0,52034,12904,56868,completed
412,47824,111,1,0-2,1,0.024967291666666655,0.00962,52144,4320,52255,completed
413,47910,61,1,0-2,1,0.01372076388888889,0.005286666666666667,52230,4320,52291,completed
415,48123,63,1,0-2,1,0.014170625000000003,0.0054600000000000004,52443,4320,52506,completed
416,48154,199,2,0-2,2,0.08477636111111109,0.034493333333333334,52474,4320,52673,completed
346,39130,4834,1,6-12,1,0.9539418333333334,0.0,52611,13481,57445,completed
352,39249,1697,1,2-6,1,0.36259329166666665,0.0,52881,13632,54578,completed
417,48606,112,1,0-2,1,0.022840222222222227,0.009706666666666667,52926,4320,53038,completed
418,48670,137,1,0-2,1,0.027938486111111112,0.011873333333333333,52990,4320,53127,completed
420,48927,94,1,0-2,1,0.019415166666666678,0.008146666666666667,53247,4320,53341,completed
421,49475,449,1,0-2,1,0.09814145833333333,0.038913333333333334,53795,4320,54244,completed
422,49515,607,3,0-2,3-4,0.404604375,0.15782000000000002,53835,4320,54442,completed
423,49616,589,3,0-2,3-4,0.3982405,0.15314,53936,4320,54525,completed
424,49690,1004,3,0-2,3-4,0.6860017499999999,0.26104,54010,4320,55014,completed
327,36816,4714,3,6-12,3-4,2.544485833333333,1.22564,54096,17280,58810,completed
368,41387,1487,1,2-6,1,0.3378156666666666,0.0,54182,12795,55669,completed
425,49978,169,1,0-2,1,0.038447499999999996,0.014646666666666667,54298,4320,54467,completed
426,49982,138,1,0-2,1,0.031395,0.01196,54302,4320,54440,completed
427,50035,126,1,0-2,1,0.028664999999999986,0.010920000000000001,54355,4320,54481,completed
428,50136,123,1,0-2,1,0.02798249999999999,0.01066,54456,4320,54579,completed
330,37189,5415,3,6-12,3-4,2.6613238333333333,1.4079,54469,17280,59884,completed
370,42489,3661,1,6-12,1,0.6625274999999999,0.0,54579,12090,58240,completed
429,50677,127,1,0-2,1,0.02900362499999999,0.011006666666666666,54997,4320,55124,completed
430,50698,377,1,0-2,1,0.086097375,0.03267333333333333,55018,4320,55395,completed
371,42594,4585,1,6-12,1,0.7020808333333334,0.0,55250,12656,59835,completed
334,38060,8256,2,12-24,2,2.787126777777778,1.43104,55340,17280,63596,completed
433,51206,126,4,0-2,3-4,0.11222399999999996,0.043680000000000004,55526,4320,55652,completed
372,42783,2656,1,2-6,1,0.42867383333333337,0.0,55670,12887,58326,completed
435,51572,107,3,0-2,3-4,0.07147599999999998,0.02782,55892,4320,55999,completed
436,51611,856,2,0-2,2,0.2765834166666666,0.14837333333333333,55931,4320,56787,completed
338,38746,2142,2,2-6,2,0.6474946666666667,0.37128,56026,17280,58168,completed
437,51799,92,1,0-2,1,0.016230374999999995,0.007973333333333334,56119,4320,56211,completed
438,52072,1154,1,0-2,1,0.16104847222222224,0.10001333333333333,56392,4320,57546,completed
349,39185,2539,2,2-6,2,0.7275799722222223,0.44009333333333334,56465,17280,59004,completed
440,52367,1299,1,0-2,1,0.19073006944444448,0.11258,56687,4320,57986,completed
442,52367,1348,1,0-2,1,0.19875381944444448,0.11682666666666666,56687,4320,58035,completed
447,52368,277,1,0-2,1,0.038615625,0.024006666666666666,56688,4320,56965,completed
448,52368,277,1,0-2,1,0.038615625,0.024006666666666666,56688,4320,56965,completed
373,42786,3009,1,6-12,1,0.4056938750000001,0.0,56869,14083,59878,completed
374,43771,4646,1,6-12,1,0.6514904166666667,0.0,57446,13675,62092,completed
452,53549,397,2,0-2,2,0.1300175,0.06881333333333334,57869,4320,58266,completed
453,53555,480,1,0-2,1,0.07734388888888888,0.0416,57875,4320,58355,completed
454,53584,132,1,0-2,1,0.021615000000000006,0.01144,57904,4320,58036,completed
380,44187,3610,1,6-12,1,0.4781966666666667,0.0,58241,14054,61851,completed
389,44928,10297,1,12-24,1,1.7341691944444446,0.0,58327,13399,68624,completed
397,45674,2719,1,2-6,1,0.43045051388888894,0.0,59836,14162,62555,completed
401,45811,16642,1,24-48,1,2.470898069444445,0.0,59879,14068,76521,completed
406,46681,2204,1,2-6,1,0.3336066111111111,0.0,60008,13327,62212,completed
462,56158,691,1,0-2,1,0.09340131944444446,0.059886666666666664,60478,4320,61169,completed
414,48049,1771,1,2-6,1,0.2788396805555555,0.0,60523,12474,62294,completed
463,56269,731,1,0-2,1,0.10059501388888892,0.06335333333333333,60589,4320,61320,completed
465,56454,257,1,0-2,1,0.034734263888888894,0.022273333333333332,60774,4320,61031,completed
466,56456,919,1,0-2,1,0.13162352777777778,0.07964666666666667,60776,4320,61695,completed
467,56645,923,1,0-2,1,0.13505645833333332,0.07999333333333333,60965,4320,61888,completed
471,57157,306,1,0-2,1,0.0459425,0.026520000000000002,61477,4320,61783,completed
472,57384,160,1,0-2,1,0.02402222222222222,0.013866666666666666,61704,4320,61864,completed
431,51075,2461,1,2-6,1,0.6317746527777779,0.0,61852,10777,64313,completed
473,57541,91,1,0-2,1,0.015638194444444444,0.007886666666666667,61861,4320,61952,completed
474,57542,318,1,0-2,1,0.06379555555555555,0.02756,61862,4320,62180,completed
475,57699,105,1,0-2,1,0.022246874999999996,0.0091,62019,4320,62124,completed
432,51154,1919,1,2-6,1,0.5052524027777778,0.0,62093,10939,64012,completed
476,57839,365,1,0-2,1,0.07733437499999998,0.03163333333333333,62159,4320,62524,completed
477,57840,544,1,0-2,1,0.11876666666666667,0.04714666666666667,62160,4320,62704,completed
434,51515,10525,1,12-24,1,1.7345446250000003,0.0,62213,10698,72738,completed
478,57919,67,1,0-2,1,0.014195625000000002,0.005806666666666667,62239,4320,62306,completed
439,52366,1604,1,2-6,1,0.4282491805555556,0.0,62295,9929,63899,completed
444,52367,7298,1,12-24,1,1.2603509444444447,0.0,62556,10189,69854,completed
479,58363,664,1,0-2,1,0.1770666666666667,0.05754666666666667,62683,4320,63347,completed
480,58498,257,1,0-2,1,0.06853333333333335,0.022273333333333332,62818,4320,63075,completed
481,58787,245,1,0-2,1,0.06533333333333334,0.021233333333333333,63107,4320,63352,completed
482,59218,130,1,0-2,1,0.03935027777777778,0.011266666666666666,63538,4320,63668,completed
483,59286,617,1,0-2,1,0.179733625,0.05347333333333333,63606,4320,64223,completed
405,46610,6531,4,12-24,3-4,3.804059555555556,2.26408,63890,17280,70421,completed
446,52367,3941,1,6-12,1,0.6631446944444445,0.0,63900,11533,67841,completed
441,52367,7217,1,12-24,1,1.0049044166666667,0.0,64013,11646,71230,completed
445,52367,2313,1,2-6,1,0.4093387500000001,0.0,64314,11947,66627,completed
488,60350,751,1,0-2,1,0.1483887916666667,0.06508666666666667,64670,4320,65421,completed
411,47790,2259,4,2-6,3-4,1.2751260000000002,0.78312,65070,17280,67329,completed
491,61146,137,1,0-2,1,0.022028444444444448,0.011873333333333333,65466,4320,65603,completed
492,61158,123,1,0-2,1,0.019509000000000002,0.01066,65478,4320,65601,completed
493,61159,121,1,0-2,1,0.01917865277777778,0.010486666666666667,65479,4320,65600,completed
494,61220,427,2,0-2,2,0.1233792777777778,0.07401333333333333,65540,4320,65967,completed
495,61226,156,2,0-2,2,0.04507533333333334,0.02704,65546,4320,65702,completed
496,61312,431,1,0-2,1,0.06226752777777779,0.037353333333333336,65632,4320,66063,completed
497,61312,431,1,0-2,1,0.06226752777777779,0.037353333333333336,65632,4320,66063,completed
498,61330,712,1,0-2,1,0.10045472222222224,0.06170666666666667,65650,4320,66362,completed
500,61602,601,1,0-2,1,0.08123855555555556,0.05208666666666667,65922,4320,66523,completed
419,48727,4357,2,6-12,2,1.001287611111111,0.7552133333333333,66007,17280,70364,completed
501,61704,641,1,0-2,1,0.08421294444444445,0.055553333333333337,66024,4320,66665,completed
502,61805,974,1,0-2,1,0.12197844444444446,0.08441333333333334,66125,4320,67099,completed
504,62001,508,1,0-2,1,0.06335888888888888,0.044026666666666665,66321,4320,66829,completed
503,62001,206,1,0-2,1,0.02569277777777778,0.017853333333333332,66321,4320,66527,completed
507,62292,619,1,0-2,1,0.07374780555555557,0.05364666666666667,66612,4320,67231,completed
443,52367,1995,1,2-6,1,0.2280443472222223,0.0,66628,14261,68623,completed
508,62553,389,1,0-2,1,0.04466644444444445,0.03371333333333333,66873,4320,67262,completed
509,62705,823,1,0-2,1,0.09195713888888893,0.07132666666666666,67025,4320,67848,completed
511,63329,217,1,0-2,1,0.024080972222222233,0.018806666666666666,67649,4320,67866,completed
449,52785,5805,1,12-24,1,0.7807342499999999,0.0,67842,15057,73647,completed
512,63601,281,1,0-2,1,0.03113636111111112,0.024353333333333334,67921,4320,68202,completed
450,53223,4231,1,6-12,1,0.5056705277777778,0.0,67929,14706,72160,completed
513,63622,113,1,0-2,1,0.012521027777777782,0.009793333333333333,67942,4320,68055,completed
451,53310,4024,1,6-12,1,0.5200637777777777,0.0,68624,15314,72648,completed
455,55418,11702,1,24-48,1,1.2766941666666667,0.0,68625,13207,80327,completed
514,64516,177,1,0-2,1,0.02082454166666666,0.01534,68836,4320,69013,completed
515,65228,557,3,0-2,3-4,0.1775975,0.14482,69548,4320,70105,completed
456,55423,11521,1,24-48,1,1.391286277777778,0.0,69855,14432,81376,completed
517,65675,126,1,0-2,1,0.013531000000000001,0.010920000000000001,69995,4320,70121,completed
518,65700,114,1,0-2,1,0.012242333333333332,0.00988,70020,4320,70134,completed
521,65753,459,4,0-2,3-4,0.19716599999999995,0.15912,70073,4320,70532,completed
524,66003,955,1,0-2,1,0.10710372222222224,0.08276666666666667,70323,4320,71278,completed
525,66117,85,1,0-2,1,0.009128055555555558,0.007366666666666667,70437,4320,70522,completed
526,66143,412,1,0-2,1,0.04623922222222222,0.035706666666666664,70463,4320,70875,completed
527,66348,712,1,0-2,1,0.08394522222222223,0.06170666666666667,70668,4320,71380,completed
528,66571,118,1,0-2,1,0.013419222222222221,0.010226666666666667,70891,4320,71009,completed
459,55424,11787,1,24-48,1,1.7095310000000001,0.0,71231,15807,83018,completed
458,55424,11868,1,24-48,1,1.82905925,0.0,72161,16737,84029,completed
531,68136,77,1,0-2,1,0.014664222222222223,0.006673333333333333,72456,4320,72533,completed
532,68137,90,1,0-2,1,0.01714,0.0078000000000000005,72457,4320,72547,completed
533,68294,753,2,0-2,2,0.285084,0.13052,72614,4320,73367,completed
460,55424,11847,1,24-48,1,1.8430875555555557,0.0,72649,17225,84496,completed
534,68348,762,1,0-2,1,0.144172,0.06604,72668,4320,73430,completed
457,55424,11442,1,12-24,1,1.7541211666666667,0.99164,72704,17280,84146,completed
461,55453,5369,1,6-12,1,0.4946415555555555,0.46531333333333336,72733,17280,78102,completed
464,56297,1553,1,2-6,1,0.22074005555555556,0.0,72739,16442,74292,completed
536,68479,91,1,0-2,1,0.017209111111111113,0.007886666666666667,72799,4320,72890,completed
537,68645,362,1,0-2,1,0.06845822222222223,0.031373333333333336,72965,4320,73327,completed
543,69150,1394,1,0-2,1,0.12611938888888888,0.12081333333333334,73470,4320,74864,completed
545,69150,1256,1,0-2,1,0.11617380555555555,0.10885333333333333,73470,4320,74726,completed
542,69150,1292,1,0-2,1,0.11876830555555555,0.11197333333333334,73470,4320,74762,completed
548,69156,1050,1,0-2,1,0.10110441666666667,0.091,73476,4320,74526,completed
549,69156,969,1,0-2,1,0.09526679166666666,0.08398,73476,4320,74445,completed
468,56835,3157,1,6-12,1,0.24952870833333335,0.0,73648,16813,76805,completed
550,69536,176,2,0-2,2,0.038456,0.030506666666666668,73856,4320,74032,completed
469,56909,4358,1,6-12,1,0.3103275,0.3776933333333333,74189,17280,78547,completed
485,59825,3847,1,6-12,1,0.2751647638888889,0.0,74293,14468,78140,completed
470,57089,3437,3,6-12,3-4,0.7439324583333334,0.89362,74369,17280,77806,completed
554,70122,686,2,0-2,2,0.09996772222222222,0.11890666666666667,74442,4320,75128,completed
555,70789,333,2,0-2,2,0.04945975,0.05772,75109,4320,75442,completed
556,70912,435,1,0-2,1,0.03226570833333334,0.0377,75232,4320,75667,completed
557,71499,217,3,0-2,3-4,0.04796604166666667,0.05642,75819,4320,76036,completed
486,59996,3954,1,6-12,1,0.3833074166666667,0.0,76522,16526,80476,completed
559,72338,105,1,0-2,1,0.007616875000000002,0.0091,76658,4320,76763,completed
487,60129,7973,1,12-24,1,1.4825625000000002,0.0,76806,16677,84779,completed
484,59569,5556,3,6-12,3-4,2.6366847083333336,1.44456,76849,17280,82405,completed
560,72783,120,1,0-2,1,0.008235,0.0104,77103,4320,77223,completed
561,72897,671,1,0-2,1,0.04558337499999999,0.058153333333333335,77217,4320,77888,completed
562,72955,1274,1,0-2,1,0.08581683333333331,0.11041333333333334,77275,4320,78549,completed
563,73115,148,1,0-2,1,0.010156499999999999,0.012826666666666667,77435,4320,77583,completed
564,73391,579,1,0-2,1,0.03781262499999999,0.05018,77711,4320,78290,completed
565,73422,1438,1,0-2,1,0.10620330555555556,0.12462666666666666,77742,4320,79180,completed
566,73571,682,1,0-2,1,0.04601304166666666,0.05910666666666667,77891,4320,78573,completed
567,73593,472,1,0-2,1,0.03067999999999999,0.04090666666666667,77913,4320,78385,completed
489,60658,1746,1,2-6,1,0.15195016666666666,0.15132,77938,17280,79684,completed
569,73662,864,1,0-2,1,0.06278358333333334,0.07488,77982,4320,78846,completed
570,73759,791,1,0-2,1,0.058472916666666666,0.06855333333333334,78079,4320,78870,completed
571,73764,1282,1,0-2,1,0.10508191666666668,0.11110666666666667,78084,4320,79366,completed
572,73770,943,1,0-2,1,0.0713027638888889,0.08172666666666667,78090,4320,79033,completed
573,73794,1014,1,0-2,1,0.07763700000000001,0.08788,78114,4320,79128,completed
574,73816,1368,1,0-2,1,0.11792266666666666,0.11856,78136,4320,79504,completed
490,61016,1572,1,2-6,1,0.142163875,0.0,78141,17125,79713,completed
576,73878,649,1,0-2,1,0.04882668055555556,0.05624666666666667,78198,4320,78847,completed
577,73925,1200,1,0-2,1,0.10390270833333334,0.104,78245,4320,79445,completed
582,74054,1374,1,0-2,1,0.13113283333333334,0.11908,78374,4320,79748,completed
583,74174,62,1,0-2,1,0.005152027777777779,0.005373333333333333,78494,4320,78556,completed
584,74275,62,1,0-2,1,0.005152027777777779,0.005373333333333333,78595,4320,78657,completed
499,61384,1609,4,2-6,3-4,0.783489611111111,0.5577866666666667,78664,17280,80273,completed
585,74877,1153,1,0-2,1,0.16613137499999997,0.09992666666666666,79197,4320,80350,completed
586,74878,946,1,0-2,1,0.1271228611111111,0.08198666666666667,79198,4320,80144,completed
505,62004,2531,1,2-6,1,0.5285855972222222,0.21935333333333334,79284,17280,81815,completed
506,62191,13742,1,24-48,1,3.0066094583333336,1.1909733333333334,79471,17280,93213,completed
588,75379,198,1,0-2,1,0.023273249999999995,0.01716,79699,4320,79897,completed
587,75379,692,1,0-2,1,0.11497608333333331,0.05997333333333334,79699,4320,80391,completed
510,63097,16896,1,24-48,1,3.3455580277777783,0.0,79714,16617,96610,completed
589,75854,692,1,0-2,1,0.1465885833333333,0.05997333333333334,80174,4320,80866,completed
516,65662,4909,1,6-12,1,1.2372699583333333,0.0,80207,14545,85116,completed
519,65748,1777,1,2-6,1,0.4604411111111112,0.0,80328,14580,82105,completed
520,65752,2528,1,2-6,1,0.6886578472222223,0.0,80477,14725,83005,completed
594,76796,258,1,0-2,1,0.06723597222222222,0.02236,81116,4320,81374,completed
522,65754,2078,1,2-6,1,0.5876594583333334,0.0,81377,15623,83455,completed
596,77317,392,1,0-2,1,0.11311922222222226,0.033973333333333335,81637,4320,82029,completed
597,77736,118,1,0-2,1,0.034133444444444466,0.010226666666666667,82056,4320,82174,completed
598,77778,129,1,0-2,1,0.037338333333333334,0.01118,82098,4320,82227,completed
523,65776,3221,1,6-12,1,0.7905476944444445,0.0,82106,16330,85327,completed
599,78040,64,1,0-2,1,0.018524444444444444,0.005546666666666667,82360,4320,82424,completed
600,78044,62,1,0-2,1,0.017945555555555544,0.005373333333333333,82364,4320,82426,completed
603,78423,149,1,0-2,1,0.04127444444444443,0.012913333333333334,82743,4320,82892,completed
604,78425,136,1,0-2,1,0.037733194444444444,0.011786666666666668,82745,4320,82881,completed
605,78430,162,1,0-2,1,0.04463444444444444,0.01404,82750,4320,82912,completed
529,67484,2584,1,2-6,1,0.5801555555555555,0.0,83006,15522,85590,completed
530,67621,2588,1,2-6,1,0.5796253333333333,0.0,83019,15398,85607,completed
606,78800,511,1,0-2,1,0.13473530555555555,0.04428666666666667,83120,4320,83631,completed
607,78848,1058,1,0-2,1,0.2666085,0.09169333333333334,83168,4320,84226,completed
608,79013,1119,1,0-2,1,0.27163713888888885,0.09698,83333,4320,84452,completed
609,79046,83,1,0-2,1,0.022352361111111108,0.007193333333333334,83366,4320,83449,completed
610,79049,1342,1,0-2,1,0.31820988888888885,0.11630666666666667,83369,4320,84711,completed
611,79067,1104,1,0-2,1,0.26556738888888887,0.09568,83387,4320,84491,completed
612,79103,1369,1,0-2,1,0.3212646388888889,0.11864666666666666,83423,4320,84792,completed
613,79134,409,1,0-2,1,0.1012470277777778,0.03544666666666667,83454,4320,83863,completed
614,79134,320,1,0-2,1,0.0795878888888889,0.027733333333333332,83454,4320,83774,completed
538,68776,1500,1,2-6,1,0.3480065555555556,0.0,83456,14680,84956,completed
615,79145,1191,1,0-2,1,0.28040780555555556,0.10322,83465,4320,84656,completed
616,79182,1062,1,0-2,1,0.2504565,0.09204,83502,4320,84564,completed
618,79555,853,1,0-2,1,0.19484480555555556,0.07392666666666667,83875,4320,84728,completed
540,69143,12853,1,24-48,1,2.302607611111111,0.0,84030,14887,96883,completed
541,69150,1521,1,2-6,1,0.2816181111111111,0.0,84497,15347,86018,completed
619,80266,119,1,0-2,1,0.025852749999999987,0.010313333333333334,84586,4320,84705,completed
546,69150,1509,1,2-6,1,0.26440345833333334,0.0,84780,15630,86289,completed
544,69150,1519,1,2-6,1,0.2554849166666667,0.0,84957,15807,86476,completed
620,80684,567,1,0-2,1,0.09908325,0.04914,85004,4320,85571,completed
621,80690,892,1,0-2,1,0.1533455833333333,0.07730666666666666,85010,4320,85902,completed
547,69152,1773,1,2-6,1,0.2895146666666667,0.0,85117,15965,86890,completed
622,81007,483,1,0-2,1,0.08292188888888888,0.04186,85327,4320,85810,completed
551,70034,2646,1,2-6,1,0.4120399444444445,0.0,85328,15294,87974,completed
624,81107,370,1,0-2,1,0.063323375,0.03206666666666667,85427,4320,85797,completed
552,70055,2597,1,2-6,1,0.40156308333333335,0.0,85591,15536,88188,completed
553,70088,2538,1,2-6,1,0.39162849999999993,0.0,85608,15520,88146,completed
535,68351,3347,3,6-12,3-4,1.67797375,0.87022,85631,17280,88978,completed
626,81326,351,1,0-2,1,0.057722569444444455,0.03042,85646,4320,85997,completed
627,81444,71,3,0-2,3-4,0.034792958333333346,0.01846,85764,4320,85835,completed
628,81518,407,1,0-2,1,0.06648231944444444,0.03527333333333334,85838,4320,86245,completed
558,72030,1966,1,2-6,1,0.2969770972222222,0.0,86019,13989,87985,completed
630,81838,183,1,0-2,1,0.029892541666666675,0.01586,86158,4320,86341,completed
631,81861,478,1,0-2,1,0.07463383333333334,0.04142666666666667,86181,4320,86659,completed
539,68928,1528,2,2-6,2,0.45446511111111104,0.26485333333333333,86208,17280,87736,completed
568,73653,1847,1,2-6,1,0.27791244444444446,0.0,86290,12637,88137,completed
632,81988,229,1,0-2,1,0.03558365277777778,0.01984666666666667,86308,4320,86537,completed
633,82056,98,1,0-2,1,0.015023416666666664,0.008493333333333334,86376,4320,86474,completed
575,73838,2024,1,2-6,1,0.3087442638888889,0.0,86477,12639,88501,completed
635,82448,133,1,0-2,1,0.019955541666666667,0.011526666666666668,86768,4320,86901,completed
578,73925,1940,1,2-6,1,0.3232336250000001,0.0,86891,12966,88831,completed
637,82658,1329,4,0-2,3-4,0.8056284444444444,0.46072,86978,4320,88307,completed
640,82817,197,2,0-2,2,0.05618330555555555,0.034146666666666665,87137,4320,87334,completed
579,73971,1976,1,2-6,1,0.5357323194444444,0.0,87975,14004,89951,completed
580,73972,2848,1,2-6,1,0.8233995555555556,0.0,87986,14014,90834,completed
641,83717,60,1,0-2,1,0.009948333333333337,0.0052,88037,4320,88097,completed
581,73974,2462,1,2-6,1,0.7340299444444444,0.0,88138,14164,90600,completed
590,76739,3412,1,6-12,1,0.9369429444444444,0.0,88147,11408,91559,completed
591,76755,1813,1,2-6,1,0.520011361111111,0.0,88189,11434,90002,completed
642,83979,199,1,0-2,1,0.03299530555555555,0.017246666666666667,88299,4320,88498,completed
643,83998,80,2,0-2,2,0.02652888888888889,0.013866666666666666,88318,4320,88398,completed
592,76756,3651,1,6-12,1,0.9700034722222222,0.0,88502,11746,92153,completed
644,84474,461,3,0-2,3-4,0.3410247500000001,0.11986000000000001,88794,4320,89255,completed
645,84511,517,3,0-2,3-4,0.4115575833333334,0.13442,88831,4320,89348,completed
593,76767,6078,1,12-24,1,1.2404019722222221,0.0,88832,12065,94910,completed
646,84699,504,1,0-2,1,0.158949375,0.043680000000000004,89019,4320,89523,completed
647,84705,228,2,0-2,2,0.11244200000000006,0.03952,89025,4320,89253,completed
648,84709,261,1,0-2,1,0.06578505555555558,0.02262,89029,4320,89290,completed
649,84751,105,2,0-2,2,0.05178250000000002,0.0182,89071,4320,89176,completed
650,84908,76,2,0-2,2,0.044329333333333346,0.013173333333333334,89228,4320,89304,completed
651,85178,977,4,0-2,3-4,1.4347668888888885,0.33869333333333335,89498,4320,90475,completed
652,85293,270,1,0-2,1,0.10510124999999998,0.0234,89613,4320,89883,completed
653,85354,666,4,0-2,3-4,0.975100111111111,0.23088,89674,4320,90340,completed
654,85396,61,1,0-2,1,0.02374509722222223,0.005286666666666667,89716,4320,89777,completed
655,85418,63,1,0-2,1,0.02452362500000001,0.0054600000000000004,89738,4320,89801,completed
656,85495,493,1,0-2,1,0.1778888194444444,0.04272666666666667,89815,4320,90308,completed
658,85564,643,1,0-2,1,0.22631086111111107,0.05572666666666667,89884,4320,90527,completed
595,77026,3433,1,6-12,1,0.7001253611111111,0.0,89952,12926,93385,completed
602,78351,4930,1,6-12,1,0.8510441527777777,0.0,90003,11652,94933,completed
660,86045,904,1,0-2,1,0.23239550000000003,0.07834666666666666,90365,4320,91269,completed
662,86074,138,1,0-2,1,0.047437499999999994,0.01196,90394,4320,90532,completed
601,78351,3535,1,6-12,1,0.5614039166666667,0.0,90601,12250,94136,completed
663,86296,125,1,0-2,1,0.03997158333333333,0.010833333333333334,90616,4320,90741,completed
617,79247,1523,1,2-6,1,0.2632258055555555,0.0,90835,11588,92358,completed
664,86522,385,1,0-2,1,0.07739569444444445,0.03336666666666667,90842,4320,91227,completed
665,86604,172,1,0-2,1,0.03457677777777779,0.014906666666666667,90924,4320,91096,completed
666,86701,93,1,0-2,1,0.018695583333333342,0.00806,91021,4320,91114,completed
667,86819,325,2,0-2,2,0.12844672222222223,0.05633333333333333,91139,4320,91464,completed
668,86844,231,1,0-2,1,0.04643741666666668,0.02002,91164,4320,91395,completed
669,87124,450,1,0-2,1,0.06963749999999999,0.039,91444,4320,91894,completed
672,87228,403,1,0-2,1,0.06236424999999998,0.03492666666666667,91548,4320,91951,completed
625,81161,4649,1,6-12,1,0.571385888888889,0.0,91560,10399,96209,completed
674,87361,700,2,0-2,2,0.21563094444444442,0.12133333333333333,91681,4320,92381,completed
675,87453,214,1,0-2,1,0.033116499999999986,0.018546666666666666,91773,4320,91987,completed
678,87484,1142,1,0-2,1,0.17374083333333334,0.09897333333333333,91804,4320,92946,completed
679,87592,385,1,0-2,1,0.05926288888888888,0.03336666666666667,91912,4320,92297,completed
680,87691,146,1,0-2,1,0.022593499999999996,0.012653333333333334,92011,4320,92157,completed
629,81691,5309,1,6-12,1,0.6730738194444446,0.0,92154,10463,97463,completed
634,82122,10925,1,12-24,1,3.267074555555556,0.0,92359,10237,103284,completed
681,88122,359,1,0-2,1,0.05472755555555556,0.031113333333333333,92442,4320,92801,completed
682,88187,82,1,0-2,1,0.012500444444444444,0.0071066666666666665,92507,4320,92589,completed
683,88513,81,1,0-2,1,0.011744500000000001,0.00702,92833,4320,92914,completed
684,88524,621,1,0-2,1,0.08428425,0.05382,92844,4320,93465,completed
685,88528,107,1,0-2,1,0.014980305555555556,0.009273333333333333,92848,4320,92955,completed
686,88622,120,1,0-2,1,0.016163333333333335,0.0104,92942,4320,93062,completed
687,88704,343,1,0-2,1,0.04620019444444445,0.02972666666666667,93024,4320,93367,completed
688,88704,345,1,0-2,1,0.04646958333333334,0.0299,93024,4320,93369,completed
689,88794,245,1,0-2,1,0.03300013888888889,0.021233333333333333,93114,4320,93359,completed
691,89062,373,1,0-2,1,0.04601943055555556,0.03232666666666667,93382,4320,93755,completed
636,82581,4259,1,6-12,1,0.541249125,0.0,93386,10805,97645,completed
692,89169,167,3,0-2,3-4,0.06290625,0.04342,93489,4320,93656,completed
693,89170,169,3,0-2,3-4,0.06346929166666668,0.04394,93490,4320,93659,completed
694,89211,959,1,0-2,1,0.10449738888888889,0.08311333333333333,93531,4320,94490,completed
695,89564,240,2,0-2,2,0.05158,0.0416,93884,4320,94124,completed
696,89577,68,1,0-2,1,0.0073071666666666675,0.005893333333333334,93897,4320,93965,completed
697,89631,722,1,0-2,1,0.07668280555555557,0.06257333333333333,93951,4320,94673,completed
657,85563,9852,1,12-24,1,3.343713166666667,0.0,94137,8574,103989,completed
659,85675,1516,1,2-6,1,0.15294456944444446,0.0,94911,9236,96427,completed
661,86070,2649,1,2-6,1,0.3546266805555556,0.0,94934,8864,97583,completed
699,90614,442,1,0-2,1,0.046885027777777775,0.03830666666666667,94934,4320,95376,completed
700,90619,460,1,0-2,1,0.04880873611111111,0.03986666666666667,94939,4320,95399,completed
701,90662,67,1,0-2,1,0.007042361111111112,0.005806666666666667,94982,4320,95049,completed
703,90856,590,1,0-2,1,0.06272822222222223,0.051133333333333336,95176,4320,95766,completed
704,90966,542,1,0-2,1,0.05685422222222222,0.04697333333333333,95286,4320,95828,completed
705,91015,475,1,0-2,1,0.04994444444444445,0.041166666666666664,95335,4320,95810,completed
706,91063,1270,1,0-2,1,0.13195577777777778,0.11006666666666667,95383,4320,96653,completed
707,91145,833,1,0-2,1,0.0820328888888889,0.07219333333333333,95465,4320,96298,completed
708,91221,711,1,0-2,1,0.069614,0.06162,95541,4320,96252,completed
709,91223,668,1,0-2,1,0.06554255555555556,0.05789333333333333,95543,4320,96211,completed
710,91877,70,1,0-2,1,0.006587777777777776,0.006066666666666666,96197,4320,96267,completed
670,87136,2757,1,2-6,1,0.731221625,0.0,96210,9074,98967,completed
711,91995,87,1,0-2,1,0.008187666666666664,0.00754,96315,4320,96402,completed
671,87193,17516,1,24-48,1,5.594219555555556,0.0,96428,9235,113944,completed
712,92117,1258,1,0-2,1,0.2320886527777778,0.10902666666666667,96437,4320,97695,completed
713,92120,627,1,0-2,1,0.08542266666666667,0.05434,96440,4320,97067,completed
714,92125,1196,1,0-2,1,0.21738501388888892,0.10365333333333333,96445,4320,97641,completed
715,92125,884,1,0-2,1,0.13678068055555556,0.07661333333333334,96445,4320,97329,completed
716,92137,1332,1,0-2,1,0.2544910694444445,0.11544,96457,4320,97789,completed
717,92143,450,1,0-2,1,0.061835,0.039,96463,4320,96913,completed
673,87262,12102,1,24-48,1,4.922196861111111,0.0,96611,9349,108713,completed
718,92355,459,1,0-2,1,0.063852,0.03978,96675,4320,97134,completed
719,92426,63,1,0-2,1,0.008763999999999997,0.0054600000000000004,96746,4320,96809,completed
720,92515,1432,1,0-2,1,0.36642379166666667,0.12410666666666667,96835,4320,98267,completed
676,87483,2160,1,2-6,1,0.6850852777777778,0.0,96884,9401,99044,completed
723,92867,188,1,0-2,1,0.04701920833333334,0.016293333333333333,97187,4320,97375,completed
724,92881,481,1,0-2,1,0.12426501388888891,0.04168666666666667,97201,4320,97682,completed
727,93062,119,1,0-2,1,0.03074331944444445,0.010313333333333334,97382,4320,97501,completed
677,87484,2027,1,2-6,1,0.7795214027777776,0.0,97464,9980,99491,completed
728,93210,987,1,0-2,1,0.3237929583333333,0.08554,97530,4320,98517,completed
690,88984,17236,1,24-48,1,5.476928555555556,0.0,97584,8600,114820,completed
698,89770,1655,1,2-6,1,0.6443053472222222,0.0,97646,7876,99301,completed
730,93606,79,1,0-2,1,0.02951418055555556,0.006846666666666667,97926,4320,98005,completed
732,93778,879,1,0-2,1,0.3577484027777777,0.07618,98098,4320,98977,completed
734,93825,1369,1,0-2,1,0.5883682638888889,0.11864666666666666,98145,4320,99514,completed
623,81056,2643,4,2-6,3-4,4.785765888888889,0.91624,98336,17280,100979,completed
736,94023,88,1,0-2,1,0.032876555555555555,0.007626666666666667,98343,4320,98431,completed
737,94276,626,1,0-2,1,0.2845705277777777,0.054253333333333334,98596,4320,99222,completed
738,94296,93,1,0-2,1,0.04075520833333331,0.00806,98616,4320,98709,completed
702,90818,1543,1,2-6,1,0.711591736111111,0.0,98968,8150,100511,completed
742,94690,1322,1,0-2,1,0.6109884166666667,0.11457333333333333,99010,4320,100332,completed
721,92665,5915,1,12-24,1,2.737648680555556,0.0,99045,6380,104960,completed
743,94742,67,1,0-2,1,0.030867458333333334,0.005806666666666667,99062,4320,99129,completed
747,94835,1126,1,0-2,1,0.52103525,0.09758666666666667,99155,4320,100281,completed
748,94838,1175,1,0-2,1,0.5432575138888889,0.10183333333333333,99158,4320,100333,completed
749,94871,518,1,0-2,1,0.2404113055555555,0.044893333333333334,99191,4320,99709,completed
722,92822,1767,1,2-6,1,0.8226165000000001,0.0,99302,6480,101069,completed
725,92944,5964,1,12-24,1,2.7052158333333334,0.0,99492,6548,105456,completed
751,95429,223,1,0-2,1,0.10386534722222221,0.019326666666666666,99749,4320,99972,completed
752,95476,473,1,0-2,1,0.21806981944444445,0.04099333333333333,99796,4320,100269,completed
753,95513,936,3,0-2,3-4,1.2834055,0.24336,99833,4320,100769,completed
638,82710,2590,3,2-6,3-4,3.83158375,0.6734,99990,17280,102580,completed
755,95692,533,1,0-2,1,0.24274965277777782,0.046193333333333336,100012,4320,100545,completed
639,82755,2160,3,2-6,3-4,3.186915,0.5616,100035,17280,102195,completed
756,95736,242,1,0-2,1,0.11013519444444445,0.020973333333333333,100056,4320,100298,completed
757,95816,181,1,0-2,1,0.08216143055555558,0.015686666666666668,100136,4320,100317,completed
758,96075,608,1,0-2,1,0.2847497916666667,0.052693333333333335,100395,4320,101003,completed
759,96145,118,1,0-2,1,0.05356380555555557,0.010226666666666667,100465,4320,100583,completed
760,96189,64,1,0-2,1,0.029051555555555556,0.005546666666666667,100509,4320,100573,completed
729,93257,9715,1,12-24,1,3.812697041666667,0.0,100512,7255,110227,completed
761,96223,545,1,0-2,1,0.2598201527777778,0.047233333333333336,100543,4320,101088,completed
763,96346,73,1,0-2,1,0.03313693055555556,0.006326666666666667,100666,4320,100739,completed
764,96546,64,1,0-2,1,0.03181333333333333,0.005546666666666667,100866,4320,100930,completed
765,96596,1230,1,0-2,1,0.6309663055555556,0.1066,100916,4320,102146,completed
766,96612,1123,1,0-2,1,0.5749359027777777,0.09732666666666667,100932,4320,102055,completed
767,96624,696,1,0-2,1,0.34971833333333335,0.06032,100944,4320,101640,completed
768,96632,1284,1,0-2,1,0.6606200555555555,0.11128,100952,4320,102236,completed
770,96649,436,1,0-2,1,0.2167283333333334,0.03778666666666667,100969,4320,101405,completed
769,96649,443,1,0-2,1,0.22020791666666673,0.038393333333333335,100969,4320,101412,completed
731,93699,2446,1,2-6,1,1.214437611111111,0.0,101070,7371,103516,completed
771,96779,97,1,0-2,1,0.04821708333333335,0.008406666666666666,101099,4320,101196,completed
772,96901,164,1,0-2,1,0.08152166666666669,0.014213333333333333,101221,4320,101385,completed
774,97046,1052,1,0-2,1,0.5460224166666667,0.09117333333333333,101366,4320,102418,completed
775,97271,313,2,0-2,2,0.33072797222222217,0.054253333333333334,101591,4320,101904,completed
776,97317,1032,1,0-2,1,0.5332732499999999,0.08944,101637,4320,102669,completed
778,97345,499,1,0-2,1,0.26363140277777775,0.04324666666666667,101665,4320,102164,completed
777,97345,937,1,0-2,1,0.4849495972222222,0.08120666666666666,101665,4320,102602,completed
779,97345,740,1,0-2,1,0.38635930555555553,0.06413333333333333,101665,4320,102405,completed
780,97369,986,1,0-2,1,0.5088033888888889,0.08545333333333334,101689,4320,102675,completed
781,97407,963,1,0-2,1,0.496234125,0.08346,101727,4320,102690,completed
782,97443,476,1,0-2,1,0.25148005555555547,0.041253333333333336,101763,4320,102239,completed
783,97512,748,1,0-2,1,0.3857101666666667,0.06482666666666667,101832,4320,102580,completed
784,97626,444,1,0-2,1,0.23039466666666666,0.03848,101946,4320,102390,completed
785,97627,274,1,0-2,1,0.14475952777777779,0.023746666666666666,101947,4320,102221,completed
786,97812,817,1,0-2,1,0.4118834583333334,0.07080666666666667,102132,4320,102949,completed
787,97992,735,1,0-2,1,0.3634204166666667,0.0637,102312,4320,103047,completed
788,98475,304,1,0-2,1,0.14508315277777778,0.026346666666666668,102795,4320,103099,completed
789,98476,265,1,0-2,1,0.12749430555555558,0.022966666666666666,102796,4320,103061,completed
790,98581,114,1,0-2,1,0.05426023611111111,0.00988,102901,4320,103015,completed
791,98597,306,1,0-2,1,0.1397893472222222,0.026520000000000002,102917,4320,103223,completed
792,98762,1178,1,0-2,1,0.5179386666666668,0.10209333333333334,103082,4320,104260,completed
793,98763,73,1,0-2,1,0.032827694444444444,0.006326666666666667,103083,4320,103156,completed
733,93815,1628,1,2-6,1,0.6688885555555557,0.0,103285,9470,104913,completed
794,99005,64,1,0-2,1,0.028780444444444442,0.005546666666666667,103325,4320,103389,completed
795,99024,265,1,0-2,1,0.11916902777777777,0.022966666666666666,103344,4320,103609,completed
735,93850,1584,1,2-6,1,0.6313046666666668,0.0,103517,9667,105101,completed
797,99205,74,1,0-2,1,0.03327738888888889,0.006413333333333333,103525,4320,103599,completed
796,99205,105,1,0-2,1,0.047217916666666665,0.0091,103525,4320,103630,completed
799,99269,374,1,0-2,1,0.16242745833333339,0.032413333333333336,103589,4320,103963,completed
798,99269,143,1,0-2,1,0.06324825,0.012393333333333334,103589,4320,103732,completed
800,99535,275,4,0-2,3-4,0.4722819444444446,0.09533333333333334,103855,4320,104130,completed
801,99612,132,1,0-2,1,0.056673833333333354,0.01144,103932,4320,104064,completed
739,94301,2072,1,2-6,1,0.7826885277777779,0.0,103990,9689,106062,completed
803,99779,1078,1,0-2,1,0.40476393055555565,0.09342666666666667,104099,4320,105177,completed
807,99886,288,1,0-2,1,0.11666597222222225,0.02496,104206,4320,104494,completed
806,99886,288,1,0-2,1,0.11666597222222225,0.02496,104206,4320,104494,completed
808,100315,167,1,0-2,1,0.0592896388888889,0.014473333333333333,104635,4320,104802,completed
740,94320,1986,1,2-6,1,0.8100040555555555,0.0,104914,10594,106900,completed
741,94527,2914,1,6-12,1,1.1954121249999998,0.0,104961,10434,107875,completed
811,100695,77,1,0-2,1,0.02733713888888889,0.006673333333333333,105015,4320,105092,completed
744,94782,2393,1,2-6,1,1.0045790416666667,0.0,105102,10320,107495,completed
812,100875,84,1,0-2,1,0.029341666666666655,0.00728,105195,4320,105279,completed
813,100964,63,1,0-2,1,0.022006249999999988,0.0054600000000000004,105284,4320,105347,completed
745,94791,1603,1,2-6,1,0.6956456944444444,0.0,105457,10666,107060,completed
815,101325,74,1,0-2,1,0.025848611111111103,0.006413333333333333,105645,4320,105719,completed
817,101670,581,3,0-2,3-4,0.7824742499999998,0.15106,105990,4320,106571,completed
746,94826,1834,1,2-6,1,0.795628263888889,0.0,106063,11237,107897,completed
819,102027,150,3,0-2,3-4,0.20176249999999993,0.039,106347,4320,106497,completed
820,102501,72,1,0-2,1,0.034422,0.00624,106821,4320,106893,completed
821,102511,200,1,0-2,1,0.09561666666666666,0.017333333333333333,106831,4320,107031,completed
750,95088,2842,1,2-6,1,0.8843599166666667,0.0,106901,11813,109743,completed
754,95684,3830,1,6-12,1,0.9582844861111112,0.0,107061,11377,110891,completed
824,102800,250,1,0-2,1,0.10983458333333332,0.021666666666666667,107120,4320,107370,completed
825,102857,87,1,0-2,1,0.04159324999999998,0.00754,107177,4320,107264,completed
826,102886,518,1,0-2,1,0.19986166666666672,0.044893333333333334,107206,4320,107724,completed
828,102945,401,1,0-2,1,0.1501681666666667,0.03475333333333333,107265,4320,107666,completed
762,96333,1542,1,2-6,1,0.48196683333333334,0.0,107496,11163,109038,completed
833,103403,593,1,0-2,1,0.19965529166666668,0.05139333333333333,107723,4320,108316,completed
834,103502,682,1,0-2,1,0.22071158333333332,0.05910666666666667,107822,4320,108504,completed
773,96962,7784,1,12-24,1,1.0999051666666666,0.0,107876,10914,115660,completed
802,99736,3345,1,6-12,1,0.6580565416666667,0.0,107898,8162,111243,completed
835,103631,411,2,0-2,2,0.25863325,0.07124,107951,4320,108362,completed
836,103685,642,1,0-2,1,0.19714749999999998,0.05564,108005,4320,108647,completed
837,103788,230,2,0-2,2,0.14125833333333332,0.03986666666666667,108108,4320,108338,completed
838,103830,123,1,0-2,1,0.03777125,0.01066,108150,4320,108273,completed
839,103934,922,1,0-2,1,0.24943749999999998,0.07990666666666667,108254,4320,109176,completed
840,103982,312,3,0-2,3-4,0.28742999999999996,0.08112,108302,4320,108614,completed
841,104065,99,1,0-2,1,0.030401249999999994,0.00858,108385,4320,108484,completed
842,104071,1378,2,0-2,2,0.6408743888888888,0.23885333333333333,108391,4320,109769,completed
804,99871,2133,1,2-6,1,0.362698375,0.0,108714,8843,110847,completed
805,99879,11989,1,24-48,1,1.4054999722222221,0.0,109039,9160,121028,completed
847,104723,698,1,0-2,1,0.1397014166666667,0.060493333333333336,109043,4320,109741,completed
850,104872,77,1,0-2,1,0.017955972222222227,0.006673333333333333,109192,4320,109269,completed
851,105263,402,1,0-2,1,0.06293533333333334,0.03484,109583,4320,109985,completed
852,105263,402,1,0-2,1,0.06293533333333334,0.03484,109583,4320,109985,completed
814,101263,2033,1,2-6,1,0.23397648611111113,0.0,109744,8481,111777,completed
853,105454,65,1,0-2,1,0.010176111111111113,0.005633333333333333,109774,4320,109839,completed
854,105528,602,2,0-2,2,0.16542983333333333,0.10434666666666667,109848,4320,110450,completed
855,105541,797,2,0-2,2,0.20994472222222224,0.13814666666666667,109861,4320,110658,completed
856,105673,104,1,0-2,1,0.01628177777777778,0.009013333333333333,109993,4320,110097,completed
857,105850,85,1,0-2,1,0.009927291666666664,0.007366666666666667,110170,4320,110255,completed
816,101398,1705,1,2-6,1,0.17537004166666667,0.0,110228,8830,111933,completed
726,92990,3894,3,6-12,3-4,1.1251694166666666,1.01244,110270,17280,114164,completed
858,105999,398,1,0-2,1,0.04648308333333334,0.034493333333333334,110319,4320,110717,completed
859,106059,278,1,0-2,1,0.03246808333333333,0.024093333333333335,110379,4320,110657,completed
860,106185,90,1,0-2,1,0.01051125,0.0078000000000000005,110505,4320,110595,completed
861,106198,117,1,0-2,1,0.013664625,0.01014,110518,4320,110635,completed
863,106299,1215,1,0-2,1,0.12052637499999999,0.1053,110619,4320,111834,completed
864,106369,997,1,0-2,1,0.09863012500000001,0.08640666666666667,110689,4320,111686,completed
865,106375,541,1,0-2,1,0.05540173611111111,0.04688666666666667,110695,4320,111236,completed
866,106481,1161,1,0-2,1,0.11113695833333334,0.10062,110801,4320,111962,completed
867,106504,94,1,0-2,1,0.010147694444444438,0.008146666666666667,110824,4320,110918,completed
818,101850,2230,1,2-6,1,0.20622574999999999,0.0,110848,8998,113078,completed
823,102651,1877,1,2-6,1,0.1738532361111111,0.0,110892,8241,112769,completed
868,106720,77,1,0-2,1,0.007309652777777778,0.006673333333333333,111040,4320,111117,completed
869,106809,1064,1,0-2,1,0.09968833333333332,0.09221333333333334,111129,4320,112193,completed
827,102904,9634,1,12-24,1,1.0730280555555554,0.0,111244,8340,120878,completed
870,106964,102,1,0-2,1,0.00968291666666666,0.00884,111284,4320,111386,completed
871,107138,64,1,0-2,1,0.006075555555555555,0.005546666666666667,111458,4320,111522,completed
872,107321,479,1,0-2,1,0.04440729166666667,0.04151333333333333,111641,4320,112120,completed
829,103379,3038,1,6-12,1,0.2837625833333334,0.0,111778,8399,114816,completed
873,107500,119,1,0-2,1,0.011032291666666668,0.010313333333333334,111820,4320,111939,completed
830,103380,4649,1,6-12,1,0.5165789999999999,0.0,111934,8554,116583,completed
875,107627,201,1,0-2,1,0.018634375,0.01742,111947,4320,112148,completed
876,107651,708,1,0-2,1,0.06425136111111111,0.06136,111971,4320,112679,completed
877,107933,703,1,0-2,1,0.06271829166666668,0.06092666666666667,112253,4320,112956,completed
878,107947,450,1,0-2,1,0.04018588888888888,0.039,112267,4320,112717,completed
879,107963,784,1,0-2,1,0.06982908333333332,0.06794666666666667,112283,4320,113067,completed
880,108094,369,1,0-2,1,0.032784625000000005,0.03198,112414,4320,112783,completed
881,108133,1275,2,0-2,2,0.2280893055555556,0.221,112453,4320,113728,completed
882,108157,75,1,0-2,1,0.006663541666666667,0.0065,112477,4320,112552,completed
883,108172,290,1,0-2,1,0.025765694444444445,0.025133333333333334,112492,4320,112782,completed
884,108215,95,1,0-2,1,0.008440486111111116,0.008233333333333334,112535,4320,112630,completed
885,108216,204,1,0-2,1,0.018124833333333333,0.01768,112536,4320,112740,completed
886,108220,264,1,0-2,1,0.023455666666666666,0.02288,112540,4320,112804,completed
887,108250,1234,2,0-2,2,0.2217635,0.21389333333333332,112570,4320,113804,completed
888,108320,75,1,0-2,1,0.006663541666666667,0.0065,112640,4320,112715,completed
889,108373,1398,1,0-2,1,0.12835059722222222,0.12116,112693,4320,114091,completed
890,108435,742,1,0-2,1,0.06643241666666666,0.06430666666666666,112755,4320,113497,completed
831,103381,4862,1,6-12,1,0.6083307499999999,0.0,112770,9389,117632,completed
891,108648,456,1,0-2,1,0.040941000000000005,0.03952,112968,4320,113424,completed
892,108706,1418,1,0-2,1,0.13369186111111114,0.12289333333333334,113026,4320,114444,completed
832,103381,4792,1,6-12,1,0.6139351249999999,0.0,113079,9698,117871,completed
893,108817,136,1,0-2,1,0.012234333333333333,0.011786666666666668,113137,4320,113273,completed
894,108931,427,1,0-2,1,0.038412208333333336,0.03700666666666667,113251,4320,113678,completed
895,108946,299,1,0-2,1,0.026897541666666667,0.025913333333333333,113266,4320,113565,completed
896,108951,562,1,0-2,1,0.051212569444444446,0.04870666666666667,113271,4320,113833,completed
897,108952,962,1,0-2,1,0.09079933333333334,0.08337333333333334,113272,4320,114234,completed
898,108952,499,1,0-2,1,0.04498805555555556,0.04324666666666667,113272,4320,113771,completed
899,108952,814,1,0-2,1,0.07615555555555556,0.07054666666666667,113272,4320,114086,completed
900,109011,526,1,0-2,1,0.04818973611111112,0.045586666666666664,113331,4320,113857,completed
901,109016,586,1,0-2,1,0.054171333333333335,0.05078666666666667,113336,4320,113922,completed
902,109119,91,1,0-2,1,0.008186208333333332,0.007886666666666667,113439,4320,113530,completed
903,109316,1186,1,0-2,1,0.11652833333333334,0.10278666666666667,113636,4320,114822,completed
904,109316,79,1,0-2,1,0.007106708333333334,0.006846666666666667,113636,4320,113715,completed
906,109456,468,1,0-2,1,0.04630600000000001,0.04056,113776,4320,114244,completed
907,109519,74,1,0-2,1,0.007321888888888889,0.006413333333333333,113839,4320,113913,completed
844,104413,4683,1,6-12,1,0.6226514999999999,0.0,113945,9532,118628,completed
909,109651,78,1,0-2,1,0.007717666666666665,0.00676,113971,4320,114049,completed
911,109655,86,1,0-2,1,0.008509222222222225,0.0074533333333333335,113975,4320,114061,completed
910,109655,66,1,0-2,1,0.006530333333333333,0.00572,113975,4320,114041,completed
913,109785,927,1,0-2,1,0.09219683333333331,0.08034,114105,4320,115032,completed
914,109861,88,1,0-2,1,0.008707111111111112,0.007626666666666667,114181,4320,114269,completed
915,109862,278,1,0-2,1,0.027506555555555555,0.024093333333333335,114182,4320,114460,completed
916,109884,87,1,0-2,1,0.00860816666666667,0.00754,114204,4320,114291,completed
917,109965,505,1,0-2,1,0.050233888888888883,0.04376666666666667,114285,4320,114790,completed
919,110105,100,1,0-2,1,0.009933194444444446,0.008666666666666666,114425,4320,114525,completed
920,110182,83,1,0-2,1,0.008283861111111112,0.007193333333333334,114502,4320,114585,completed
921,110362,183,1,0-2,1,0.018264416666666665,0.01586,114682,4320,114865,completed
845,104607,1694,1,2-6,1,0.23489311111111108,0.0,114817,10210,116511,completed
846,104607,1538,1,2-6,1,0.20855677777777776,0.0,114821,10214,116359,completed
923,110601,105,1,0-2,1,0.01047958333333333,0.0091,114921,4320,115026,completed
924,110703,72,1,0-2,1,0.007186,0.00624,115023,4320,115095,completed
848,104727,3812,1,6-12,1,0.5274854305555555,0.0,115661,10934,119473,completed
925,111374,402,1,0-2,1,0.060109277777777775,0.03484,115694,4320,116096,completed
849,104793,9929,1,12-24,1,0.8188156527777779,0.0,116360,11567,126289,completed
862,106229,9481,1,12-24,1,0.7766509305555556,0.0,116512,10283,125993,completed
905,109421,28542,1,24-48,1,2.019692416666667,0.0,116584,7163,145126,completed
928,112349,550,1,0-2,1,0.09175833333333333,0.04766666666666667,116669,4320,117219,completed
929,112639,1270,3,0-2,3-4,0.5482606666666665,0.3302,116959,4320,118229,completed
930,112696,1214,3,0-2,3-4,0.5200569999999998,0.31564000000000003,117016,4320,118230,completed
931,112702,1114,3,0-2,3-4,0.4865196666666666,0.28964,117022,4320,118136,completed
933,112811,720,1,0-2,1,0.10620833333333331,0.062400000000000004,117131,4320,117851,completed
935,112900,116,1,0-2,1,0.019352666666666674,0.010053333333333334,117220,4320,117336,completed
936,113017,70,4,0-2,3-4,0.041386666666666655,0.024266666666666666,117337,4320,117407,completed
937,113040,148,2,0-2,2,0.04099599999999999,0.025653333333333334,117360,4320,117508,completed
938,113060,103,1,0-2,1,0.014265499999999995,0.008926666666666666,117380,4320,117483,completed
939,113238,83,1,0-2,1,0.011495499999999997,0.007193333333333334,117558,4320,117641,completed
940,113302,958,1,0-2,1,0.11757188888888885,0.08302666666666667,117622,4320,118580,completed
908,109597,3814,1,6-12,1,0.35331175000000004,0.0,117633,8036,121447,completed
941,113340,102,1,0-2,1,0.014126999999999995,0.00884,117660,4320,117762,completed
942,113354,165,1,0-2,1,0.022852499999999994,0.0143,117674,4320,117839,completed
943,113357,320,1,0-2,1,0.04431999999999999,0.027733333333333332,117677,4320,117997,completed
944,113364,850,1,0-2,1,0.10400411111111107,0.07366666666666667,117684,4320,118534,completed
809,100423,3848,3,6-12,3-4,1.04699625,1.00048,117703,17280,121551,completed
810,100455,1951,3,2-6,3-4,0.66135325,0.50726,117735,17280,119686,completed
946,113465,826,1,0-2,1,0.09835299999999997,0.07158666666666667,117785,4320,118611,completed
945,113465,754,1,0-2,1,0.09055699999999997,0.06534666666666666,117785,4320,118539,completed
947,113514,81,1,0-2,1,0.011218499999999998,0.00702,117834,4320,117915,completed
912,109740,1933,1,2-6,1,0.21387737499999998,0.0,117872,8132,119805,completed
948,113564,877,1,0-2,1,0.10088316666666663,0.07600666666666667,117884,4320,118761,completed
949,113700,451,1,0-2,1,0.050646611111111094,0.039086666666666665,118020,4320,118471,completed
950,113809,235,1,0-2,1,0.025445277777777768,0.02036666666666667,118129,4320,118364,completed
951,114110,479,1,0-2,1,0.05178179166666665,0.04151333333333333,118430,4320,118909,completed
922,110491,1462,1,2-6,1,0.15542845833333335,0.0,118629,8138,120091,completed
952,114424,1265,1,0-2,1,0.13443143055555556,0.10963333333333333,118744,4320,120009,completed
954,114786,108,1,0-2,1,0.011611500000000005,0.00936,119106,4320,119214,completed
955,114816,210,1,0-2,1,0.022577916666666673,0.0182,119136,4320,119346,completed
956,115124,605,1,0-2,1,0.0632972638888889,0.05243333333333333,119444,4320,120049,completed
926,111690,1963,1,2-6,1,0.1404603888888889,0.0,119474,7784,121437,completed
822,102513,7578,2,12-24,2,0.8543679166666667,1.31352,119793,17280,127371,completed
932,112707,2483,1,2-6,1,0.15068183333333332,0.0,119806,7099,122289,completed
934,112813,10423,1,12-24,1,0.5917397083333333,0.0,120092,7279,130515,completed
961,116179,107,1,0-2,1,0.005320277777777778,0.009273333333333333,120499,4320,120606,completed
962,116366,422,1,0-2,1,0.021282888888888893,0.03657333333333333,120686,4320,121108,completed
963,116384,504,1,0-2,1,0.025562888888888895,0.043680000000000004,120704,4320,121208,completed
964,116389,860,1,0-2,1,0.04399602777777778,0.07453333333333334,120709,4320,121569,completed
965,116391,166,1,0-2,1,0.008253888888888887,0.014386666666666667,120711,4320,120877,completed
966,116396,529,1,0-2,1,0.026880972222222223,0.04584666666666667,120716,4320,121245,completed
953,114680,4967,1,6-12,1,0.2643788611111111,0.0,120879,6199,125846,completed
957,115594,3865,1,6-12,1,0.2031338888888889,0.0,121029,5435,124894,completed
968,116852,77,1,0-2,1,0.00398475,0.006673333333333333,121172,4320,121249,completed
969,116940,82,1,0-2,1,0.004243499999999999,0.0071066666666666665,121260,4320,121342,completed
958,115594,3997,1,6-12,1,0.21207940277777776,0.0,121438,5844,125435,completed
959,115742,5054,1,6-12,1,0.2714074722222222,0.0,121448,5706,126502,completed
843,104279,4580,2,6-12,2,0.49156786111111106,0.7938666666666667,121559,17280,126139,completed
970,117908,197,4,0-2,3-4,0.042082499999999995,0.06829333333333333,122228,4320,122425,completed
967,116425,3654,1,6-12,1,0.19625461111111112,0.0,122290,5865,125944,completed
972,118415,524,3,0-2,3-4,0.08455183333333333,0.13624,122735,4320,123259,completed
975,118737,60,1,0-2,1,0.003290833333333334,0.0052,123057,4320,123117,completed
976,119044,492,1,0-2,1,0.02501816666666666,0.04264,123364,4320,123856,completed
977,119133,1301,1,0-2,1,0.06702056944444446,0.11275333333333333,123453,4320,124754,completed
980,119164,1395,1,0-2,1,0.07232104166666667,0.12090000000000001,123484,4320,124879,completed
981,119416,800,1,0-2,1,0.04073577777777779,0.06933333333333333,123736,4320,124536,completed
982,119581,439,1,0-2,1,0.022358513888888897,0.038046666666666666,123901,4320,124340,completed
983,119818,1083,1,0-2,1,0.057856875,0.09386,124138,4320,125221,completed
984,119826,435,1,0-2,1,0.022240541666666672,0.0377,124146,4320,124581,completed
986,119977,90,1,0-2,1,0.004583750000000002,0.0078000000000000005,124297,4320,124387,completed
987,120082,406,1,0-2,1,0.021690472222222222,0.035186666666666665,124402,4320,124808,completed
988,120092,80,1,0-2,1,0.004074444444444446,0.006933333333333333,124412,4320,124492,completed
989,120141,428,1,0-2,1,0.023141694444444444,0.03709333333333333,124461,4320,124889,completed
992,120215,1221,1,0-2,1,0.06814087499999999,0.10582,124535,4320,125756,completed
991,120215,1337,1,0-2,1,0.0747834861111111,0.11587333333333334,124535,4320,125872,completed
993,120305,98,1,0-2,1,0.005391361111111111,0.008493333333333334,124625,4320,124723,completed
994,120358,97,1,0-2,1,0.0053363472222222215,0.008406666666666666,124678,4320,124775,completed
995,120458,63,1,0-2,1,0.003465874999999999,0.0054600000000000004,124778,4320,124841,completed
874,107593,2632,2,2-6,2,0.29389102777777776,0.45621333333333336,124873,17280,127505,completed
971,118075,3567,1,6-12,1,0.20270034722222224,0.0,124895,6820,128462,completed
996,120649,227,1,0-2,1,0.012488152777777775,0.019673333333333334,124969,4320,125196,completed
997,120665,67,1,0-2,1,0.003685930555555555,0.005806666666666667,124985,4320,125052,completed
998,120678,132,1,0-2,1,0.007261833333333333,0.01144,124998,4320,125130,completed
999,120951,272,1,0-2,1,0.015555527777777774,0.023573333333333335,125271,4320,125543,completed
973,118433,4988,1,6-12,1,0.29767183333333336,0.0,125436,7003,130424,completed
974,118440,4831,1,6-12,1,0.290805125,0.0,125847,7407,130678,completed
985,119964,7669,1,12-24,1,0.500704263888889,0.0,125945,5981,133614,completed
990,120214,1767,1,2-6,1,0.09885066666666668,0.0,125994,5780,127761,completed
927,111967,3919,2,6-12,2,0.47539502777777787,0.0,126503,14536,130422,completed
918,109971,6135,3,12-24,3-4,1.2248622500000002,1.5951,127251,17280,133386,completed
960,116147,3921,2,6-12,2,0.5082800000000001,0.0,128463,12316,132384,completed
978,119139,19842,2,24-48,2,2.8472166666666663,0.0,130423,11284,150265,completed
979,119140,19848,2,24-48,2,2.8608906666666667,0.0,130516,11376,150364,completed
-1,0,0,0,0,0,0.0,40.720992,0,0,0,0
