ID,arrival_time,length,cpus,length_class,resource_class,carbon_cost,dollar_cost,start_time,waiting_time,exit_time,reason
0,0,1260,1,0-2,1,0.17048750000000001,0.0,0,0,1260,completed
1,13,200,1,0-2,1,0.02670555555555556,0.0,13,0,213,completed
2,92,314,3,0-2,3-4,0.12578316666666667,0.0,92,0,406,completed
3,167,4709,1,6-12,1,0.6804191388888889,0.0,167,0,4876,completed
4,397,133,1,0-2,1,0.017759194444444446,0.0,397,0,530,completed
5,523,125,2,0-2,2,0.03338194444444444,0.0,523,0,648,completed
6,523,125,2,0-2,2,0.03338194444444444,0.0,523,0,648,completed
7,587,10992,1,12-24,1,1.524372486111111,0.0,587,0,11579,completed
8,601,10569,1,12-24,1,1.4182971666666666,0.0,601,0,11170,completed
9,810,4732,3,6-12,3-4,1.9985689166666665,0.0,810,0,5542,completed
10,958,350,2,0-2,2,0.09637638888888891,0.0,958,0,1308,completed
11,1159,565,1,0-2,1,0.07906751388888889,0.0,1159,0,1724,completed
12,1284,5424,1,6-12,1,0.6975178333333333,0.0,1284,0,6708,completed
13,1389,2434,2,2-6,2,0.7177984166666665,0.0,1389,0,3823,completed
14,1515,408,1,0-2,1,0.05800966666666667,0.0,1515,0,1923,completed
15,1725,222,1,0-2,1,0.031564083333333326,0.0,1725,0,1947,completed
16,1725,222,1,0-2,1,0.031564083333333326,0.0,1725,0,1947,completed
17,1997,1667,1,2-6,1,0.24843543055555553,0.0,1997,0,3664,completed
18,2096,83,1,0-2,1,0.011820513888888889,0.0,2096,0,2179,completed
19,2253,494,1,0-2,1,0.07074491666666666,0.0,2253,0,2747,completed
20,2299,112,1,0-2,1,0.016039333333333333,0.0,2299,0,2411,completed
21,2555,3388,1,6-12,1,0.4558189166666667,0.0,2555,0,5943,completed
22,2660,97,1,0-2,1,0.013891208333333332,0.0,2748,88,2845,completed
24,3055,65,1,0-2,1,0.010146319444444444,0.0,3055,0,3120,completed
26,3178,74,1,0-2,1,0.011551194444444444,0.0,3178,0,3252,completed
27,3179,68,1,0-2,1,0.010614611111111111,0.0,3253,74,3321,completed
28,3284,2472,1,2-6,1,0.32867372222222224,0.0,3322,38,5794,completed
30,3349,704,1,0-2,1,0.10691831944444445,0.0,3665,316,4369,completed
25,3134,34571,2,48+,2,21.8419,0.0,3824,690,38395,completed
32,3505,2215,1,2-6,1,0.2402913888888889,0.19196666666666667,4225,720,6440,completed
33,4268,61,1,0-2,1,0.008752652777777781,0.0,4370,102,4431,completed
34,4465,709,1,0-2,1,0.09544295833333336,0.0,4465,0,5174,completed
35,4543,2548,1,2-6,1,0.2490442916666667,0.22082666666666667,4543,0,7091,completed
36,4712,5939,1,12-24,1,0.698753861111111,0.5147133333333334,4712,0,10651,completed
29,3291,95,2,0-2,2,0.018345555555555566,0.0,5175,1884,5270,completed
37,4901,471,2,0-2,2,0.09095533333333333,0.0,5271,370,5742,completed
41,5540,4093,1,6-12,1,0.4064175555555556,0.3547266666666667,5540,0,9633,completed
31,3487,285,3,0-2,3-4,0.07874983333333332,0.0,5543,2056,5828,completed
39,5372,118,2,0-2,2,0.019019249999999994,0.0,5743,371,5861,completed
23,2887,183,4,0-2,3-4,0.057024833333333316,0.06344,5767,2880,5950,completed
38,5372,118,2,0-2,2,0.01838505555555555,0.0,5829,457,5947,completed
40,5375,67,4,0-2,3-4,0.02087794444444444,0.0,5862,487,5929,completed
42,6242,427,1,0-2,1,0.03466361111111111,0.0,6242,0,6669,completed
43,6624,320,2,0-2,2,0.05459555555555557,0.0,6624,0,6944,completed
44,6646,707,1,0-2,1,0.06115040277777779,0.0,6646,0,7353,completed
45,6666,2386,1,2-6,1,0.22753772222222224,0.0,6666,0,9052,completed
46,6676,4359,1,6-12,1,0.5972655972222223,0.0,6676,0,11035,completed
47,6699,67,2,0-2,2,0.011430944444444447,0.0,6699,0,6766,completed
48,6819,3748,1,6-12,1,0.47969683333333335,0.0,6819,0,10567,completed
49,6921,77,1,0-2,1,0.006568527777777779,0.0,6921,0,6998,completed
50,7474,11448,4,12-24,3-4,12.576638666666668,0.0,7474,0,18922,completed
51,7487,296,1,0-2,1,0.026874333333333333,0.0,7487,0,7783,completed
52,7691,88,3,0-2,3-4,0.023969000000000004,0.02288,7691,0,7779,completed
53,7879,4327,1,6-12,1,0.8342393749999999,0.0,7879,0,12206,completed
54,7991,77,1,0-2,1,0.00705298611111111,0.006673333333333333,7991,0,8068,completed
59,8170,69,1,0-2,1,0.006320208333333332,0.00598,8170,0,8239,completed
60,8215,254,1,0-2,1,0.023265694444444443,0.022013333333333333,8215,0,8469,completed
55,8059,7351,1,12-24,1,2.0491131388888886,0.0,9053,994,16404,completed
69,9287,328,1,0-2,1,0.05363030555555555,0.028426666666666666,9287,0,9615,completed
72,9366,756,1,0-2,1,0.1337618333333333,0.06552,9366,0,10122,completed
74,9486,131,1,0-2,1,0.022939555555555553,0.011353333333333333,9486,0,9617,completed
76,9583,85,1,0-2,1,0.01488444444444444,0.007366666666666667,9583,0,9668,completed
77,9585,69,1,0-2,1,0.012082666666666662,0.00598,9585,0,9654,completed
78,9614,117,1,0-2,1,0.020488000000000003,0.01014,9614,0,9731,completed
80,9670,1169,3,0-2,3-4,0.6928282916666666,0.30394,9670,0,10839,completed
85,10387,1318,2,0-2,2,0.6423662499999999,0.22845333333333334,10387,0,11705,completed
56,8115,6930,1,12-24,1,2.173307638888889,0.0,10568,2453,17498,completed
57,8139,2558,1,2-6,1,0.8297550277777777,0.0,11036,2897,13594,completed
89,11103,302,1,0-2,1,0.07315530555555554,0.026173333333333333,11103,0,11405,completed
58,8157,6180,1,12-24,1,1.9818424166666668,0.0,11171,3014,17351,completed
61,8229,2321,1,2-6,1,0.791171875,0.0,11580,3351,13901,completed
62,8277,7144,1,12-24,1,2.4690700833333334,0.0,12207,3930,19351,completed
63,8304,7286,1,12-24,1,2.825287819444444,0.0,13595,5291,20881,completed
64,8680,4991,1,6-12,1,1.6744840416666669,0.0,13902,5222,18893,completed
91,11404,79,1,0-2,1,0.024638125,0.006846666666666667,14284,2880,14363,completed
92,11435,465,1,0-2,1,0.12524076388888888,0.0403,14315,2880,14780,completed
112,13597,1366,3,0-2,3-4,1.1114115416666663,0.35516000000000003,14317,720,15683,completed
117,14363,970,1,0-2,1,0.25820204166666666,0.08406666666666666,14363,0,15333,completed
118,14370,67,1,0-2,1,0.01896956944444444,0.005806666666666667,14370,0,14437,completed
110,12955,1388,3,0-2,3-4,1.1223661249999999,0.36088,14395,1440,15783,completed
119,14525,96,1,0-2,1,0.024942666666666665,0.008320000000000001,14525,0,14621,completed
114,13823,61,1,0-2,1,0.01584898611111111,0.005286666666666667,14543,720,14604,completed
99,12477,220,1,0-2,1,0.057160277777777775,0.019066666666666666,14637,2160,14857,completed
111,13242,189,1,0-2,1,0.04910587499999999,0.01638,14682,1440,14871,completed
93,11821,91,1,0-2,1,0.023643569444444443,0.007886666666666667,14701,2880,14792,completed
94,11855,68,1,0-2,1,0.01766772222222222,0.005893333333333334,14735,2880,14803,completed
95,11860,1379,3,0-2,3-4,1.2063911666666667,0.35854,14740,2880,16119,completed
90,11213,175,1,0-2,1,0.04546840277777778,0.015166666666666667,14813,3600,14988,completed
121,14823,81,3,0-2,3-4,0.06313612499999999,0.02106,14823,0,14904,completed
96,11952,277,1,0-2,1,0.0719699861111111,0.024006666666666666,14832,2880,15109,completed
97,11979,62,1,0-2,1,0.016108805555555553,0.005373333333333333,14859,2880,14921,completed
116,14272,471,2,0-2,2,0.2584413333333333,0.08164,14992,720,15463,completed
123,15017,98,1,0-2,1,0.025462305555555554,0.008493333333333334,15017,0,15115,completed
124,15068,1330,1,0-2,1,0.41886861111111107,0.11526666666666667,15068,0,16398,completed
126,15263,125,1,0-2,1,0.0349722222222222,0.010833333333333334,15263,0,15388,completed
127,15338,105,1,0-2,1,0.02937666666666666,0.0091,15338,0,15443,completed
132,15766,67,1,0-2,1,0.018745111111111108,0.005806666666666667,15766,0,15833,completed
137,16372,415,1,0-2,1,0.14857918055555558,0.03596666666666667,16372,0,16787,completed
65,8791,2081,1,2-6,1,0.7560913888888889,0.0,16405,7614,18486,completed
138,16667,292,1,0-2,1,0.10274750000000003,0.02530666666666667,16667,0,16959,completed
134,16100,884,1,0-2,1,0.31576861111111115,0.07661333333333334,16820,720,17704,completed
139,16918,91,1,0-2,1,0.03202062500000001,0.007886666666666667,16918,0,17009,completed
140,16919,621,1,0-2,1,0.22140326388888895,0.05382,16919,0,17540,completed
142,16963,60,1,0-2,1,0.02111250000000001,0.0052,16963,0,17023,completed
136,16330,104,1,0-2,1,0.03659500000000001,0.009013333333333333,17050,720,17154,completed
66,9037,6248,1,12-24,1,2.5556372222222223,0.0,17352,8315,23600,completed
67,9049,4386,1,6-12,1,2.0297341666666666,0.0,17499,8450,21885,completed
68,9224,9360,1,12-24,1,2.8307713333333333,0.0,18487,9263,27847,completed
70,9317,9595,1,12-24,1,2.789739027777778,0.0,18894,9577,28489,completed
71,9334,10055,1,12-24,1,2.9091282916666668,0.0,18923,9589,28978,completed
73,9461,6613,1,12-24,1,2.2989672916666666,0.0,18923,9462,25536,completed
75,9489,7096,1,12-24,1,2.3715049583333334,0.0,18923,9434,26019,completed
79,9665,4987,1,6-12,1,2.017820125,0.0,18923,9258,23910,completed
81,9793,5813,1,12-24,1,2.0459177222222227,0.0,19352,9559,25165,completed
82,9840,6355,1,12-24,1,1.5105033194444446,0.0,20882,11042,27237,completed
145,17338,1168,1,0-2,1,0.3726523055555555,0.10122666666666667,21658,4320,22826,completed
144,17338,1163,1,0-2,1,0.37131591666666663,0.10079333333333333,21658,4320,22821,completed
143,17338,1175,1,0-2,1,0.37452325,0.10183333333333333,21658,4320,22833,completed
83,10187,8318,1,12-24,1,1.91694225,0.0,21886,11699,30204,completed
189,20538,884,1,0-2,1,0.26751430555555555,0.07661333333333334,21978,1440,22862,completed
147,17682,861,3,0-2,3-4,0.77752375,0.22386,22002,4320,22863,completed
148,17703,378,1,0-2,1,0.128161125,0.03276,22023,4320,22401,completed
149,17795,1518,1,2-6,1,0.3973735138888889,0.13156,22115,4320,23633,completed
183,19962,388,1,0-2,1,0.12179052777777778,0.033626666666666666,22122,2160,22510,completed
184,19996,103,1,0-2,1,0.03693837500000001,0.008926666666666666,22156,2160,22259,completed
150,17871,2813,1,2-6,1,0.6238424027777778,0.24379333333333333,22191,4320,25004,completed
194,21484,69,1,0-2,1,0.024745125000000007,0.00598,22204,720,22273,completed
151,17888,69,1,0-2,1,0.024745125000000007,0.00598,22208,4320,22277,completed
152,17930,62,1,0-2,1,0.022234750000000008,0.005373333333333333,22250,4320,22312,completed
170,18652,9340,3,12-24,3-4,6.9201955,2.4284,22252,3600,31592,completed
195,21563,745,1,0-2,1,0.20250179166666665,0.06456666666666666,22283,720,23028,completed
186,20149,440,1,0-2,1,0.11860704166666666,0.03813333333333333,22309,2160,22749,completed
196,21591,610,1,0-2,1,0.16386156944444444,0.052866666666666666,22311,720,22921,completed
125,15128,3727,2,6-12,2,1.4745735555555557,0.6460133333333333,22328,7200,26055,completed
187,20173,261,1,0-2,1,0.0697595,0.02262,22333,2160,22594,completed
133,15873,22293,1,24-48,1,7.383436166666667,1.93206,22353,6480,44646,completed
197,21637,784,1,0-2,1,0.20493344444444445,0.06794666666666667,22357,720,23141,completed
198,21673,782,1,0-2,1,0.2028462222222222,0.06777333333333334,22393,720,23175,completed
179,19580,255,4,0-2,3-4,0.27262333333333344,0.0884,22460,2880,22715,completed
120,14545,4946,1,6-12,1,0.9002458055555556,0.42865333333333333,22465,7920,27411,completed
155,18145,1322,1,0-2,1,0.3183754722222223,0.11457333333333333,22465,4320,23787,completed
158,18145,1042,1,0-2,1,0.2571771111111112,0.09030666666666667,22465,4320,23507,completed
157,18145,1479,1,2-6,1,0.3482098333333334,0.12818,22465,4320,23944,completed
156,18145,949,1,0-2,1,0.2365672777777778,0.08224666666666666,22465,4320,23414,completed
153,18145,1319,1,0-2,1,0.31780538888888893,0.11431333333333334,22465,4320,23784,completed
154,18145,1347,1,0-2,1,0.3231261666666667,0.11674,22465,4320,23812,completed
159,18145,358,1,0-2,1,0.09568544444444446,0.031026666666666668,22465,4320,22823,completed
161,18146,1643,1,2-6,1,0.37929713888888894,0.14239333333333334,22466,4320,24109,completed
160,18146,1686,1,2-6,1,0.3874683333333334,0.14612,22466,4320,24152,completed
162,18172,1862,1,2-6,1,0.4189047222222223,0.16137333333333334,22492,4320,24354,completed
163,18178,1994,1,2-6,1,0.44327722222222227,0.17281333333333335,22498,4320,24492,completed
199,21778,1145,1,0-2,1,0.27849605555555557,0.09923333333333334,22498,720,23643,completed
164,18222,581,1,0-2,1,0.15149805555555557,0.05035333333333333,22542,4320,23123,completed
165,18273,1440,1,2-6,1,0.33091075000000003,0.12480000000000001,22593,4320,24033,completed
180,19717,80,1,0-2,1,0.021382222222222223,0.006933333333333333,22597,2880,22677,completed
181,19736,176,1,0-2,1,0.04704088888888889,0.015253333333333334,22616,2880,22792,completed
100,12539,3768,1,6-12,1,0.7077965,0.32656,22619,10080,26387,completed
101,12539,3275,1,6-12,1,0.6359374722222222,0.2838333333333333,22619,10080,25894,completed
103,12549,1730,1,2-6,1,0.3832378055555556,0.14993333333333334,22629,10080,24359,completed
102,12549,1730,1,2-6,1,0.3832378055555556,0.14993333333333334,22629,10080,24359,completed
166,18309,1759,1,2-6,1,0.38874861111111114,0.15244666666666667,22629,4320,24388,completed
146,17611,2681,1,2-6,1,0.5422962222222223,0.23235333333333333,22651,5040,25332,completed
200,21946,611,1,0-2,1,0.15248372222222223,0.05295333333333333,22666,720,23277,completed
167,18357,1426,1,0-2,1,0.3217613611111112,0.12358666666666666,22677,4320,24103,completed
188,20527,93,1,0-2,1,0.024856833333333342,0.00806,22687,2160,22780,completed
141,16929,6422,2,12-24,2,2.4444833333333333,1.1131466666666667,22689,5760,29111,completed
190,20543,1531,1,2-6,1,0.3397057777777778,0.13268666666666667,22703,2160,24234,completed
135,16234,2495,1,2-6,1,0.5068351805555555,0.21623333333333333,22714,6480,25209,completed
88,10477,12607,1,24-48,1,3.935582611111111,1.0926066666666667,22717,12240,35324,completed
191,20566,1466,1,2-6,1,0.3255772222222223,0.12705333333333332,22726,2160,24192,completed
104,12664,5781,1,12-24,1,1.033587,0.50102,22744,10080,28525,completed
122,14830,1875,1,2-6,1,0.3984519444444445,0.1625,22750,7920,24625,completed
176,19151,156,4,0-2,3-4,0.16678133333333336,0.05408,22751,3600,22907,completed
177,19153,64,1,0-2,1,0.01710577777777778,0.005546666666666667,22753,3600,22817,completed
128,15562,1740,1,2-6,1,0.37440977777777784,0.1508,22762,7200,24502,completed
129,15565,1927,1,2-6,1,0.40579183333333335,0.16700666666666666,22765,7200,24692,completed
182,19900,375,1,0-2,1,0.09497749999999999,0.0325,22780,2880,23155,completed
168,18471,374,2,0-2,2,0.18850711111111113,0.06482666666666667,22791,4320,23165,completed
169,18508,193,4,0-2,3-4,0.20633844444444444,0.06690666666666667,22828,4320,23021,completed
201,22124,84,1,0-2,1,0.02245133333333334,0.00728,22844,720,22928,completed
98,12054,2661,1,2-6,1,0.5157455416666668,0.23062,22854,10800,25515,completed
115,14245,4271,2,6-12,2,1.4988577777777778,0.7403066666666667,22885,8640,27156,completed
178,19312,230,2,0-2,2,0.11363177777777778,0.03986666666666667,22912,3600,23142,completed
185,20036,11017,1,12-24,1,3.146419527777778,0.9548066666666667,22916,2880,33933,completed
130,15724,3285,1,6-12,1,0.6003876666666668,0.2847,22924,7200,26209,completed
131,15730,3684,1,6-12,1,0.657689,0.31928,22930,7200,26614,completed
106,12851,4743,1,6-12,1,0.8197395555555556,0.41106,22931,10080,27674,completed
105,12851,4752,1,6-12,1,0.8212468055555555,0.41184,22931,10080,27683,completed
107,12852,4772,1,6-12,1,0.8244964444444445,0.41357333333333335,22932,10080,27704,completed
108,12857,4809,1,6-12,1,0.830193888888889,0.41678,22937,10080,27746,completed
109,12877,3134,1,6-12,1,0.5744050555555555,0.2716133333333333,22957,10080,26091,completed
192,20837,10936,1,12-24,1,3.1247700277777777,0.9477866666666667,22997,2160,33933,completed
113,13795,1553,1,2-6,1,0.3095153888888889,0.13459333333333334,23155,9360,24708,completed
193,21039,31269,2,24-48,2,18.848787666666666,5.41996,23199,2160,54468,completed
171,18888,157,4,0-2,3-4,0.13917177777777778,0.054426666666666665,23208,4320,23365,completed
211,23227,2388,1,2-6,1,0.439730875,0.20696,23227,0,25615,completed
172,18909,195,1,0-2,1,0.04321416666666668,0.016900000000000002,23229,4320,23424,completed
84,10348,2954,1,6-12,1,0.5177002222222222,0.2560133333333333,23308,12960,26262,completed
173,19019,327,1,0-2,1,0.07246683333333334,0.02834,23339,4320,23666,completed
86,10396,9304,1,12-24,1,2.431837555555555,0.8063466666666667,23356,12960,32660,completed
174,19063,71,1,0-2,1,0.015734388888888895,0.006153333333333334,23383,4320,23454,completed
87,10457,7078,1,12-24,1,1.5982353194444447,0.6134266666666667,23417,12960,30495,completed
175,19128,880,4,0-2,3-4,0.7083137777777777,0.30506666666666665,23448,4320,24328,completed
202,22438,277,1,0-2,1,0.05765944444444446,0.0,23601,1163,23878,completed
207,22888,1607,1,2-6,1,0.2947359305555556,0.13927333333333333,23608,720,25215,completed
215,23773,3220,4,6-12,3-4,2.087938277777778,1.1162666666666667,23773,0,26993,completed
203,22509,78,1,0-2,1,0.014822166666666671,0.0,23879,1370,23957,completed
204,22509,122,1,0-2,1,0.023183388888888885,0.0,23911,1402,24033,completed
205,22647,224,1,0-2,1,0.042566222222222214,0.0,23958,1311,24182,completed
206,22818,61,1,0-2,1,0.01159169444444445,0.0,24034,1216,24095,completed
208,22931,197,1,0-2,1,0.037435472222222224,0.0,24096,1165,24293,completed
209,22988,199,1,0-2,1,0.037815527777777774,0.0,24183,1195,24382,completed
210,23087,542,1,0-2,1,0.09564761111111109,0.0,24294,1207,24836,completed
212,23478,251,1,0-2,1,0.044518583333333334,0.0,24383,905,24634,completed
213,23710,897,1,0-2,1,0.14597044444444446,0.0,24635,925,25532,completed
214,23725,67,1,0-2,1,0.011349055555555555,0.0,24837,1112,24904,completed
216,23810,879,1,0-2,1,0.13838894444444447,0.0,24905,1095,25784,completed
219,24289,203,1,0-2,1,0.03417011111111111,0.017593333333333332,25009,720,25212,completed
220,24359,96,1,0-2,1,0.016261333333333333,0.008320000000000001,25079,720,25175,completed
221,24363,87,1,0-2,1,0.014736833333333333,0.00754,25083,720,25170,completed
217,23906,337,1,0-2,1,0.0516342638888889,0.0,25166,1260,25503,completed
222,24481,378,1,0-2,1,0.05723025000000001,0.03276,25201,720,25579,completed
218,24058,65,1,0-2,1,0.009841180555555556,0.005633333333333333,25498,1440,25563,completed
223,24590,1898,1,2-6,1,0.28068738888888883,0.0,25504,914,27402,completed
224,24763,42957,1,48+,1,11.411051624999999,0.0,25533,770,68490,completed
225,24890,103,1,0-2,1,0.015594486111111116,0.0,25537,647,25640,completed
226,25081,67,1,0-2,1,0.010143986111111112,0.0,25641,560,25708,completed
227,25100,12719,1,24-48,1,5.076683986111111,0.0,25709,609,38428,completed
228,25104,11168,1,12-24,1,4.2347290555555555,0.0,25785,681,36953,completed
229,25139,3460,1,6-12,1,0.7226322222222221,0.0,26020,881,29480,completed
230,25585,1313,1,0-2,1,0.1978817222222222,0.11379333333333333,26305,720,27618,completed
232,25598,189,2,0-2,2,0.054977999999999985,0.03276,26318,720,26507,completed
231,25598,189,2,0-2,2,0.054977999999999985,0.03276,26318,720,26507,completed
236,26334,88,1,0-2,1,0.012799111111111108,0.007626666666666667,26334,0,26422,completed
234,25678,125,1,0-2,1,0.018180555555555554,0.010833333333333334,26398,720,26523,completed
235,25725,83,2,0-2,2,0.024143777777777774,0.014386666666666667,26445,720,26528,completed
237,26539,534,1,0-2,1,0.07840704166666665,0.04628,26539,0,27073,completed
239,26559,592,1,0-2,1,0.08697606944444444,0.05130666666666667,26559,0,27151,completed
240,26611,73,1,0-2,1,0.01069261111111111,0.006326666666666667,26611,0,26684,completed
241,26639,197,1,0-2,1,0.028987388888888882,0.017073333333333333,26639,0,26836,completed
242,26777,143,1,0-2,1,0.021042847222222216,0.012393333333333334,26777,0,26920,completed
243,26797,231,1,0-2,1,0.03399229166666666,0.02002,26797,0,27028,completed
244,26884,67,1,0-2,1,0.009859236111111109,0.005806666666666667,26884,0,26951,completed
245,26885,65,1,0-2,1,0.009564930555555554,0.005633333333333333,26885,0,26950,completed
246,26889,283,1,0-2,1,0.04164423611111111,0.024526666666666665,26889,0,27172,completed
247,26892,107,1,0-2,1,0.01574534722222222,0.009273333333333333,26892,0,26999,completed
248,26993,784,1,0-2,1,0.12384098611111112,0.06794666666666667,26993,0,27777,completed
249,27169,459,1,0-2,1,0.0729887361111111,0.03978,27169,0,27628,completed
233,25676,3049,1,6-12,1,0.8820369027777777,0.0,27238,1562,30287,completed
250,27246,67,1,0-2,1,0.009859236111111109,0.005806666666666667,27246,0,27313,completed
251,27251,114,1,0-2,1,0.016877013888888886,0.00988,27251,0,27365,completed
252,27321,949,1,0-2,1,0.16725340277777778,0.08224666666666666,27321,0,28270,completed
238,26542,5113,1,6-12,1,1.6948213611111111,0.0,27403,861,32516,completed
253,27340,2085,1,2-6,1,0.6343816944444444,0.0,27848,508,29933,completed
255,27921,1215,1,0-2,1,0.30567608333333335,0.1053,27921,0,29136,completed
256,28282,798,1,0-2,1,0.21487355555555557,0.06916,28282,0,29080,completed
257,28287,753,1,0-2,1,0.19904300000000003,0.06526,28287,0,29040,completed
258,28360,133,1,0-2,1,0.02865411111111112,0.011526666666666668,28360,0,28493,completed
259,28672,1075,1,0-2,1,0.3892398611111111,0.0,28672,0,29747,completed
260,28863,317,1,0-2,1,0.11692016666666669,0.0,28979,116,29296,completed
261,28962,4050,1,6-12,1,1.6181723472222225,0.0,29297,335,33347,completed
263,29169,160,1,0-2,1,0.06561119444444444,0.0,29481,312,29641,completed
265,29298,70,1,0-2,1,0.029635277777777767,0.0,29642,344,29712,completed
266,29466,77,1,0-2,1,0.03259880555555555,0.0,29713,247,29790,completed
267,29723,23537,1,24-48,1,7.8286634583333345,0.0,29748,25,53285,completed
268,29728,247,1,0-2,1,0.10457019444444443,0.0,29791,63,30038,completed
270,29934,288,1,0-2,1,0.12192799999999997,0.0,29934,0,30222,completed
271,29949,186,1,0-2,1,0.07874516666666664,0.0,30039,90,30225,completed
272,30024,284,1,0-2,1,0.11020193055555558,0.0,30205,181,30489,completed
273,30093,457,1,0-2,1,0.17574769444444446,0.0,30223,130,30680,completed
274,30204,1703,1,2-6,1,0.6365475972222223,0.0,30226,22,31929,completed
275,30345,124,1,0-2,1,0.047500611111111125,0.0,30345,0,30469,completed
276,30346,324,1,0-2,1,0.12411450000000002,0.0,30470,124,30794,completed
277,30347,142,1,0-2,1,0.05439586111111111,0.0,30490,143,30632,completed
278,30349,123,1,0-2,1,0.04711754166666668,0.0,30633,284,30756,completed
279,30353,370,1,0-2,1,0.13999279166666667,0.0,30681,328,31051,completed
264,29282,1011,3,0-2,3-4,1.1188233749999998,0.26286,30722,1440,31733,completed
280,30629,586,1,0-2,1,0.2171431805555555,0.0,30757,128,31343,completed
254,27826,1840,2,2-6,2,1.4161633333333334,0.0,31052,3226,32892,completed
262,29069,1100,4,0-2,3-4,1.623912277777778,0.38133333333333336,31229,2160,32329,completed
282,31235,110,1,0-2,1,0.04003083333333332,0.009533333333333333,31235,0,31345,completed
283,31921,268,1,0-2,1,0.09987094444444447,0.0,31921,0,32189,completed
269,29797,1819,2,2-6,2,1.6785672222222223,0.0,32190,2393,34009,completed
284,32262,1421,1,0-2,1,0.6478559305555556,0.12315333333333334,32262,0,33683,completed
285,32302,67,1,0-2,1,0.02496773611111111,0.005806666666666667,32302,0,32369,completed
287,32401,403,1,0-2,1,0.17302133333333333,0.03492666666666667,32401,0,32804,completed
288,32442,68,1,0-2,1,0.029194666666666664,0.005893333333333334,32442,0,32510,completed
286,32304,2799,1,2-6,1,1.404465,0.0,32517,213,35316,completed
289,32572,127,2,0-2,2,0.10905066666666664,0.022013333333333333,32572,0,32699,completed
291,32694,108,1,0-2,1,0.04636799999999999,0.00936,32694,0,32802,completed
292,33074,95,2,0-2,2,0.08950997222222216,0.0,33074,0,33169,completed
293,33083,95,2,0-2,2,0.0969606944444444,0.0,33170,87,33265,completed
294,33652,190,1,0-2,1,0.09693977777777776,0.0,33652,0,33842,completed
295,33694,82,1,0-2,1,0.041846194444444436,0.0,33694,0,33776,completed
296,33771,77,1,0-2,1,0.03921093055555555,0.0,33771,0,33848,completed
298,33978,91,3,0-2,3-4,0.1364620833333333,0.0,33978,0,34069,completed
281,30697,3049,4,6-12,3-4,6.62436061111111,0.0,34070,3373,37119,completed
299,34091,2289,1,2-6,1,1.2288843055555556,0.0,34091,0,36380,completed
300,34153,65,1,0-2,1,0.03505847222222221,0.0,35317,1164,35382,completed
302,34382,133,1,0-2,1,0.07173502777777775,0.0,35383,1001,35516,completed
304,34486,1338,1,0-2,1,0.7314932916666667,0.0,35517,1031,36855,completed
305,34840,62,1,0-2,1,0.033819277777777795,0.0,36381,1541,36443,completed
306,35170,62,1,0-2,1,0.033819277777777795,0.0,36444,1274,36506,completed
307,35197,67,1,0-2,1,0.0365466388888889,0.0,36507,1310,36574,completed
308,35461,1514,1,2-6,1,0.8707032361111109,0.0,36575,1114,38089,completed
310,35609,1047,1,0-2,1,0.605510236111111,0.0,36856,1247,37903,completed
309,35609,1228,1,0-2,1,0.7078527499999998,0.0,36954,1345,38182,completed
290,32670,2561,4,2-6,3-4,4.971115888888889,0.0,37120,4450,39681,completed
312,35610,1122,1,0-2,1,0.5565610000000001,0.0,37904,2294,39026,completed
311,35610,1576,1,2-6,1,0.6769523055555556,0.0,38090,2480,39666,completed
297,33838,68,4,0-2,3-4,0.13555811111111116,0.023573333333333335,38158,4320,38226,completed
313,35610,1108,1,0-2,1,0.49150283333333344,0.0,38183,2573,39291,completed
301,34156,83,2,0-2,2,0.08233600000000002,0.0,38396,4240,38479,completed
314,35613,2060,1,2-6,1,0.7861438333333335,0.0,38429,2816,40489,completed
303,34398,23251,2,24-48,2,10.019747500000001,0.0,38480,4082,61731,completed
326,36684,94,1,0-2,1,0.03842988888888889,0.008146666666666667,38844,2160,38938,completed
335,38128,1022,1,0-2,1,0.3696945000000001,0.08857333333333334,38848,720,39870,completed
332,37535,242,1,0-2,1,0.08584277777777781,0.020973333333333333,38975,1440,39217,completed
315,35760,69,1,0-2,1,0.024475833333333336,0.0,39027,3267,39096,completed
333,37640,120,1,0-2,1,0.04256666666666668,0.0104,39080,1440,39200,completed
316,35765,721,1,0-2,1,0.2578923333333334,0.0,39097,3332,39818,completed
317,36083,192,1,0-2,1,0.06810666666666669,0.0,39292,3209,39484,completed
318,36201,63,1,0-2,1,0.0223475,0.0,39485,3284,39548,completed
319,36204,3223,1,6-12,1,0.7841087777777778,0.0,39549,3345,42772,completed
320,36269,2678,1,2-6,1,0.664682263888889,0.0,39667,3398,42345,completed
321,36280,801,1,0-2,1,0.27557355555555557,0.0,39682,3402,40483,completed
322,36435,5286,1,6-12,1,1.193181611111111,0.0,39682,3247,44968,completed
324,36530,282,1,0-2,1,0.10279683333333334,0.0,39682,3152,39964,completed
328,37065,11598,1,24-48,1,2.680980944444445,0.0,39682,2617,51280,completed
329,37107,3611,1,6-12,1,0.8106705000000001,0.0,39819,2712,43430,completed
331,37335,9897,1,12-24,1,2.230499527777778,0.0,39965,2630,49862,completed
330,37189,5415,3,6-12,3-4,3.5170057500000005,1.4079,40069,2880,45484,completed
334,38060,8256,2,12-24,2,3.6429460000000007,1.43104,40220,2160,48476,completed
327,36816,4714,3,6-12,3-4,2.9189576666666666,1.22564,40416,3600,45130,completed
342,38982,1575,1,2-6,1,0.3395837916666667,0.1365,40422,1440,41997,completed
336,38669,1576,1,2-6,1,0.3341155,0.0,40484,1815,42060,completed
337,38721,1060,1,0-2,1,0.24113708333333334,0.0,40490,1769,41550,completed
344,39119,3503,1,6-12,1,0.6941120000000001,0.3035933333333333,40559,1440,44062,completed
345,39130,4834,1,6-12,1,0.9961715555555556,0.4189466666666667,40570,1440,45404,completed
346,39130,4834,1,6-12,1,0.9961715555555556,0.4189466666666667,40570,1440,45404,completed
349,39185,2539,2,2-6,2,0.9900306666666667,0.44009333333333334,40625,1440,43164,completed
323,36471,658,4,0-2,3-4,0.5708231666666668,0.22810666666666668,40791,4320,41449,completed
353,39363,759,1,0-2,1,0.16081675,0.06578,40803,1440,41562,completed
354,39371,409,1,0-2,1,0.09431033333333333,0.03544666666666667,40811,1440,41220,completed
355,39403,1236,1,0-2,1,0.24268343055555558,0.10712,40843,1440,42079,completed
325,36581,217,2,0-2,2,0.10271916666666667,0.03761333333333333,40901,4320,41118,completed
338,38746,2142,2,2-6,2,0.7991875555555555,0.37128,40906,2160,43048,completed
356,39481,462,1,0-2,1,0.09598020833333332,0.04004,40921,1440,41383,completed
357,39491,437,1,0-2,1,0.09051749999999999,0.037873333333333335,40931,1440,41368,completed
339,38843,136,1,0-2,1,0.028402708333333335,0.011786666666666668,41003,2160,41139,completed
340,38845,327,1,0-2,1,0.06421533333333333,0.02834,41005,2160,41332,completed
360,40319,141,1,0-2,1,0.026624666666666665,0.01222,41039,720,41180,completed
341,38894,870,1,0-2,1,0.16128086111111112,0.0754,41054,2160,41924,completed
343,39034,1058,1,0-2,1,0.19161391666666666,0.09169333333333334,41194,2160,42252,completed
347,39155,1284,1,0-2,1,0.2300746388888889,0.11128,41315,2160,42599,completed
358,39886,65,1,0-2,1,0.012238958333333333,0.005633333333333333,41326,1440,41391,completed
348,39174,93,1,0-2,1,0.017511125,0.00806,41334,2160,41427,completed
359,39922,780,2,0-2,2,0.2819354444444444,0.13520000000000001,41362,1440,42142,completed
350,39237,743,1,0-2,1,0.13403181944444448,0.06439333333333333,41397,2160,42140,completed
351,39247,773,1,0-2,1,0.13906279166666666,0.06699333333333334,41407,2160,42180,completed
362,40724,1134,1,0-2,1,0.20193180555555557,0.09828,41444,720,42578,completed
361,40724,1134,1,0-2,1,0.20193180555555557,0.09828,41444,720,42578,completed
352,39249,1697,1,2-6,1,0.30550295833333335,0.0,41551,2302,43248,completed
369,41607,1107,1,0-2,1,0.196194375,0.09594,41607,0,42714,completed
364,41001,205,1,0-2,1,0.0360360138888889,0.017766666666666667,41721,720,41926,completed
363,41001,173,1,0-2,1,0.03050490277777778,0.014993333333333334,41721,720,41894,completed
365,41312,160,1,0-2,1,0.027655555555555558,0.013866666666666666,42032,720,42192,completed
367,41325,150,1,0-2,1,0.025927083333333333,0.013,42045,720,42195,completed
366,41325,150,1,0-2,1,0.025927083333333333,0.013,42045,720,42195,completed
368,41387,1487,1,2-6,1,0.2740604861111111,0.0,42061,674,43548,completed
370,42489,3661,1,6-12,1,0.7868868194444445,0.0,42489,0,46150,completed
371,42594,4585,1,6-12,1,1.0383218194444446,0.0,42773,179,47358,completed
372,42783,2656,1,2-6,1,0.5874145138888889,0.0,43249,466,45905,completed
373,42786,3009,1,6-12,1,0.6860831250000001,0.0,43431,645,46440,completed
374,43771,4646,1,6-12,1,1.075626625,0.0,43771,0,48417,completed
375,43891,155,1,0-2,1,0.03607194444444444,0.0,44969,1078,45124,completed
377,43910,180,1,0-2,1,0.04189,0.0,45125,1215,45305,completed
379,44138,140,1,0-2,1,0.03267905555555556,0.0,45306,1168,45446,completed
380,44187,3610,1,6-12,1,0.8434227777777779,0.0,45447,1260,49057,completed
381,44214,1049,1,0-2,1,0.26602218055555565,0.0,45906,1692,46955,completed
382,44268,198,1,0-2,1,0.05175775000000002,0.0,46151,1883,46349,completed
383,44357,786,1,0-2,1,0.1980985833333334,0.0,46350,1993,47136,completed
384,44409,949,1,0-2,1,0.23514040277777787,0.0,46441,2032,47390,completed
385,44459,1168,1,0-2,1,0.2619688888888889,0.0,46956,2497,48124,completed
386,44536,824,1,0-2,1,0.18437605555555558,0.0,47137,2601,47961,completed
402,45862,294,1,0-2,1,0.06817536111111111,0.02548,47302,1440,47596,completed
392,45193,394,1,0-2,1,0.08768625000000002,0.034146666666666665,47353,2160,47747,completed
387,44538,185,1,0-2,1,0.04359959722222223,0.0,47359,2821,47544,completed
388,44818,689,1,0-2,1,0.14854815277777778,0.0,47391,2573,48080,completed
407,46720,71,2,0-2,2,0.03400702777777777,0.012306666666666667,47440,720,47511,completed
393,45295,1179,1,0-2,1,0.255136375,0.10218,47455,2160,48634,completed
376,43891,1150,2,0-2,2,0.4961673055555556,0.19933333333333333,47491,3600,48641,completed
389,44928,10297,1,12-24,1,2.1819850694444445,0.0,47545,2617,57842,completed
378,43982,171,2,0-2,2,0.07185325000000001,0.02964,47582,3600,47753,completed
403,46142,593,1,0-2,1,0.12458765277777778,0.05139333333333333,47582,1440,48175,completed
394,45498,1080,1,0-2,1,0.23388391666666666,0.0936,47658,2160,48738,completed
395,45499,847,1,0-2,1,0.18168004166666668,0.07340666666666666,47659,2160,48506,completed
410,47700,817,1,0-2,1,0.17553127777777777,0.07080666666666667,47700,0,48517,completed
396,45622,356,1,0-2,1,0.07479461111111112,0.030853333333333333,47782,2160,48138,completed
412,47824,111,1,0-2,1,0.02332079166666667,0.00962,47824,0,47935,completed
390,44963,535,1,0-2,1,0.11433593055555556,0.04636666666666667,47843,2880,48378,completed
404,46424,350,1,0-2,1,0.07353402777777779,0.030333333333333334,47864,1440,48214,completed
398,45710,292,1,0-2,1,0.06134838888888888,0.02530666666666667,47870,2160,48162,completed
399,45711,281,1,0-2,1,0.059037319444444444,0.024353333333333334,47871,2160,48152,completed
400,45732,848,1,0-2,1,0.1851693888888889,0.07349333333333334,47892,2160,48740,completed
413,47910,61,1,0-2,1,0.012815930555555558,0.005286666666666667,47910,0,47971,completed
391,45053,472,1,0-2,1,0.10147818055555555,0.04090666666666667,47933,2880,48405,completed
408,47229,187,1,0-2,1,0.03928818055555556,0.016206666666666668,47949,720,48136,completed
409,47241,72,1,0-2,1,0.015127,0.00624,47961,720,48033,completed
397,45674,2719,1,2-6,1,0.6264531666666666,0.0,47962,2288,50681,completed
401,45811,16642,1,24-48,1,3.34878275,0.0,48081,2270,64723,completed
406,46681,2204,1,2-6,1,0.5045417638888889,0.0,48125,1444,50329,completed
414,48049,1771,1,2-6,1,0.4070871388888889,0.0,48418,369,50189,completed
415,48123,63,1,0-2,1,0.014365750000000005,0.0,49058,935,49121,completed
417,48606,112,1,0-2,1,0.02553911111111112,0.0,49122,516,49234,completed
418,48670,137,1,0-2,1,0.03123980555555556,0.0,49235,565,49372,completed
420,48927,94,1,0-2,1,0.02143461111111112,0.0,49373,446,49467,completed
421,49475,449,1,0-2,1,0.10496002777777778,0.0,49475,0,49924,completed
416,48154,199,2,0-2,2,0.09495616666666666,0.0,49925,1771,50124,completed
419,48727,4357,2,6-12,2,1.9696708333333333,0.0,50125,1398,54482,completed
425,49978,169,1,0-2,1,0.040320583333333326,0.0,50190,212,50359,completed
426,49982,138,1,0-2,1,0.03381605555555555,0.0,50330,348,50468,completed
427,50035,126,1,0-2,1,0.031189055555555553,0.0,50360,325,50486,completed
428,50136,123,1,0-2,1,0.03095841666666667,0.0,50469,333,50592,completed
429,50677,127,1,0-2,1,0.03196519444444444,0.0,50677,0,50804,completed
430,50698,377,1,0-2,1,0.09488880555555557,0.0,50698,0,51075,completed
431,51075,2461,1,2-6,1,0.5431835833333333,0.0,51075,0,53536,completed
432,51154,1919,1,2-6,1,0.4283861527777777,0.0,51154,0,53073,completed
434,51515,10525,1,12-24,1,1.843568888888889,0.0,51515,0,62040,completed
437,51799,92,1,0-2,1,0.02114290277777777,0.0,51799,0,51891,completed
438,52072,1154,1,0-2,1,0.2455838611111111,0.0,52072,0,53226,completed
436,51611,856,2,0-2,2,0.3587471111111111,0.14837333333333333,52331,720,53187,completed
423,49616,589,3,0-2,3-4,0.3643772916666666,0.15314,52496,2880,53085,completed
424,49690,1004,3,0-2,3-4,0.6177913333333335,0.26104,52570,2880,53574,completed
433,51206,126,4,0-2,3-4,0.102781,0.043680000000000004,52646,1440,52772,completed
435,51572,107,3,0-2,3-4,0.06546170833333334,0.02782,53012,1440,53119,completed
439,52366,1604,1,2-6,1,0.34598469444444446,0.0,53074,708,54678,completed
422,49515,607,3,0-2,3-4,0.3766983750000001,0.15782000000000002,53115,3600,53722,completed
440,52367,1299,1,0-2,1,0.2802033194444445,0.0,53227,860,54526,completed
445,52367,2313,1,2-6,1,0.51211625,0.0,53286,919,55599,completed
446,52367,3941,1,6-12,1,0.7686801249999999,0.0,53537,1170,57478,completed
444,52367,7298,1,12-24,1,1.1522181944444445,0.0,54483,2116,61781,completed
442,52367,1348,1,0-2,1,0.30541016666666665,0.0,54483,2116,55831,completed
443,52367,1995,1,2-6,1,0.41906097222222216,0.0,54527,2160,56522,completed
441,52367,7217,1,12-24,1,1.1248941666666668,0.0,54679,2312,61896,completed
448,52368,277,1,0-2,1,0.06167866666666665,0.0,55600,3232,55877,completed
447,52368,277,1,0-2,1,0.06167866666666665,0.0,55832,3464,56109,completed
449,52785,5805,1,12-24,1,0.8216290833333334,0.0,55878,3093,61683,completed
405,46610,6531,4,12-24,3-4,3.839304166666667,2.26408,55970,9360,62501,completed
450,53223,4231,1,6-12,1,0.5811849444444445,0.36668666666666666,56103,2880,60334,completed
451,53310,4024,1,6-12,1,0.5515207222222223,0.0,56110,2800,60134,completed
452,53549,397,2,0-2,2,0.1105534722222222,0.06881333333333334,56429,2880,56826,completed
411,47790,2259,4,2-6,3-4,1.3135480000000002,0.78312,56430,8640,58689,completed
453,53555,480,1,0-2,1,0.06685277777777776,0.0416,56435,2880,56915,completed
454,53584,132,1,0-2,1,0.018379166666666665,0.01144,56464,2880,56596,completed
455,55418,11702,1,24-48,1,1.9575763194444447,0.0,56523,1105,68225,completed
456,55423,11521,1,24-48,1,1.9141164583333334,0.0,57479,2056,69000,completed
459,55424,11787,1,24-48,1,1.9252204166666667,0.0,57843,2419,69630,completed
475,57699,105,1,0-2,1,0.013425416666666669,0.0091,58419,720,58524,completed
476,57839,365,1,0-2,1,0.04666930555555557,0.03163333333333333,58559,720,58924,completed
477,57840,544,1,0-2,1,0.06821511111111112,0.04714666666666667,58560,720,59104,completed
478,57919,67,1,0-2,1,0.008566694444444446,0.005806666666666667,58639,720,58706,completed
481,58787,245,1,0-2,1,0.03132597222222223,0.021233333333333333,58787,0,59032,completed
467,56645,923,1,0-2,1,0.10359647222222224,0.07999333333333333,58805,2160,59728,completed
472,57384,160,1,0-2,1,0.02045777777777778,0.013866666666666666,58824,1440,58984,completed
473,57541,91,1,0-2,1,0.010964694444444442,0.007886666666666667,58981,1440,59072,completed
474,57542,318,1,0-2,1,0.03521066666666667,0.02756,58982,1440,59300,completed
462,56158,691,1,0-2,1,0.07391173611111113,0.059886666666666664,59038,2880,59729,completed
479,58363,664,1,0-2,1,0.07098344444444446,0.05754666666666667,59083,720,59747,completed
463,56269,731,1,0-2,1,0.08218093055555557,0.06335333333333333,59149,2880,59880,completed
480,58498,257,1,0-2,1,0.02747401388888889,0.022273333333333332,59218,720,59475,completed
482,59218,130,1,0-2,1,0.013897361111111112,0.011266666666666666,59218,0,59348,completed
483,59286,617,1,0-2,1,0.0707673888888889,0.05347333333333333,59286,0,59903,completed
471,57157,306,1,0-2,1,0.03271225,0.026520000000000002,59317,2160,59623,completed
465,56454,257,1,0-2,1,0.02747401388888889,0.022273333333333332,59334,2880,59591,completed
466,56456,919,1,0-2,1,0.11488802777777779,0.07964666666666667,59336,2880,60255,completed
457,55424,11442,1,12-24,1,1.8493033333333333,0.0,60135,4711,71577,completed
488,60350,751,1,0-2,1,0.10219848611111114,0.06508666666666667,60350,0,61101,completed
491,61146,137,1,0-2,1,0.019759777777777775,0.011873333333333333,61146,0,61283,completed
458,55424,11868,1,24-48,1,1.9770487777777777,0.0,61684,6260,73552,completed
460,55424,11847,1,24-48,1,1.9727918611111113,0.0,61732,6308,73579,completed
461,55453,5369,1,6-12,1,1.1167041944444445,0.0,61732,6279,67101,completed
464,56297,1553,1,2-6,1,0.35860250000000005,0.0,61782,5485,63335,completed
468,56835,3157,1,6-12,1,0.7957054444444445,0.0,61897,5062,65054,completed
469,56909,4358,1,6-12,1,0.9770839583333334,0.0,62041,5132,66399,completed
485,59825,3847,1,6-12,1,0.7595098055555556,0.0,63336,3511,67183,completed
486,59996,3954,1,6-12,1,0.540026638888889,0.0,64724,4728,68678,completed
512,63601,281,1,0-2,1,0.05223087500000001,0.024353333333333334,65041,1440,65322,completed
487,60129,7973,1,12-24,1,1.0590280972222224,0.0,65055,4926,73028,completed
513,63622,113,1,0-2,1,0.021003874999999998,0.009793333333333333,65062,1440,65175,completed
514,64516,177,1,0-2,1,0.03289987500000001,0.01534,65236,720,65413,completed
490,61016,1572,1,2-6,1,0.22153544444444448,0.13624,65336,4320,66908,completed
492,61158,123,1,0-2,1,0.019509000000000002,0.01066,65478,4320,65601,completed
493,61159,121,1,0-2,1,0.01917865277777778,0.010486666666666667,65479,4320,65600,completed
511,63329,217,1,0-2,1,0.03263395833333334,0.018806666666666666,65489,2160,65706,completed
494,61220,427,2,0-2,2,0.1233792777777778,0.07401333333333333,65540,4320,65967,completed
495,61226,156,2,0-2,2,0.04507533333333334,0.02704,65546,4320,65702,completed
509,62705,823,1,0-2,1,0.11558263888888892,0.07132666666666666,65585,2880,66408,completed
505,62004,2531,1,2-6,1,0.3127208611111112,0.21935333333333334,65604,3600,68135,completed
497,61312,431,1,0-2,1,0.06226752777777779,0.037353333333333336,65632,4320,66063,completed
496,61312,431,1,0-2,1,0.06226752777777779,0.037353333333333336,65632,4320,66063,completed
498,61330,712,1,0-2,1,0.10045472222222224,0.06170666666666667,65650,4320,66362,completed
489,60658,1746,1,2-6,1,0.22229850000000004,0.15132,65698,5040,67444,completed
499,61384,1609,4,2-6,3-4,0.8270532222222224,0.5577866666666667,65704,4320,67313,completed
506,62191,13742,1,24-48,1,1.495839402777778,1.1909733333333334,65791,3600,79533,completed
500,61602,601,1,0-2,1,0.08123855555555556,0.05208666666666667,65922,4320,66523,completed
515,65228,557,3,0-2,3-4,0.2257118333333334,0.14482,65948,720,66505,completed
510,63097,16896,1,24-48,1,2.2728155,1.46432,65977,2880,82873,completed
501,61704,641,1,0-2,1,0.08421294444444445,0.055553333333333337,66024,4320,66665,completed
484,59569,5556,3,6-12,3-4,1.932398,1.44456,66049,6480,71605,completed
502,61805,974,1,0-2,1,0.12197844444444446,0.08441333333333334,66125,4320,67099,completed
508,62553,389,1,0-2,1,0.05023519444444445,0.03371333333333333,66153,3600,66542,completed
503,62001,206,1,0-2,1,0.02569277777777778,0.017853333333333332,66321,4320,66527,completed
504,62001,508,1,0-2,1,0.06335888888888888,0.044026666666666665,66321,4320,66829,completed
507,62292,619,1,0-2,1,0.07645080555555556,0.0,66400,4108,67019,completed
524,66003,955,1,0-2,1,0.10995522222222226,0.08276666666666667,66723,720,67678,completed
525,66117,85,1,0-2,1,0.01060138888888889,0.007366666666666667,66837,720,66922,completed
526,66143,412,1,0-2,1,0.04736930555555557,0.035706666666666664,66863,720,67275,completed
516,65662,4909,1,6-12,1,0.566505138888889,0.0,67020,1358,71929,completed
527,66348,712,1,0-2,1,0.0796075555555556,0.06170666666666667,67068,720,67780,completed
517,65675,126,1,0-2,1,0.014108500000000003,0.0,67102,1427,67228,completed
518,65700,114,1,0-2,1,0.012764833333333338,0.00988,67140,1440,67254,completed
519,65748,1777,1,2-6,1,0.20132143055555557,0.0,67184,1436,68961,completed
521,65753,459,4,0-2,3-4,0.20558100000000007,0.15912,67193,1440,67652,completed
520,65752,2528,1,2-6,1,0.2820514166666667,0.0,67229,1477,69757,completed
528,66571,118,1,0-2,1,0.013212722222222225,0.010226666666666667,67291,720,67409,completed
522,65754,2078,1,2-6,1,0.2296186111111111,0.0,68226,2472,70304,completed
523,65776,3221,1,6-12,1,0.3709835972222222,0.0,68491,2715,71712,completed
529,67484,2584,1,2-6,1,0.2849515972222222,0.0,68679,1195,71263,completed
530,67621,2588,1,2-6,1,0.2923266388888889,0.0,68962,1341,71550,completed
531,68136,77,1,0-2,1,0.009059263888888884,0.0,69001,865,69078,completed
533,68294,753,2,0-2,2,0.16117183333333335,0.13052,69014,720,69767,completed
534,68348,762,1,0-2,1,0.08086516666666665,0.06604,69068,720,69830,completed
532,68137,90,1,0-2,1,0.009982374999999998,0.0,69079,942,69169,completed
545,69150,1256,1,0-2,1,0.13342377777777775,0.10885333333333333,69150,0,70406,completed
543,69150,1394,1,0-2,1,0.14824344444444443,0.12081333333333334,69150,0,70544,completed
542,69150,1292,1,0-2,1,0.1372897777777778,0.11197333333333334,69150,0,70442,completed
549,69156,969,1,0-2,1,0.10261583333333332,0.08398,69156,0,70125,completed
548,69156,1050,1,0-2,1,0.11131433333333332,0.091,69156,0,70206,completed
536,68479,91,1,0-2,1,0.009580277777777776,0.0,69170,691,69261,completed
537,68645,362,1,0-2,1,0.03811055555555555,0.0,69262,617,69624,completed
538,68776,1500,1,2-6,1,0.16420777777777776,0.0,69625,849,71125,completed
540,69143,12853,1,24-48,1,1.734988611111111,0.0,69631,488,82484,completed
546,69150,1509,1,2-6,1,0.16635438888888887,0.0,69758,608,71267,completed
541,69150,1521,1,2-6,1,0.1876,0.0,70305,1155,71826,completed
544,69150,1519,1,2-6,1,0.24364988888888883,0.0,71126,1976,72645,completed
547,69152,1773,1,2-6,1,0.3021877777777778,0.0,71264,2112,73037,completed
551,70034,2646,1,2-6,1,0.4297291666666666,0.0,71268,1234,73914,completed
552,70055,2597,1,2-6,1,0.4150480277777777,0.0,71551,1496,74148,completed
553,70088,2538,1,2-6,1,0.40767827777777776,0.0,71578,1490,74116,completed
556,70912,435,1,0-2,1,0.06936230555555555,0.0,71713,801,72148,completed
539,68928,1528,2,2-6,2,0.5705791111111111,0.0,71930,3002,73458,completed
558,72030,1966,1,2-6,1,0.3186475277777778,0.0,72149,119,74115,completed
559,72338,105,1,0-2,1,0.01995533333333334,0.0,72646,308,72751,completed
560,72783,120,1,0-2,1,0.022693333333333336,0.0,72783,0,72903,completed
561,72897,671,1,0-2,1,0.11611230555555555,0.0,72904,7,73575,completed
562,72955,1274,1,0-2,1,0.16669059722222218,0.0,73029,74,74303,completed
563,73115,148,1,0-2,1,0.027988444444444437,0.0,73115,0,73263,completed
535,68351,3347,3,6-12,3-4,0.8299765833333335,0.87022,73391,5040,76738,completed
564,73391,579,1,0-2,1,0.06716894444444443,0.0,73391,0,73970,completed
550,69536,176,2,0-2,2,0.038456,0.0,73459,3923,73635,completed
565,73422,1438,1,0-2,1,0.12644804166666668,0.0,73553,131,74991,completed
566,73571,682,1,0-2,1,0.07086480555555555,0.0,73576,5,74258,completed
567,73593,472,1,0-2,1,0.051565999999999994,0.0,73593,0,74065,completed
554,70122,686,2,0-2,2,0.13784449999999998,0.0,73636,3514,74322,completed
470,57089,3437,3,6-12,3-4,0.8088705,0.89362,73649,16560,77086,completed
568,73653,1847,1,2-6,1,0.1533233611111111,0.16007333333333335,73653,0,75500,completed
575,73838,2024,1,2-6,1,0.15984280555555558,0.17541333333333334,73838,0,75862,completed
569,73662,864,1,0-2,1,0.0713772361111111,0.0,73915,253,74779,completed
578,73925,1940,1,2-6,1,0.15055909722222222,0.16813333333333333,73925,0,75865,completed
570,73759,791,1,0-2,1,0.06403405555555555,0.0,73971,212,74762,completed
579,73971,1976,1,2-6,1,0.15157540277777776,0.17125333333333334,73971,0,75947,completed
580,73972,2848,1,2-6,1,0.21521983333333336,0.24682666666666667,73972,0,76820,completed
581,73974,2462,1,2-6,1,0.18714533333333333,0.21337333333333333,73974,0,76436,completed
571,73764,1282,1,0-2,1,0.096915,0.0,74066,302,75348,completed
572,73770,943,1,0-2,1,0.06999023611111112,0.0,74116,346,75059,completed
573,73794,1014,1,0-2,1,0.07522798611111112,0.0,74117,323,75131,completed
574,73816,1368,1,0-2,1,0.10039784722222223,0.0,74149,333,75517,completed
576,73878,649,1,0-2,1,0.04683451388888889,0.0,74259,381,74908,completed
577,73925,1200,1,0-2,1,0.08785266666666668,0.0,74304,379,75504,completed
555,70789,333,2,0-2,2,0.04799825,0.0,74323,3534,74656,completed
557,71499,217,3,0-2,3-4,0.046917208333333335,0.05642,74379,2880,74596,completed
582,74054,1374,1,0-2,1,0.10129780555555556,0.0,74657,603,76031,completed
583,74174,62,1,0-2,1,0.004468305555555553,0.0,74657,483,74719,completed
584,74275,62,1,0-2,1,0.004468305555555553,0.0,74720,445,74782,completed
585,74877,1153,1,0-2,1,0.08536884722222222,0.0,74877,0,76030,completed
586,74878,946,1,0-2,1,0.07011858333333335,0.0,74878,0,75824,completed
587,75379,692,1,0-2,1,0.051115861111111105,0.0,75379,0,76071,completed
588,75379,198,1,0-2,1,0.014704249999999999,0.0,75379,0,75577,completed
589,75854,692,1,0-2,1,0.050729555555555556,0.0,75854,0,76546,completed
590,76739,3412,1,6-12,1,0.30615441666666665,0.0,76739,0,80151,completed
591,76755,1813,1,2-6,1,0.12419693055555553,0.0,76755,0,78568,completed
592,76756,3651,1,6-12,1,0.35329454166666663,0.0,76756,0,80407,completed
593,76767,6078,1,12-24,1,1.011292625,0.0,76767,0,82845,completed
594,76796,258,1,0-2,1,0.01866091666666667,0.0,76796,0,77054,completed
595,77026,3433,1,6-12,1,0.34353412499999997,0.0,77026,0,80459,completed
596,77317,392,1,0-2,1,0.026900999999999994,0.0,77317,0,77709,completed
597,77736,118,1,0-2,1,0.007756999999999997,0.0,77736,0,77854,completed
598,77778,129,1,0-2,1,0.008385,0.0,77778,0,77907,completed
599,78040,64,1,0-2,1,0.00416,0.0,78040,0,78104,completed
600,78044,62,1,0-2,1,0.00403,0.0,78044,0,78106,completed
601,78351,3535,1,6-12,1,0.6271625277777778,0.0,78351,0,81886,completed
602,78351,4930,1,6-12,1,1.0210809722222223,0.0,78351,0,83281,completed
603,78423,149,1,0-2,1,0.011349944444444447,0.0,78423,0,78572,completed
604,78425,136,1,0-2,1,0.010305875000000003,0.0,78425,0,78561,completed
605,78430,162,1,0-2,1,0.012556888888888892,0.0,78430,0,78592,completed
606,78800,511,1,0-2,1,0.046286013888888894,0.0,78800,0,79311,completed
607,78848,1058,1,0-2,1,0.11223463888888888,0.0,78848,0,79906,completed
608,79013,1119,1,0-2,1,0.1402283472222222,0.0,79013,0,80132,completed
609,79046,83,1,0-2,1,0.006897069444444446,0.0,79046,0,79129,completed
610,79049,1342,1,0-2,1,0.18617705555555553,0.0,79049,0,80391,completed
611,79067,1104,1,0-2,1,0.1431104722222222,0.09568,79067,0,80171,completed
612,79103,1369,1,0-2,1,0.19699543055555552,0.11864666666666666,79103,0,80472,completed
613,79134,409,1,0-2,1,0.04580120833333332,0.0,79134,0,79543,completed
614,79134,320,1,0-2,1,0.035339999999999996,0.027733333333333332,79134,0,79454,completed
615,79145,1191,1,0-2,1,0.16780701388888886,0.10322,79145,0,80336,completed
616,79182,1062,1,0-2,1,0.14734824999999996,0.09204,79182,0,80244,completed
617,79247,1523,1,2-6,1,0.2580203333333333,0.0,79312,65,80835,completed
618,79555,853,1,0-2,1,0.135114375,0.0,79555,0,80408,completed
619,80266,119,1,0-2,1,0.022486041666666665,0.0,80266,0,80385,completed
620,80684,567,1,0-2,1,0.14685299999999996,0.0,80684,0,81251,completed
621,80690,892,1,0-2,1,0.2375924166666667,0.0,80690,0,81582,completed
622,81007,483,1,0-2,1,0.12894102777777777,0.0,81007,0,81490,completed
623,81056,2643,4,2-6,3-4,2.929470555555556,0.0,81056,0,83699,completed
624,81107,370,1,0-2,1,0.09928962500000002,0.0,81107,0,81477,completed
625,81161,4649,1,6-12,1,1.1316017361111113,0.0,81252,91,85901,completed
626,81326,351,1,0-2,1,0.10128787500000004,0.0,81478,152,81829,completed
628,81518,407,1,0-2,1,0.11744776388888893,0.0,81518,0,81925,completed
629,81691,5309,1,6-12,1,1.179648513888889,0.0,81691,0,87000,completed
630,81838,183,1,0-2,1,0.052808208333333356,0.0,81838,0,82021,completed
631,81861,478,1,0-2,1,0.1381855694444445,0.0,81887,26,82365,completed
632,81988,229,1,0-2,1,0.06620227777777779,0.0,81988,0,82217,completed
633,82056,98,1,0-2,1,0.02834455555555556,0.0,82056,0,82154,completed
634,82122,10925,1,12-24,1,2.383910555555556,0.0,82155,33,93080,completed
635,82448,133,1,0-2,1,0.038496111111111106,0.0,82448,0,82581,completed
636,82581,4259,1,6-12,1,0.8983766666666666,0.0,82581,0,86840,completed
640,82817,197,2,0-2,2,0.10610638888888888,0.0,82817,0,83014,completed
627,81444,71,3,0-2,3-4,0.0573620833333333,0.0,83015,1571,83086,completed
638,82710,2590,3,2-6,3-4,1.7206351666666664,0.0,83087,377,85677,completed
637,82658,1329,4,0-2,3-4,1.199571,0.0,83700,1042,85029,completed
641,83717,60,1,0-2,1,0.014601666666666666,0.0,83717,0,83777,completed
642,83979,199,1,0-2,1,0.04842886111111112,0.0,83979,0,84178,completed
646,84699,504,1,0-2,1,0.09916649999999999,0.0,84699,0,85203,completed
639,82755,2160,3,2-6,3-4,1.0476279166666669,0.0,85030,2275,87190,completed
648,84709,261,1,0-2,1,0.04560975,0.0,85030,321,85291,completed
644,84474,461,3,0-2,3-4,0.24167925,0.11986000000000001,85194,720,85655,completed
645,84511,517,3,0-2,3-4,0.2687110833333333,0.13442,85231,720,85748,completed
643,83998,80,2,0-2,2,0.02796,0.0,85292,1294,85372,completed
647,84705,228,2,0-2,2,0.079686,0.0,85373,668,85601,completed
649,84751,105,2,0-2,2,0.0366975,0.0182,85471,720,85576,completed
650,84908,76,2,0-2,2,0.026561999999999995,0.0,85602,694,85678,completed
652,85293,270,1,0-2,1,0.04412655555555557,0.0,85678,385,85948,completed
654,85396,61,1,0-2,1,0.009986986111111115,0.0,85678,282,85739,completed
655,85418,63,1,0-2,1,0.01031368055555556,0.0,85678,260,85741,completed
656,85495,493,1,0-2,1,0.08054158333333336,0.0,85679,184,86172,completed
657,85563,9852,1,12-24,1,1.8212389722222224,0.0,85679,116,95531,completed
658,85564,643,1,0-2,1,0.10503226388888892,0.0,85740,176,86383,completed
659,85675,1516,1,2-6,1,0.2351908888888889,0.0,85742,67,87258,completed
660,86045,904,1,0-2,1,0.1403611388888889,0.0,86045,0,86949,completed
661,86070,2649,1,2-6,1,0.42319133333333336,0.0,86070,0,88719,completed
662,86074,138,1,0-2,1,0.022541916666666672,0.0,86173,99,86311,completed
663,86296,125,1,0-2,1,0.019926097222222227,0.0,86312,16,86437,completed
664,86522,385,1,0-2,1,0.057766041666666657,0.0,86522,0,86907,completed
665,86604,172,1,0-2,1,0.025807166666666666,0.0,86604,0,86776,completed
651,85178,977,4,0-2,3-4,0.5722183888888889,0.33869333333333335,86618,1440,87595,completed
666,86701,93,1,0-2,1,0.013953874999999998,0.0,86777,76,86870,completed
653,85354,666,4,0-2,3-4,0.3895865555555555,0.23088,86794,1440,87460,completed
667,86819,325,2,0-2,2,0.09716975,0.05633333333333333,86819,0,87144,completed
668,86844,231,1,0-2,1,0.034659625,0.0,86844,0,87075,completed
669,87124,450,1,0-2,1,0.06416874999999998,0.0,87124,0,87574,completed
670,87136,2757,1,2-6,1,0.6359272083333333,0.0,87136,0,89893,completed
671,87193,17516,1,24-48,1,5.067433986111111,0.0,87193,0,104709,completed
672,87228,403,1,0-2,1,0.05746668055555554,0.0,87228,0,87631,completed
673,87262,12102,1,24-48,1,2.5560442500000002,0.0,87262,0,99364,completed
674,87361,700,2,0-2,2,0.2098941944444444,0.0,87361,0,88061,completed
675,87453,214,1,0-2,1,0.03051580555555555,0.0,87453,0,87667,completed
676,87483,2160,1,2-6,1,0.48913000000000006,0.0,87483,0,89643,completed
678,87484,1142,1,0-2,1,0.18641911111111112,0.09897333333333333,87484,0,88626,completed
677,87484,2027,1,2-6,1,0.4600512361111112,0.0,87575,91,89602,completed
679,87592,385,1,0-2,1,0.05807947222222222,0.03336666666666667,87592,0,87977,completed
680,87691,146,1,0-2,1,0.020819194444444442,0.0,87691,0,87837,completed
681,88122,359,1,0-2,1,0.05952419444444445,0.0,88122,0,88481,completed
682,88187,82,1,0-2,1,0.013596055555555557,0.0,88187,0,88269,completed
683,88513,81,1,0-2,1,0.016176694444444452,0.0,88513,0,88594,completed
684,88524,621,1,0-2,1,0.15022025000000006,0.0,88524,0,89145,completed
685,88528,107,1,0-2,1,0.02379952777777779,0.0,88528,0,88635,completed
686,88622,120,1,0-2,1,0.029590000000000012,0.0,88622,0,88742,completed
687,88704,343,1,0-2,1,0.08457808333333337,0.0,88704,0,89047,completed
688,88704,345,1,0-2,1,0.08507125000000004,0.0,88704,0,89049,completed
689,88794,245,1,0-2,1,0.0604129166666667,0.0,88794,0,89039,completed
690,88984,17236,1,24-48,1,5.319035888888888,0.0,88984,0,106220,completed
691,89062,373,1,0-2,1,0.11409106944444443,0.0,89062,0,89435,completed
692,89169,167,3,0-2,3-4,0.1475085833333334,0.0,89169,0,89336,completed
693,89170,169,3,0-2,3-4,0.19735679166666664,0.0,89337,167,89506,completed
694,89211,959,1,0-2,1,0.35532608333333326,0.0,89436,225,90395,completed
695,89564,240,2,0-2,2,0.1868466666666666,0.0,89564,0,89804,completed
696,89577,68,1,0-2,1,0.02646994444444445,0.0,89577,0,89645,completed
697,89631,722,1,0-2,1,0.2649821249999999,0.0,89631,0,90353,completed
698,89770,1655,1,2-6,1,0.4787552777777777,0.0,89770,0,91425,completed
699,90614,442,1,0-2,1,0.10398283333333334,0.0,90614,0,91056,completed
700,90619,460,1,0-2,1,0.10688772222222223,0.0,90619,0,91079,completed
701,90662,67,1,0-2,1,0.021746750000000002,0.0,90662,0,90729,completed
702,90818,1543,1,2-6,1,0.26710061111111105,0.0,90818,0,92361,completed
703,90856,590,1,0-2,1,0.11832872222222224,0.0,90856,0,91446,completed
704,90966,542,1,0-2,1,0.10581016666666668,0.0,90966,0,91508,completed
705,91015,475,1,0-2,1,0.09317430555555557,0.0,91015,0,91490,completed
706,91063,1270,1,0-2,1,0.21358036111111112,0.0,91063,0,92333,completed
707,91145,833,1,0-2,1,0.1425586944444444,0.0,91145,0,91978,completed
708,91221,711,1,0-2,1,0.11067513888888886,0.0,91426,205,92137,completed
709,91223,668,1,0-2,1,0.10337299999999996,0.0,91447,224,92115,completed
710,91877,70,1,0-2,1,0.0108325,0.0,91877,0,91947,completed
711,91995,87,1,0-2,1,0.01346325,0.0,91995,0,92082,completed
712,92117,1258,1,0-2,1,0.183088,0.0,92117,0,93375,completed
713,92120,627,1,0-2,1,0.09567488888888889,0.0,92120,0,92747,completed
714,92125,1196,1,0-2,1,0.17457650000000002,0.0,92125,0,93321,completed
715,92125,884,1,0-2,1,0.13255183333333334,0.0,92125,0,93009,completed
716,92137,1332,1,0-2,1,0.1926342222222222,0.0,92138,1,93470,completed
717,92143,450,1,0-2,1,0.0686,0.0,92334,191,92784,completed
718,92355,459,1,0-2,1,0.069972,0.0,92362,7,92821,completed
719,92426,63,1,0-2,1,0.009604000000000001,0.0,92748,322,92811,completed
720,92515,1432,1,0-2,1,0.1777640138888889,0.0,92785,270,94217,completed
721,92665,5915,1,12-24,1,0.9998878472222222,0.0,92812,147,98727,completed
722,92822,1767,1,2-6,1,0.21141062500000002,0.0,92822,0,94589,completed
723,92867,188,1,0-2,1,0.025322555555555556,0.0,93010,143,93198,completed
724,92881,481,1,0-2,1,0.06478802777777778,0.0,93081,200,93562,completed
725,92944,5964,1,12-24,1,1.1474229305555557,0.0,93199,255,99163,completed
727,93062,119,1,0-2,1,0.01602863888888889,0.0,93322,260,93441,completed
728,93210,987,1,0-2,1,0.11205237500000001,0.0,93376,166,94363,completed
729,93257,9715,1,12-24,1,3.054841527777778,0.0,93442,185,103157,completed
730,93606,79,1,0-2,1,0.00848920833333333,0.0,93606,0,93685,completed
731,93699,2446,1,2-6,1,0.25513440277777777,0.0,93699,0,96145,completed
732,93778,879,1,0-2,1,0.09359465277777779,0.0,93778,0,94657,completed
733,93815,1628,1,2-6,1,0.17122430555555557,0.0,94218,403,95846,completed
734,93825,1369,1,0-2,1,0.1446802777777778,0.0,94364,539,95733,completed
735,93850,1584,1,2-6,1,0.16280825,0.0,94590,740,96174,completed
736,94023,88,1,0-2,1,0.009231444444444445,0.0,94658,635,94746,completed
737,94276,626,1,0-2,1,0.06618251388888889,0.0,94747,471,95373,completed
738,94296,93,1,0-2,1,0.009899333333333331,0.0,95374,1078,95467,completed
742,94690,1322,1,0-2,1,0.14007155555555556,0.11457333333333333,95410,720,96732,completed
751,95429,223,1,0-2,1,0.023737111111111105,0.019326666666666666,95429,0,95652,completed
743,94742,67,1,0-2,1,0.007131777777777779,0.005806666666666667,95462,720,95529,completed
739,94301,2072,1,2-6,1,0.2868398333333334,0.0,95468,1167,97540,completed
752,95476,473,1,0-2,1,0.04801722222222223,0.04099333333333333,95476,0,95949,completed
753,95513,936,3,0-2,3-4,0.27340300000000006,0.24336,95513,0,96449,completed
740,94320,1986,1,2-6,1,0.27434375000000005,0.0,95532,1212,97518,completed
747,94835,1126,1,0-2,1,0.11754244444444445,0.09758666666666667,95555,720,96681,completed
748,94838,1175,1,0-2,1,0.1244568888888889,0.10183333333333333,95558,720,96733,completed
749,94871,518,1,0-2,1,0.050833888888888894,0.044893333333333334,95591,720,96109,completed
755,95692,533,1,0-2,1,0.0509998888888889,0.046193333333333336,95692,0,96225,completed
741,94527,2914,1,6-12,1,0.6293732222222223,0.0,95734,1207,98648,completed
756,95736,242,1,0-2,1,0.023070888888888894,0.020973333333333333,95736,0,95978,completed
757,95816,181,1,0-2,1,0.017034111111111108,0.015686666666666668,95816,0,95997,completed
744,94782,2393,1,2-6,1,0.4652934444444445,0.0,95847,1065,98240,completed
758,96075,608,1,0-2,1,0.06635455555555556,0.052693333333333335,96075,0,96683,completed
759,96145,118,1,0-2,1,0.01110511111111111,0.010226666666666667,96145,0,96263,completed
745,94791,1603,1,2-6,1,0.27342573611111115,0.0,96146,1355,97749,completed
746,94826,1834,1,2-6,1,0.3481240416666667,0.0,96175,1349,98009,completed
760,96189,64,1,0-2,1,0.006023111111111111,0.005546666666666667,96189,0,96253,completed
761,96223,545,1,0-2,1,0.06425055555555556,0.047233333333333336,96223,0,96768,completed
763,96346,73,1,0-2,1,0.006870111111111111,0.006326666666666667,96346,0,96419,completed
764,96546,64,1,0-2,1,0.008903111111111112,0.005546666666666667,96546,0,96610,completed
765,96596,1230,1,0-2,1,0.24574847222222226,0.1066,96596,0,97826,completed
766,96612,1123,1,0-2,1,0.22001309722222226,0.09732666666666667,96612,0,97735,completed
767,96624,696,1,0-2,1,0.11112966666666668,0.06032,96624,0,97320,completed
768,96632,1284,1,0-2,1,0.2639917222222223,0.11128,96632,0,97916,completed
770,96649,436,1,0-2,1,0.060652444444444446,0.03778666666666667,96649,0,97085,completed
769,96649,443,1,0-2,1,0.06162622222222222,0.038393333333333335,96649,0,97092,completed
771,96779,97,1,0-2,1,0.013493777777777778,0.008406666666666666,96779,0,96876,completed
772,96901,164,1,0-2,1,0.022814222222222222,0.014213333333333333,96901,0,97065,completed
774,97046,1052,1,0-2,1,0.2739334166666667,0.09117333333333333,97046,0,98098,completed
775,97271,313,2,0-2,2,0.16172536111111113,0.054253333333333334,97271,0,97584,completed
776,97317,1032,1,0-2,1,0.31605658333333336,0.08944,97317,0,98349,completed
777,97345,937,1,0-2,1,0.2837918472222223,0.08120666666666666,97345,0,98282,completed
779,97345,740,1,0-2,1,0.21019319444444445,0.06413333333333333,97345,0,98085,completed
778,97345,499,1,0-2,1,0.1289152638888889,0.04324666666666667,97345,0,97844,completed
780,97369,986,1,0-2,1,0.3048641111111111,0.08545333333333334,97369,0,98355,completed
781,97407,963,1,0-2,1,0.30065087500000004,0.08346,97407,0,98370,completed
782,97443,476,1,0-2,1,0.1229732777777778,0.041253333333333336,97443,0,97919,completed
783,97512,748,1,0-2,1,0.23242872222222227,0.06482666666666667,97512,0,98260,completed
750,95088,2842,1,2-6,1,1.1672017222222222,0.0,97519,2431,100361,completed
754,95684,3830,1,6-12,1,1.6446281805555554,0.0,97541,1857,101371,completed
784,97626,444,1,0-2,1,0.13199366666666668,0.03848,97626,0,98070,completed
785,97627,274,1,0-2,1,0.0707871388888889,0.023746666666666666,97627,0,97901,completed
762,96333,1542,1,2-6,1,0.613290861111111,0.0,97750,1417,99292,completed
786,97812,817,1,0-2,1,0.29278193055555557,0.07080666666666667,97812,0,98629,completed
787,97992,735,1,0-2,1,0.28217262499999995,0.0637,97992,0,98727,completed
773,96962,7784,1,12-24,1,3.451838194444445,0.0,98010,1048,105794,completed
788,98475,304,1,0-2,1,0.125682,0.0,98475,0,98779,completed
789,98476,265,1,0-2,1,0.10780148611111111,0.022966666666666666,98476,0,98741,completed
790,98581,114,1,0-2,1,0.04738119444444443,0.00988,98581,0,98695,completed
791,98597,306,1,0-2,1,0.13723097222222222,0.026520000000000002,98597,0,98903,completed
792,98762,1178,1,0-2,1,0.5456466388888889,0.0,98762,0,99940,completed
793,98763,73,1,0-2,1,0.03363170833333333,0.0,98763,0,98836,completed
794,99005,64,1,0-2,1,0.029485333333333332,0.0,99005,0,99069,completed
795,99024,265,1,0-2,1,0.12208770833333331,0.0,99024,0,99289,completed
796,99205,105,1,0-2,1,0.04837437499999998,0.0,99205,0,99310,completed
797,99205,74,1,0-2,1,0.03409241666666666,0.0,99205,0,99279,completed
798,99269,143,1,0-2,1,0.06619979166666665,0.0,99280,11,99423,completed
799,99269,374,1,0-2,1,0.17384180555555553,0.0,99290,21,99664,completed
726,92990,3894,3,6-12,3-4,5.678789458333334,0.0,99365,6375,103259,completed
801,99612,132,1,0-2,1,0.06148083333333333,0.0,99612,0,99744,completed
802,99736,3345,1,6-12,1,1.6400858055555556,0.0,99736,0,103081,completed
803,99779,1078,1,0-2,1,0.49535868055555554,0.0,99779,0,100857,completed
804,99871,2133,1,2-6,1,1.042160152777778,0.0,99941,70,102074,completed
800,99535,275,4,0-2,3-4,0.4993236111111112,0.09533333333333334,100255,720,100530,completed
805,99879,11989,1,24-48,1,4.094905847222223,0.0,100362,483,112351,completed
806,99886,288,1,0-2,1,0.14316,0.0,100858,972,101146,completed
807,99886,288,1,0-2,1,0.14316,0.0,101147,1261,101435,completed
808,100315,167,1,0-2,1,0.08360640277777778,0.0,101372,1057,101539,completed
811,100695,77,1,0-2,1,0.03827541666666668,0.0,101436,741,101513,completed
812,100875,84,1,0-2,1,0.04419141666666667,0.0,101514,639,101598,completed
813,100964,63,1,0-2,1,0.03328412500000001,0.0,101540,576,101603,completed
814,101263,2033,1,2-6,1,1.0011774305555556,0.0,101599,336,103632,completed
815,101325,74,1,0-2,1,0.03909563888888889,0.0,101604,279,101678,completed
816,101398,1705,1,2-6,1,0.8473876527777777,0.0,101679,281,103384,completed
818,101850,2230,1,2-6,1,1.0396247222222224,0.0,102075,225,104305,completed
820,102501,72,1,0-2,1,0.032378,0.0,103082,581,103154,completed
821,102511,200,1,0-2,1,0.08993888888888887,0.0,103155,644,103355,completed
823,102651,1877,1,2-6,1,0.769313138888889,0.0,103158,507,105035,completed
809,100423,3848,3,6-12,3-4,4.769794,0.0,103260,2837,107108,completed
824,102800,250,1,0-2,1,0.1124236111111111,0.0,103356,556,103606,completed
825,102857,87,1,0-2,1,0.03912341666666668,0.0,103385,528,103472,completed
826,102886,518,1,0-2,1,0.22661373611111116,0.0,103473,587,103991,completed
827,102904,9634,1,12-24,1,2.585809319444445,0.0,103607,703,113241,completed
828,102945,401,1,0-2,1,0.17312455555555561,0.0,103633,688,104034,completed
829,103379,3038,1,6-12,1,1.2298128333333334,0.0,103992,613,107030,completed
830,103380,4649,1,6-12,1,1.8076467361111113,0.0,104035,655,108684,completed
832,103381,4792,1,6-12,1,1.790496138888889,0.0,104306,925,109098,completed
835,103631,411,2,0-2,2,0.299116138888889,0.07124,104351,720,104762,completed
836,103685,642,1,0-2,1,0.22792783333333339,0.05564,104405,720,105047,completed
837,103788,230,2,0-2,2,0.16331277777777783,0.03986666666666667,104508,720,104738,completed
817,101670,581,3,0-2,3-4,0.6186245833333335,0.15106,104550,2880,105131,completed
838,103830,123,1,0-2,1,0.04366841666666668,0.01066,104550,720,104673,completed
839,103934,922,1,0-2,1,0.3247262777777778,0.07990666666666667,104654,720,105576,completed
840,103982,312,3,0-2,3-4,0.33230600000000005,0.08112,104702,720,105014,completed
831,103381,4862,1,6-12,1,1.740496722222222,0.0,104710,1329,109572,completed
841,104065,99,1,0-2,1,0.03514775000000001,0.00858,104785,720,104884,completed
842,104071,1378,2,0-2,2,1.0316298888888888,0.23885333333333333,104791,720,106169,completed
833,103403,593,1,0-2,1,0.20872324999999997,0.05139333333333333,104843,1440,105436,completed
819,102027,150,3,0-2,3-4,0.15976250000000003,0.039,104907,2880,105057,completed
834,103502,682,1,0-2,1,0.23924494444444444,0.05910666666666667,104942,1440,105624,completed
844,104413,4683,1,6-12,1,1.647771333333333,0.0,105036,623,109719,completed
846,104607,1538,1,2-6,1,0.7023930416666666,0.0,105795,1188,107333,completed
845,104607,1694,1,2-6,1,0.7314554583333333,0.0,106221,1614,107915,completed
847,104723,698,1,0-2,1,0.28537854166666665,0.0,107031,2308,107729,completed
810,100455,1951,3,2-6,3-4,1.9466050833333337,0.0,107109,6654,109060,completed
848,104727,3812,1,6-12,1,0.8577867777777779,0.0,107334,2607,111146,completed
849,104793,9929,1,12-24,1,1.4729852499999998,0.0,107730,2937,117659,completed
850,104872,77,1,0-2,1,0.02852529166666667,0.0,107916,3044,107993,completed
852,105263,402,1,0-2,1,0.12382774999999999,0.0,107994,2731,108396,completed
851,105263,402,1,0-2,1,0.11761027777777777,0.0,108397,3134,108799,completed
853,105454,65,1,0-2,1,0.01774375,0.0,108685,3231,108750,completed
856,105673,104,1,0-2,1,0.024252222222222217,0.0,108751,3078,108855,completed
857,105850,85,1,0-2,1,0.01982152777777778,0.0,108800,2950,108885,completed
858,105999,398,1,0-2,1,0.09281138888888887,0.0,108856,2857,109254,completed
859,106059,278,1,0-2,1,0.06482805555555557,0.0,108886,2827,109164,completed
822,102513,7578,2,12-24,2,1.8297876666666666,1.31352,108993,6480,116571,completed
843,104279,4580,2,6-12,2,1.0766513055555555,0.0,109061,4782,113641,completed
860,106185,90,1,0-2,1,0.0209875,0.0,109061,2876,109151,completed
861,106198,117,1,0-2,1,0.02728375,0.0,109099,2901,109216,completed
862,106229,9481,1,12-24,1,1.1746790277777777,0.8216866666666667,109109,2880,118590,completed
863,106299,1215,1,0-2,1,0.20405587500000003,0.0,109152,2853,110367,completed
864,106369,997,1,0-2,1,0.17708205555555556,0.0,109165,2796,110162,completed
865,106375,541,1,0-2,1,0.10178702777777777,0.0,109217,2842,109758,completed
866,106481,1161,1,0-2,1,0.1857596388888889,0.0,109255,2774,110416,completed
871,107138,64,1,0-2,1,0.014924444444444445,0.005546666666666667,109298,2160,109362,completed
891,108648,456,1,0-2,1,0.07690733333333336,0.03952,109368,720,109824,completed
877,107933,703,1,0-2,1,0.11519336111111114,0.06092666666666667,109373,1440,110076,completed
867,106504,94,1,0-2,1,0.019008,0.008146666666666667,109384,2880,109478,completed
878,107947,450,1,0-2,1,0.07451186111111113,0.039,109387,1440,109837,completed
879,107963,784,1,0-2,1,0.12450156944444447,0.06794666666666667,109403,1440,110187,completed
892,108706,1418,1,0-2,1,0.19587022222222225,0.12289333333333334,109426,720,110844,completed
872,107321,479,1,0-2,1,0.07499011111111112,0.04151333333333333,109481,2160,109960,completed
880,108094,369,1,0-2,1,0.057769000000000015,0.03198,109534,1440,109903,completed
893,108817,136,1,0-2,1,0.02129155555555556,0.011786666666666668,109537,720,109673,completed
868,106720,77,1,0-2,1,0.01205477777777778,0.0,109573,2853,109650,completed
881,108133,1275,2,0-2,2,0.3445015555555556,0.221,109573,1440,110848,completed
882,108157,75,1,0-2,1,0.01174166666666667,0.0065,109597,1440,109672,completed
883,108172,290,1,0-2,1,0.04540111111111112,0.025133333333333334,109612,1440,109902,completed
869,106809,1064,1,0-2,1,0.14450615277777779,0.0,109651,2842,110715,completed
894,108931,427,1,0-2,1,0.06684922222222223,0.03700666666666667,109651,720,110078,completed
884,108215,95,1,0-2,1,0.014872777777777782,0.008233333333333334,109655,1440,109750,completed
885,108216,204,1,0-2,1,0.03193733333333334,0.01768,109656,1440,109860,completed
873,107500,119,1,0-2,1,0.018630111111111115,0.010313333333333334,109660,2160,109779,completed
886,108220,264,1,0-2,1,0.041330666666666675,0.02288,109660,1440,109924,completed
895,108946,299,1,0-2,1,0.04681011111111112,0.025913333333333333,109666,720,109965,completed
896,108951,562,1,0-2,1,0.08508145833333336,0.04870666666666667,109671,720,110233,completed
899,108952,814,1,0-2,1,0.11447319444444445,0.07054666666666667,109672,720,110486,completed
897,108952,962,1,0-2,1,0.13175836111111114,0.08337333333333334,109672,720,110634,completed
898,108952,499,1,0-2,1,0.07768381944444447,0.04324666666666667,109672,720,110171,completed
887,108250,1234,2,0-2,2,0.3236961111111112,0.21389333333333332,109690,1440,110924,completed
870,106964,102,1,0-2,1,0.01596866666666667,0.0,109720,2756,109822,completed
900,109011,526,1,0-2,1,0.07849112500000001,0.045586666666666664,109731,720,110257,completed
901,109016,586,1,0-2,1,0.08529980555555557,0.05078666666666667,109736,720,110322,completed
874,107593,2632,2,2-6,2,0.5773663611111112,0.45621333333333336,109753,2160,112385,completed
875,107627,201,1,0-2,1,0.03146766666666667,0.0,109759,2132,109960,completed
888,108320,75,1,0-2,1,0.01174166666666667,0.0065,109760,1440,109835,completed
876,107651,708,1,0-2,1,0.09656609722222223,0.06136,109811,2160,110519,completed
889,108373,1398,1,0-2,1,0.16983679166666665,0.12116,109813,1440,111211,completed
890,108435,742,1,0-2,1,0.10005984722222225,0.0,109823,1388,110565,completed
902,109119,91,1,0-2,1,0.01424655555555556,0.007886666666666667,109839,720,109930,completed
854,105528,602,2,0-2,2,0.16542983333333333,0.10434666666666667,109848,4320,110450,completed
855,105541,797,2,0-2,2,0.20994472222222224,0.13814666666666667,109861,4320,110658,completed
904,109316,79,1,0-2,1,0.012367888888888892,0.0,109961,645,110040,completed
903,109316,1186,1,0-2,1,0.1359691388888889,0.10278666666666667,110036,720,111222,completed
905,109421,28542,1,24-48,1,2.2903513888888893,0.0,110041,620,138583,completed
906,109456,468,1,0-2,1,0.054658500000000006,0.0,110163,707,110631,completed
907,109519,74,1,0-2,1,0.008642583333333332,0.006413333333333333,110239,720,110313,completed
908,109597,3814,1,6-12,1,0.36539188888888885,0.0,110368,771,114182,completed
909,109651,78,1,0-2,1,0.009109749999999996,0.00676,110371,720,110449,completed
911,109655,86,1,0-2,1,0.01004408333333333,0.0074533333333333335,110375,720,110461,completed
910,109655,66,1,0-2,1,0.00770825,0.00572,110375,720,110441,completed
912,109740,1933,1,2-6,1,0.19183995833333334,0.0,110417,677,112350,completed
913,109785,927,1,0-2,1,0.09619854166666666,0.08034,110505,720,111432,completed
914,109861,88,1,0-2,1,0.010277666666666668,0.0,110566,705,110654,completed
915,109862,278,1,0-2,1,0.03246808333333333,0.024093333333333335,110582,720,110860,completed
916,109884,87,1,0-2,1,0.010160874999999996,0.00754,110604,720,110691,completed
917,109965,505,1,0-2,1,0.05336148611111112,0.0,110632,667,111137,completed
919,110105,100,1,0-2,1,0.011679166666666666,0.0,110655,550,110755,completed
920,110182,83,1,0-2,1,0.009693708333333332,0.0,110716,534,110799,completed
921,110362,183,1,0-2,1,0.02008306944444444,0.0,110756,394,110939,completed
922,110491,1462,1,2-6,1,0.13906625,0.0,110800,309,112262,completed
923,110601,105,1,0-2,1,0.009967708333333332,0.0,110940,339,111045,completed
924,110703,72,1,0-2,1,0.006835,0.0,111046,343,111118,completed
918,109971,6135,3,12-24,3-4,2.122141625,0.0,111147,1176,117282,completed
925,111374,402,1,0-2,1,0.036589194444444445,0.03484,112094,720,112496,completed
926,111690,1963,1,2-6,1,0.18013248611111113,0.0,112263,573,114226,completed
928,112349,550,1,0-2,1,0.04886597222222223,0.04766666666666667,112349,0,112899,completed
927,111967,3919,2,6-12,2,0.8494222777777778,0.0,112352,385,116271,completed
929,112639,1270,3,0-2,3-4,0.34542137500000003,0.3302,112639,0,113909,completed
930,112696,1214,3,0-2,3-4,0.33052533333333334,0.31564000000000003,112696,0,113910,completed
931,112702,1114,3,0-2,3-4,0.30102375000000003,0.28964,112702,0,113816,completed
933,112811,720,1,0-2,1,0.06451555555555556,0.062400000000000004,112811,0,113531,completed
935,112900,116,1,0-2,1,0.010306277777777779,0.010053333333333334,112900,0,113016,completed
936,113017,70,4,0-2,3-4,0.025086111111111115,0.024266666666666666,113017,0,113087,completed
937,113040,148,2,0-2,2,0.026627666666666668,0.025653333333333334,113040,0,113188,completed
938,113060,103,1,0-2,1,0.009265708333333329,0.008926666666666666,113060,0,113163,completed
939,113238,83,1,0-2,1,0.007466541666666667,0.007193333333333334,113238,0,113321,completed
932,112707,2483,1,2-6,1,0.2595671666666667,0.0,113242,535,115725,completed
940,113302,958,1,0-2,1,0.09067313888888891,0.08302666666666667,113302,0,114260,completed
941,113340,102,1,0-2,1,0.009175749999999996,0.00884,113340,0,113442,completed
942,113354,165,1,0-2,1,0.014843125000000002,0.0143,113354,0,113519,completed
943,113357,320,1,0-2,1,0.02878666666666667,0.027733333333333332,113357,0,113677,completed
944,113364,850,1,0-2,1,0.08054427777777778,0.07366666666666667,113364,0,114214,completed
945,113465,754,1,0-2,1,0.07195320833333334,0.06534666666666666,113465,0,114219,completed
946,113465,826,1,0-2,1,0.07907720833333334,0.07158666666666667,113465,0,114291,completed
947,113514,81,1,0-2,1,0.007286625000000001,0.00702,113514,0,113595,completed
948,113564,877,1,0-2,1,0.085013,0.07600666666666667,113564,0,114441,completed
934,112813,10423,1,12-24,1,1.0215544583333334,0.0,113642,829,124065,completed
949,113700,451,1,0-2,1,0.04408477777777778,0.0,113700,0,114151,completed
950,113809,235,1,0-2,1,0.02325194444444445,0.02036666666666667,113809,0,114044,completed
951,114110,479,1,0-2,1,0.04748825,0.04151333333333333,114110,0,114589,completed
952,114424,1265,1,0-2,1,0.1424786388888889,0.0,114424,0,115689,completed
953,114680,4967,1,6-12,1,0.6590233472222221,0.0,114680,0,119647,completed
954,114786,108,1,0-2,1,0.010778999999999999,0.0,114786,0,114894,completed
955,114816,210,1,0-2,1,0.02095916666666666,0.0182,114816,0,115026,completed
956,115124,605,1,0-2,1,0.07798630555555555,0.0,115124,0,115729,completed
957,115594,3865,1,6-12,1,0.5323264583333334,0.0,115690,96,119555,completed
958,115594,3997,1,6-12,1,0.5450424583333333,0.0,115726,132,119723,completed
959,115742,5054,1,6-12,1,0.6244343888888888,0.0,115742,0,120796,completed
960,116147,3921,2,6-12,2,1.0162746388888888,0.0,116272,125,120193,completed
961,116179,107,1,0-2,1,0.017001166666666664,0.0,117283,1104,117390,completed
962,116366,422,1,0-2,1,0.06062866666666665,0.0,117283,917,117705,completed
963,116384,504,1,0-2,1,0.07198566666666667,0.0,117283,899,117787,completed
964,116389,860,1,0-2,1,0.11394199999999996,0.0,117391,1002,118251,completed
965,116391,166,1,0-2,1,0.022990999999999994,0.0,117660,1269,117826,completed
966,116396,529,1,0-2,1,0.06858205555555555,0.0,117706,1310,118235,completed
967,116425,3654,1,6-12,1,0.3315855,0.0,117788,1363,121442,completed
968,116852,77,1,0-2,1,0.010664499999999997,0.0,117827,975,117904,completed
969,116940,82,1,0-2,1,0.011356999999999997,0.0,117905,965,117987,completed
971,118075,3567,1,6-12,1,0.302186,0.0,118075,0,121642,completed
973,118433,4988,1,6-12,1,0.3583329583333333,0.0,118433,0,123421,completed
974,118440,4831,1,6-12,1,0.3499479305555555,0.0,118440,0,123271,completed
975,118737,60,1,0-2,1,0.006252500000000002,0.0,119556,819,119616,completed
976,119044,492,1,0-2,1,0.051270500000000004,0.0,119617,573,120109,completed
977,119133,1301,1,0-2,1,0.0969443888888889,0.0,119648,515,120949,completed
980,119164,1395,1,0-2,1,0.09779975,0.0,119724,560,121119,completed
981,119416,800,1,0-2,1,0.04686097222222223,0.0,120110,694,120910,completed
978,119139,19842,2,24-48,2,2.3844426111111114,0.0,120194,1055,140036,completed
990,120214,1767,1,2-6,1,0.09178094444444446,0.15314,120214,0,121981,completed
982,119581,439,1,0-2,1,0.02182805555555556,0.038046666666666666,120301,720,120740,completed
993,120305,98,1,0-2,1,0.004872777777777778,0.008493333333333334,120305,0,120403,completed
994,120358,97,1,0-2,1,0.004823055555555556,0.008406666666666666,120358,0,120455,completed
995,120458,63,1,0-2,1,0.0031325000000000003,0.0054600000000000004,120458,0,120521,completed
983,119818,1083,1,0-2,1,0.055189527777777775,0.09386,120538,720,121621,completed
984,119826,435,1,0-2,1,0.021671750000000004,0.0377,120546,720,120981,completed
972,118415,524,3,0-2,3-4,0.07900891666666669,0.13624,120575,2160,121099,completed
979,119140,19848,2,24-48,2,2.382404222222222,3.4403200000000003,120580,1440,140428,completed
996,120649,227,1,0-2,1,0.011286944444444447,0.019673333333333334,120649,0,120876,completed
997,120665,67,1,0-2,1,0.003331388888888889,0.005806666666666667,120665,0,120732,completed
998,120678,132,1,0-2,1,0.006563333333333333,0.01144,120678,0,120810,completed
985,119964,7669,1,12-24,1,0.41664333333333337,0.6646466666666667,120684,720,128353,completed
986,119977,90,1,0-2,1,0.004475,0.0078000000000000005,120697,720,120787,completed
970,117908,197,4,0-2,3-4,0.03938388888888889,0.06829333333333333,120788,2880,120985,completed
987,120082,406,1,0-2,1,0.020679972222222225,0.0,120797,715,121203,completed
988,120092,80,1,0-2,1,0.003977777777777778,0.006933333333333333,120812,720,120892,completed
989,120141,428,1,0-2,1,0.021948250000000002,0.03709333333333333,120861,720,121289,completed
991,120215,1337,1,0-2,1,0.06991083333333332,0.0,120911,696,122248,completed
992,120215,1221,1,0-2,1,0.0638236111111111,0.10582,120935,720,122156,completed
999,120951,272,1,0-2,1,0.014057749999999999,0.0,120951,0,121223,completed
-1,0,0,0,0,0,0.0,50.315616000000006,0,0,0,0
