ID,arrival_time,length,cpus,length_class,resource_class,carbon_cost,dollar_cost,start_time,waiting_time,exit_time,reason
0,0,720,1,0-2,1,0.09614,0.01248,0,0,720,completed
1,13,200,1,0-2,1,0.02670555555555556,0.0034666666666666665,13,0,213,completed
2,92,314,3,0-2,3-4,0.12578316666666667,0.016328,92,0,406,completed
3,167,553,1,6-12,1,0.07384086111111113,0.047926666666666666,167,0,720,completed
4,397,133,1,0-2,1,0.017759194444444446,0.0023053333333333333,397,0,530,completed
6,523,125,2,0-2,2,0.03338194444444444,0.004333333333333333,523,0,648,completed
5,523,125,2,0-2,2,0.03338194444444444,0.004333333333333333,523,0,648,completed
7,587,853,1,12-24,1,0.11688919444444446,0.07392666666666667,587,0,1440,completed
8,601,839,1,12-24,1,0.11501980555555558,0.07271333333333334,601,0,1440,completed
9,810,630,3,6-12,3-4,0.2602162500000001,0.1638,810,0,1440,completed
10,958,350,2,0-2,2,0.09637638888888891,0.012133333333333333,958,0,1308,completed
11,1159,281,1,0-2,1,0.038688236111111114,0.004870666666666666,1159,0,1440,completed
12,1284,156,1,6-12,1,0.021478166666666673,0.01352,1284,0,1440,completed
13,1389,771,2,2-6,2,0.21878341666666667,0.13364,1389,0,2160,completed
14,1515,408,1,0-2,1,0.05800966666666667,0.007071999999999999,1515,0,1923,completed
15,1725,222,1,0-2,1,0.031564083333333326,0.003848,1725,0,1947,completed
16,1725,222,1,0-2,1,0.031564083333333326,0.003848,1725,0,1947,completed
17,1997,163,1,2-6,1,0.023175430555555553,0.014126666666666668,1997,0,2160,completed
18,2096,83,1,0-2,1,0.011820513888888889,0.0014386666666666667,2096,0,2179,completed
19,2253,494,1,0-2,1,0.07074491666666666,0.008562666666666666,2253,0,2747,completed
20,2299,112,1,0-2,1,0.016039333333333333,0.001941333333333333,2299,0,2411,completed
21,2555,325,1,6-12,1,0.046542708333333335,0.028166666666666666,2555,0,2880,completed
22,2660,97,1,0-2,1,0.013891208333333332,0.0016813333333333333,2660,0,2757,completed
33,4268,61,1,0-2,1,0.009221375,0.0010573333333333333,4268,0,4329,completed
23,2887,183,4,0-2,3-4,0.10503183333333337,0.012688,4320,1433,4503,completed
24,3055,65,1,0-2,1,0.009326597222222224,0.0011266666666666667,4320,1265,4385,completed
25,3134,5040,2,48+,2,1.0204,0.8736,4320,1186,9360,completed
26,3178,74,1,0-2,1,0.010617972222222225,0.0012826666666666665,4320,1142,4394,completed
27,3179,68,1,0-2,1,0.009757055555555559,0.0011786666666666666,4320,1141,4388,completed
28,3284,2472,1,2-6,1,0.25553533333333334,0.21424,4320,1036,6792,completed
29,3291,95,2,0-2,2,0.027262361111111123,0.003293333333333333,4320,1029,4415,completed
30,3349,704,1,0-2,1,0.10101422222222224,0.012202666666666665,4320,971,5024,completed
31,3487,285,3,0-2,3-4,0.12268062500000002,0.01482,4320,833,4605,completed
32,3505,2215,1,2-6,1,0.23361180555555558,0.19196666666666667,4320,815,6535,completed
34,4465,709,1,0-2,1,0.09544295833333336,0.012289333333333333,4465,0,5174,completed
35,4543,2548,1,2-6,1,0.2490442916666667,0.22082666666666667,4543,0,7091,completed
36,4712,4648,1,12-24,1,0.45395344444444446,0.40282666666666667,4712,0,9360,completed
37,4901,471,2,0-2,2,0.10400202777777777,0.016328,4901,0,5372,completed
0,0,540,1,0-2,1,0.05213999999999999,0.00936,5040,5040,5580,completed
3,167,4156,1,6-12,1,0.38672255555555557,0.36018666666666665,5040,4873,9196,completed
7,587,4320,1,12-24,1,0.40689,0.3744,5040,4453,9360,completed
8,601,4320,1,12-24,1,0.40689,0.3744,5040,4439,9360,completed
9,810,4102,3,6-12,3-4,1.140246166666667,1.06652,5040,4230,9142,completed
11,1159,284,1,0-2,1,0.027421777777777778,0.004922666666666666,5040,3881,5324,completed
12,1284,4320,1,6-12,1,0.40689,0.3744,5040,3756,9360,completed
13,1389,1663,2,2-6,2,0.28926627777777775,0.28825333333333336,5040,3651,6703,completed
17,1997,1504,1,2-6,1,0.13106955555555555,0.13034666666666667,5040,3043,6544,completed
21,2555,3063,1,6-12,1,0.2691622916666667,0.26546000000000003,5040,2485,8103,completed
38,5372,118,2,0-2,2,0.022787111111111116,0.004090666666666666,5372,0,5490,completed
39,5372,118,2,0-2,2,0.022787111111111116,0.004090666666666666,5372,0,5490,completed
40,5375,67,4,0-2,3-4,0.025876888888888887,0.004645333333333333,5375,0,5442,completed
41,5540,4093,1,6-12,1,0.4064175555555556,0.3547266666666667,5540,0,9633,completed
42,6242,427,1,0-2,1,0.03466361111111111,0.007401333333333333,6242,0,6669,completed
43,6624,320,2,0-2,2,0.05459555555555557,0.011093333333333334,6624,0,6944,completed
44,6646,707,1,0-2,1,0.06115040277777779,0.012254666666666665,6646,0,7353,completed
45,6666,2386,1,2-6,1,0.22753772222222224,0.20678666666666667,6666,0,9052,completed
46,6676,4124,1,6-12,1,0.540340111111111,0.35741333333333336,6676,0,10800,completed
47,6699,67,2,0-2,2,0.011430944444444447,0.0023226666666666665,6699,0,6766,completed
48,6819,3748,1,6-12,1,0.47969683333333335,0.32482666666666665,6819,0,10567,completed
49,6921,77,1,0-2,1,0.006568527777777779,0.0013346666666666665,6921,0,6998,completed
50,7474,3326,4,12-24,3-4,1.883052333333333,1.1530133333333334,7474,0,10800,completed
51,7487,296,1,0-2,1,0.026874333333333333,0.005130666666666666,7487,0,7783,completed
52,7691,88,3,0-2,3-4,0.023969000000000004,0.004575999999999999,7691,0,7779,completed
53,7879,2921,1,6-12,1,0.43399245833333333,0.25315333333333334,7879,0,10800,completed
54,7991,77,1,0-2,1,0.00705298611111111,0.0013346666666666665,7991,0,8068,completed
55,8059,2741,1,12-24,1,0.4175379861111111,0.23755333333333334,8059,0,10800,completed
56,8115,2685,1,12-24,1,0.4124085416666666,0.2327,8115,0,10800,completed
57,8139,2558,1,2-6,1,0.38879479166666664,0.22169333333333333,8139,0,10697,completed
58,8157,2643,1,12-24,1,0.4085614583333333,0.22906,8157,0,10800,completed
59,8170,69,1,0-2,1,0.006320208333333332,0.001196,8170,0,8239,completed
60,8215,254,1,0-2,1,0.023265694444444443,0.004402666666666667,8215,0,8469,completed
61,8229,2321,1,2-6,1,0.34998729166666664,0.20115333333333332,8229,0,10550,completed
62,8277,2523,1,12-24,1,0.3975697916666666,0.21866,8277,0,10800,completed
63,8304,2496,1,12-24,1,0.39509666666666665,0.21632,8304,0,10800,completed
64,8680,2120,1,6-12,1,0.35940111111111106,0.18373333333333333,8680,0,10800,completed
65,8791,2009,1,2-6,1,0.3457511944444444,0.17411333333333334,8791,0,10800,completed
66,9037,1763,1,12-24,1,0.31550002777777775,0.15279333333333334,9037,0,10800,completed
67,9049,1751,1,6-12,1,0.3140243611111111,0.15175333333333332,9049,0,10800,completed
68,9224,1576,1,12-24,1,0.29250422222222217,0.13658666666666666,9224,0,10800,completed
69,9287,328,1,0-2,1,0.05363030555555555,0.005685333333333333,9287,0,9615,completed
70,9317,1483,1,12-24,1,0.2810678055555555,0.12852666666666668,9317,0,10800,completed
71,9334,1466,1,12-24,1,0.27897727777777775,0.12705333333333332,9334,0,10800,completed
72,9366,756,1,0-2,1,0.1337618333333333,0.013104,9366,0,10122,completed
73,9461,1339,1,12-24,1,0.25809377777777776,0.11604666666666667,9461,0,10800,completed
74,9486,131,1,0-2,1,0.022939555555555553,0.0022706666666666665,9486,0,9617,completed
75,9489,1311,1,12-24,1,0.2531906666666666,0.11362,9489,0,10800,completed
76,9583,85,1,0-2,1,0.01488444444444444,0.0014733333333333332,9583,0,9668,completed
77,9585,69,1,0-2,1,0.012082666666666662,0.001196,9585,0,9654,completed
78,9614,117,1,0-2,1,0.020488000000000003,0.002028,9614,0,9731,completed
79,9665,1135,1,6-12,1,0.22237111111111107,0.09836666666666667,9665,0,10800,completed
80,9670,1130,3,0-2,3-4,0.6644866666666664,0.05876,9670,0,10800,completed
81,9793,1007,1,12-24,1,0.19995688888888885,0.08727333333333334,9793,0,10800,completed
82,9840,960,1,12-24,1,0.19172666666666663,0.0832,9840,0,10800,completed
83,10187,613,1,12-24,1,0.12745291666666664,0.05312666666666667,10187,0,10800,completed
84,10348,452,1,6-12,1,0.0939783333333333,0.03917333333333333,10348,0,10800,completed
85,10387,413,2,0-2,2,0.1717391666666666,0.014317333333333333,10387,0,10800,completed
86,10396,404,1,12-24,1,0.0839983333333333,0.035013333333333334,10396,0,10800,completed
87,10457,343,1,12-24,1,0.07131541666666663,0.02972666666666667,10457,0,10800,completed
88,10477,323,1,24-48,1,0.06715708333333331,0.027993333333333335,10477,0,10800,completed
80,9670,39,3,0-2,3-4,0.032734000000000006,0.002028,15120,5450,15159,completed
85,10387,905,2,0-2,2,0.5380944444444443,0.03137333333333333,15120,4733,16025,completed
89,11103,302,1,0-2,1,0.08449288888888887,0.005234666666666666,15423,4320,15725,completed
90,11213,175,1,0-2,1,0.0489611111111111,0.003033333333333333,15533,4320,15708,completed
91,11404,79,1,0-2,1,0.022102444444444442,0.0013693333333333333,15724,4320,15803,completed
92,11435,465,1,0-2,1,0.16264999999999996,0.00806,15755,4320,16220,completed
93,11821,91,1,0-2,1,0.03325544444444445,0.0015773333333333331,16141,4320,16232,completed
94,11855,68,1,0-2,1,0.024850222222222232,0.0011786666666666666,16175,4320,16243,completed
95,11860,1379,3,0-2,3-4,1.480476041666667,0.071708,16180,4320,17559,completed
96,11952,277,1,0-2,1,0.10122811111111113,0.004801333333333333,16272,4320,16549,completed
97,11979,62,1,0-2,1,0.02265755555555557,0.0010746666666666667,16299,4320,16361,completed
99,12477,220,1,0-2,1,0.07741250000000002,0.003813333333333333,16797,4320,17017,completed
110,12955,1388,3,0-2,3-4,1.545424375,0.07217599999999999,17275,4320,18663,completed
111,13242,189,1,0-2,1,0.068604375,0.003276,17562,4320,17751,completed
112,13597,1366,3,0-2,3-4,1.6841306666666669,0.071032,17917,4320,19283,completed
114,13823,61,1,0-2,1,0.02318847222222222,0.0010573333333333333,18143,4320,18204,completed
116,14272,471,2,0-2,2,0.4111319722222222,0.016328,18592,4320,19063,completed
117,14363,970,1,0-2,1,0.45874209722222214,0.016813333333333333,18683,4320,19653,completed
118,14370,67,1,0-2,1,0.028330124999999998,0.0011613333333333332,18690,4320,18757,completed
119,14525,96,1,0-2,1,0.04391599999999999,0.001664,18845,4320,18941,completed
121,14823,81,3,0-2,3-4,0.11116237499999998,0.004212,19143,4320,19224,completed
123,15017,98,1,0-2,1,0.04483091666666666,0.0016986666666666665,19337,4320,19435,completed
124,15068,1330,1,0-2,1,0.7328190833333333,0.023053333333333332,19388,4320,20718,completed
126,15263,125,1,0-2,1,0.0676684027777778,0.0021666666666666666,19583,4320,19708,completed
127,15338,105,1,0-2,1,0.05684145833333335,0.0018199999999999998,19658,4320,19763,completed
132,15766,67,1,0-2,1,0.0362702638888889,0.0011613333333333332,20086,4320,20153,completed
134,16100,884,1,0-2,1,0.46393072222222215,0.015322666666666665,20420,4320,21304,completed
136,16330,104,1,0-2,1,0.05950388888888887,0.0018026666666666666,20650,4320,20754,completed
137,16372,415,1,0-2,1,0.2150366111111111,0.007193333333333333,20692,4320,21107,completed
138,16667,292,1,0-2,1,0.13824577777777777,0.005061333333333333,20987,4320,21279,completed
139,16918,91,1,0-2,1,0.043083444444444445,0.0015773333333333331,21238,4320,21329,completed
140,16919,621,1,0-2,1,0.26415594444444446,0.010764,21239,4320,21860,completed
142,16963,60,1,0-2,1,0.02840666666666666,0.00104,21283,4320,21343,completed
144,17338,1163,1,0-2,1,0.37131591666666663,0.020158666666666665,21658,4320,22821,completed
143,17338,1175,1,0-2,1,0.37452325,0.020366666666666665,21658,4320,22833,completed
145,17338,1168,1,0-2,1,0.3726523055555555,0.02024533333333333,21658,4320,22826,completed
147,17682,861,3,0-2,3-4,0.77752375,0.044772,22002,4320,22863,completed
148,17703,378,1,0-2,1,0.128161125,0.006552,22023,4320,22401,completed
151,17888,69,1,0-2,1,0.024745125000000007,0.001196,22208,4320,22277,completed
152,17930,62,1,0-2,1,0.022234750000000008,0.0010746666666666667,22250,4320,22312,completed
153,18145,1319,1,0-2,1,0.31780538888888893,0.022862666666666667,22465,4320,23784,completed
158,18145,1042,1,0-2,1,0.2571771111111112,0.018061333333333332,22465,4320,23507,completed
159,18145,358,1,0-2,1,0.09568544444444446,0.006205333333333333,22465,4320,22823,completed
154,18145,1347,1,0-2,1,0.3231261666666667,0.023347999999999997,22465,4320,23812,completed
156,18145,949,1,0-2,1,0.2365672777777778,0.016449333333333333,22465,4320,23414,completed
155,18145,1322,1,0-2,1,0.3183754722222223,0.022914666666666667,22465,4320,23787,completed
164,18222,581,1,0-2,1,0.15149805555555557,0.010070666666666665,22542,4320,23123,completed
167,18357,1426,1,0-2,1,0.3217613611111112,0.02471733333333333,22677,4320,24103,completed
168,18471,374,2,0-2,2,0.18850711111111113,0.012965333333333332,22791,4320,23165,completed
169,18508,193,4,0-2,3-4,0.20633844444444444,0.013381333333333332,22828,4320,23021,completed
7,587,5819,1,12-24,1,1.0354811666666668,0.5043133333333334,23040,22453,28859,completed
8,601,5410,1,12-24,1,0.9383144444444445,0.46886666666666665,23040,22439,28450,completed
12,1284,948,1,6-12,1,0.2028863333333334,0.08216,23040,21756,23988,completed
46,6676,235,1,6-12,1,0.05207861111111113,0.02036666666666667,23040,16364,23275,completed
50,7474,5760,4,12-24,3-4,4.054880000000001,1.9968000000000001,23040,15566,28800,completed
53,7879,1406,1,6-12,1,0.2899190555555556,0.12185333333333334,23040,15161,24446,completed
55,8059,4610,1,12-24,1,0.7865869444444444,0.39953333333333335,23040,14981,27650,completed
56,8115,4245,1,12-24,1,0.7269835416666667,0.3679,23040,14925,27285,completed
58,8157,3537,1,12-24,1,0.622907,0.30654,23040,14883,26577,completed
62,8277,4621,1,12-24,1,0.7884291388888889,0.40048666666666666,23040,14763,27661,completed
63,8304,4790,1,12-24,1,0.8167319444444445,0.41513333333333335,23040,14736,27830,completed
64,8680,2871,1,6-12,1,0.525987375,0.24882,23040,14360,25911,completed
65,8791,72,1,2-6,1,0.015956000000000005,0.00624,23040,14249,23112,completed
66,9037,4485,1,12-24,1,0.7656529166666666,0.3887,23040,14003,27525,completed
67,9049,2635,1,6-12,1,0.4902563194444445,0.22836666666666666,23040,13991,25675,completed
68,9224,5760,1,12-24,1,1.0137200000000002,0.49920000000000003,23040,13816,28800,completed
70,9317,5760,1,12-24,1,1.0137200000000002,0.49920000000000003,23040,13723,28800,completed
71,9334,5760,1,12-24,1,1.0137200000000002,0.49920000000000003,23040,13706,28800,completed
73,9461,5274,1,12-24,1,0.909014,0.45708,23040,13579,28314,completed
75,9489,5760,1,12-24,1,1.0137200000000002,0.49920000000000003,23040,13551,28800,completed
79,9665,3852,1,6-12,1,0.6691525,0.33384,23040,13375,26892,completed
81,9793,4806,1,12-24,1,0.8194115000000001,0.41652,23040,13247,27846,completed
82,9840,5395,1,12-24,1,0.9350827777777777,0.4675666666666667,23040,13200,28435,completed
83,10187,5760,1,12-24,1,1.0137200000000002,0.49920000000000003,23040,12853,28800,completed
84,10348,2502,1,6-12,1,0.47011975000000006,0.21684,23040,12692,25542,completed
86,10396,5760,1,12-24,1,1.0137200000000002,0.49920000000000003,23040,12644,28800,completed
87,10457,5760,1,12-24,1,1.0137200000000002,0.49920000000000003,23040,12583,28800,completed
88,10477,5760,1,24-48,1,1.0137200000000002,0.49920000000000003,23040,12563,28800,completed
171,18888,157,4,0-2,3-4,0.13917177777777778,0.010885333333333332,23208,4320,23365,completed
172,18909,195,1,0-2,1,0.04321416666666668,0.0033799999999999998,23229,4320,23424,completed
173,19019,327,1,0-2,1,0.07246683333333334,0.005667999999999999,23339,4320,23666,completed
174,19063,71,1,0-2,1,0.015734388888888895,0.0012306666666666666,23383,4320,23454,completed
175,19128,880,4,0-2,3-4,0.7083137777777777,0.06101333333333333,23448,4320,24328,completed
176,19151,156,4,0-2,3-4,0.13828533333333337,0.010816,23471,4320,23627,completed
177,19153,64,1,0-2,1,0.014183111111111115,0.0011093333333333333,23473,4320,23537,completed
178,19312,230,2,0-2,2,0.09549811111111112,0.007973333333333332,23632,4320,23862,completed
213,23710,897,1,0-2,1,0.1694129444444444,0.015548,23710,0,24607,completed
214,23725,67,1,0-2,1,0.013837277777777778,0.0011613333333333332,23725,0,23792,completed
98,12054,2661,1,2-6,1,0.4406576666666666,0.23062,23760,11706,26421,completed
101,12539,3275,1,6-12,1,0.5306353472222222,0.2838333333333333,23760,11221,27035,completed
100,12539,3768,1,6-12,1,0.6065953333333334,0.32656,23760,11221,27528,completed
103,12549,1730,1,2-6,1,0.30268680555555555,0.14993333333333334,23760,11211,25490,completed
102,12549,1730,1,2-6,1,0.30268680555555555,0.14993333333333334,23760,11211,25490,completed
104,12664,5040,1,12-24,1,0.85416,0.4368,23760,11096,28800,completed
105,12851,4752,1,6-12,1,0.792112,0.41184,23760,10909,28512,completed
106,12851,4743,1,6-12,1,0.790173,0.41106,23760,10909,28503,completed
107,12852,4772,1,6-12,1,0.7964208888888888,0.41357333333333335,23760,10908,28532,completed
108,12857,4809,1,6-12,1,0.8043923333333334,0.41678,23760,10903,28569,completed
109,12877,3134,1,6-12,1,0.5098868055555554,0.2716133333333333,23760,10883,26894,completed
113,13795,1553,1,2-6,1,0.27588851388888885,0.13459333333333334,23760,9965,25313,completed
115,14245,4271,2,6-12,2,1.381667722222222,0.7403066666666667,23760,9515,28031,completed
120,14545,4946,1,6-12,1,0.8339082222222223,0.42865333333333333,23760,9215,28706,completed
122,14830,1875,1,2-6,1,0.3246402083333333,0.1625,23760,8930,25635,completed
125,15128,3727,2,6-12,2,1.1994579444444444,0.6460133333333333,23760,8632,27487,completed
128,15562,1740,1,2-6,1,0.3042008333333333,0.1508,23760,8198,25500,completed
129,15565,1927,1,2-6,1,0.33251315277777777,0.16700666666666666,23760,8195,25687,completed
130,15724,3285,1,6-12,1,0.532106875,0.2847,23760,8036,27045,completed
131,15730,3684,1,6-12,1,0.5925276666666666,0.31928,23760,8030,27444,completed
133,15873,5040,1,24-48,1,0.85416,0.4368,23760,7887,28800,completed
135,16234,2495,1,2-6,1,0.4165138888888889,0.21623333333333333,23760,7526,26255,completed
141,16929,5040,2,12-24,2,1.70832,0.8736,23760,6831,28800,completed
146,17611,2681,1,2-6,1,0.4435665555555555,0.23235333333333333,23760,6149,26441,completed
149,17795,1518,1,2-6,1,0.27058941666666664,0.13156,23760,5965,25278,completed
150,17871,2813,1,2-6,1,0.46276522222222216,0.24379333333333333,23760,5889,26573,completed
157,18145,1479,1,2-6,1,0.26468470833333335,0.12818,23760,5615,25239,completed
161,18146,1643,1,2-6,1,0.28951476388888886,0.14239333333333334,23760,5614,25403,completed
160,18146,1686,1,2-6,1,0.2960250833333333,0.14612,23760,5614,25446,completed
162,18172,1862,1,2-6,1,0.3226719722222222,0.16137333333333334,23760,5588,25622,completed
163,18178,1994,1,2-6,1,0.3426571388888889,0.17281333333333335,23760,5582,25754,completed
165,18273,1440,1,2-6,1,0.25878,0.12480000000000001,23760,5487,25200,completed
166,18309,1759,1,2-6,1,0.30707748611111113,0.15244666666666667,23760,5451,25519,completed
170,18652,5040,3,12-24,3-4,2.56248,1.3104,23760,5108,28800,completed
179,19580,255,4,0-2,3-4,0.19382833333333332,0.017679999999999998,23760,4180,24015,completed
180,19717,80,1,0-2,1,0.015202222222222221,0.0013866666666666667,23760,4043,23840,completed
181,19736,176,1,0-2,1,0.033444888888888885,0.0030506666666666664,23760,4024,23936,completed
182,19900,375,1,0-2,1,0.07126041666666666,0.0065,23760,3860,24135,completed
183,19962,388,1,0-2,1,0.07373077777777777,0.006725333333333333,23760,3798,24148,completed
184,19996,103,1,0-2,1,0.019572861111111114,0.0017853333333333332,23760,3764,23863,completed
185,20036,5040,1,12-24,1,0.85416,0.4368,23760,3724,28800,completed
186,20149,440,1,0-2,1,0.0836122222222222,0.007626666666666666,23760,3611,24200,completed
187,20173,261,1,0-2,1,0.049597249999999996,0.004523999999999999,23760,3587,24021,completed
188,20527,93,1,0-2,1,0.017672583333333335,0.001612,23760,3233,23853,completed
189,20538,884,1,0-2,1,0.16459977777777776,0.015322666666666665,23760,3222,24644,completed
190,20543,1531,1,2-6,1,0.27255765277777777,0.13268666666666667,23760,3217,25291,completed
191,20566,1466,1,2-6,1,0.2627164722222222,0.12705333333333332,23760,3194,25226,completed
192,20837,5040,1,12-24,1,0.85416,0.4368,23760,2923,28800,completed
193,21039,5040,2,24-48,2,1.70832,0.8736,23760,2721,28800,completed
194,21484,69,1,0-2,1,0.013111916666666671,0.001196,23760,2276,23829,completed
195,21563,745,1,0-2,1,0.1410547222222222,0.012913333333333332,23760,2197,24505,completed
196,21591,610,1,0-2,1,0.11591694444444445,0.010573333333333332,23760,2169,24370,completed
197,21637,784,1,0-2,1,0.1476608888888889,0.013589333333333332,23760,2123,24544,completed
198,21673,782,1,0-2,1,0.1473221111111111,0.013554666666666666,23760,2087,24542,completed
199,21778,1145,1,0-2,1,0.20881027777777775,0.019846666666666665,23760,1982,24905,completed
200,21946,611,1,0-2,1,0.11610697222222222,0.010590666666666667,23760,1814,24371,completed
201,22124,84,1,0-2,1,0.015962333333333335,0.0014559999999999998,23760,1636,23844,completed
202,22438,277,1,0-2,1,0.05263769444444445,0.004801333333333333,23760,1322,24037,completed
204,22509,122,1,0-2,1,0.023183388888888885,0.0021146666666666666,23760,1251,23882,completed
203,22509,78,1,0-2,1,0.014822166666666671,0.001352,23760,1251,23838,completed
205,22647,224,1,0-2,1,0.042566222222222214,0.003882666666666666,23760,1113,23984,completed
206,22818,61,1,0-2,1,0.01159169444444445,0.0010573333333333333,23760,942,23821,completed
207,22888,1607,1,2-6,1,0.28406426388888883,0.13927333333333333,23760,872,25367,completed
208,22931,197,1,0-2,1,0.037435472222222224,0.0034146666666666665,23760,829,23957,completed
209,22988,199,1,0-2,1,0.037815527777777774,0.0034493333333333333,23760,772,23959,completed
210,23087,542,1,0-2,1,0.10299505555555555,0.009394666666666666,23760,673,24302,completed
211,23227,2388,1,2-6,1,0.4009513333333333,0.20696,23760,533,26148,completed
212,23478,251,1,0-2,1,0.04769697222222222,0.004350666666666667,23760,282,24011,completed
215,23773,3220,4,6-12,3-4,2.087938277777778,1.1162666666666667,23773,0,26993,completed
216,23810,879,1,0-2,1,0.16272088888888886,0.015236,23810,0,24689,completed
217,23906,337,1,0-2,1,0.06403936111111111,0.005841333333333333,23906,0,24243,completed
218,24058,65,1,0-2,1,0.012351805555555557,0.0011266666666666667,24058,0,24123,completed
219,24289,203,1,0-2,1,0.038327972222222215,0.0035186666666666665,24289,0,24492,completed
220,24359,96,1,0-2,1,0.018242666666666664,0.001664,24359,0,24455,completed
221,24363,87,1,0-2,1,0.01653241666666667,0.001508,24363,0,24450,completed
36,4712,1291,1,12-24,1,0.2084109861111111,0.11188666666666666,24480,19768,25771,completed
222,24481,378,1,0-2,1,0.064029,0.006552,24481,0,24859,completed
223,24590,1898,1,2-6,1,0.29494966666666667,0.16449333333333332,24590,0,26488,completed
224,24763,4037,1,48+,1,0.6694029444444445,0.3498733333333333,24763,0,28800,completed
225,24890,103,1,0-2,1,0.017447055555555556,0.0017853333333333332,24890,0,24993,completed
226,25081,67,1,0-2,1,0.011349055555555555,0.0011613333333333332,25081,0,25148,completed
227,25100,3700,1,24-48,1,0.6123188888888889,0.32066666666666666,25100,0,28800,completed
228,25104,3696,1,12-24,1,0.6116413333333334,0.32032,25104,0,28800,completed
229,25139,3460,1,6-12,1,0.5624083888888889,0.29986666666666667,25139,0,28599,completed
25,3134,2160,2,48+,2,0.6393599999999999,0.3744,25200,22066,27360,completed
230,25585,1313,1,0-2,1,0.1934053472222222,0.022758666666666667,25585,0,26898,completed
232,25598,189,2,0-2,2,0.05723025000000001,0.006552,25598,0,25787,completed
231,25598,189,2,0-2,2,0.05723025000000001,0.006552,25598,0,25787,completed
233,25676,3049,1,6-12,1,0.5071539444444444,0.2642466666666667,25676,0,28725,completed
234,25678,125,1,0-2,1,0.018925347222222225,0.0021666666666666666,25678,0,25803,completed
235,25725,83,2,0-2,2,0.025132861111111116,0.0028773333333333333,25725,0,25808,completed
236,26334,88,1,0-2,1,0.012799111111111108,0.0015253333333333332,26334,0,26422,completed
237,26539,534,1,0-2,1,0.07840704166666665,0.009255999999999999,26539,0,27073,completed
238,26542,2258,1,6-12,1,0.39590355555555556,0.19569333333333333,26542,0,28800,completed
239,26559,592,1,0-2,1,0.08697606944444444,0.010261333333333332,26559,0,27151,completed
240,26611,73,1,0-2,1,0.01069261111111111,0.0012653333333333332,26611,0,26684,completed
241,26639,197,1,0-2,1,0.028987388888888882,0.0034146666666666665,26639,0,26836,completed
242,26777,143,1,0-2,1,0.021042847222222216,0.0024786666666666663,26777,0,26920,completed
243,26797,231,1,0-2,1,0.03399229166666666,0.004004,26797,0,27028,completed
244,26884,67,1,0-2,1,0.009859236111111109,0.0011613333333333332,26884,0,26951,completed
245,26885,65,1,0-2,1,0.009564930555555554,0.0011266666666666667,26885,0,26950,completed
246,26889,283,1,0-2,1,0.04164423611111111,0.004905333333333333,26889,0,27172,completed
247,26892,107,1,0-2,1,0.01574534722222222,0.0018546666666666666,26892,0,26999,completed
248,26993,784,1,0-2,1,0.12384098611111112,0.013589333333333332,26993,0,27777,completed
249,27169,459,1,0-2,1,0.0729887361111111,0.007956,27169,0,27628,completed
250,27246,67,1,0-2,1,0.009859236111111109,0.0011613333333333332,27246,0,27313,completed
251,27251,114,1,0-2,1,0.016877013888888886,0.001976,27251,0,27365,completed
252,27321,949,1,0-2,1,0.16725340277777778,0.016449333333333333,27321,0,28270,completed
253,27340,1460,1,2-6,1,0.2786430555555556,0.12653333333333333,27340,0,28800,completed
25,3134,27371,2,48+,2,17.593842861111114,4.744306666666667,27614,24480,54985,completed
254,27826,974,2,2-6,2,0.3953158888888889,0.16882666666666668,27826,0,28800,completed
255,27921,879,1,0-2,1,0.18174808333333334,0.015236,27921,0,28800,completed
256,28282,518,1,0-2,1,0.11160022222222223,0.008978666666666666,28282,0,28800,completed
257,28287,513,1,0-2,1,0.110523,0.008891999999999999,28287,0,28800,completed
258,28360,133,1,0-2,1,0.02865411111111112,0.0023053333333333333,28360,0,28493,completed
259,28672,128,1,0-2,1,0.027576888888888887,0.0022186666666666665,28672,0,28800,completed
255,27921,336,1,0-2,1,0.1714673333333333,0.005823999999999999,33120,5199,33456,completed
256,28282,280,1,0-2,1,0.14288944444444443,0.004853333333333333,33120,4838,33400,completed
257,28287,240,1,0-2,1,0.12247666666666665,0.00416,33120,4833,33360,completed
259,28672,947,1,0-2,1,0.48089847222222215,0.016414666666666664,33120,4448,34067,completed
260,28863,317,1,0-2,1,0.16177126388888888,0.005494666666666666,33183,4320,33500,completed
262,29069,1100,4,0-2,3-4,2.2182557222222217,0.07626666666666666,33389,4320,34489,completed
263,29169,160,1,0-2,1,0.0816511111111111,0.0027733333333333334,33489,4320,33649,completed
264,29282,1011,3,0-2,3-4,1.532143041666666,0.052571999999999994,33602,4320,34613,completed
265,29298,70,1,0-2,1,0.035722361111111094,0.0012133333333333332,33618,4320,33688,completed
266,29466,77,1,0-2,1,0.03905405555555555,0.0013346666666666665,33786,4320,33863,completed
50,7474,2362,4,12-24,3-4,5.0290215555555555,0.8188266666666667,33840,26366,36202,completed
68,9224,2024,1,12-24,1,1.0737168888888888,0.17541333333333334,33840,24616,35864,completed
70,9317,2352,1,12-24,1,1.2518006666666666,0.20384,33840,24523,36192,completed
71,9334,2829,1,12-24,1,1.5119909166666665,0.24518,33840,24506,36669,completed
75,9489,25,1,12-24,1,0.012496527777777777,0.0021666666666666666,33840,24351,33865,completed
83,10187,1945,1,12-24,1,1.0311073611111108,0.16856666666666667,33840,23653,35785,completed
86,10396,3140,1,12-24,1,1.6904980555555555,0.27213333333333334,33840,23444,36980,completed
87,10457,975,1,12-24,1,0.5011522916666665,0.0845,33840,23383,34815,completed
88,10477,6524,1,24-48,1,3.2589586666666666,0.5654133333333333,33840,23363,40364,completed
268,29728,247,1,0-2,1,0.12346569444444438,0.004281333333333333,34048,4320,34295,completed
270,29934,288,1,0-2,1,0.14395999999999998,0.004992,34254,4320,34542,completed
271,29949,186,1,0-2,1,0.09297416666666664,0.003224,34269,4320,34455,completed
272,30024,284,1,0-2,1,0.14563727777777777,0.004922666666666666,34344,4320,34628,completed
273,30093,457,1,0-2,1,0.24519805555555557,0.007921333333333332,34413,4320,34870,completed
275,30345,124,1,0-2,1,0.0686873888888889,0.0021493333333333334,34665,4320,34789,completed
276,30346,324,1,0-2,1,0.17947350000000004,0.0056159999999999995,34666,4320,34990,completed
277,30347,142,1,0-2,1,0.0786581388888889,0.002461333333333333,34667,4320,34809,completed
278,30349,123,1,0-2,1,0.06813345833333334,0.0021319999999999998,34669,4320,34792,completed
279,30353,370,1,0-2,1,0.2049543055555556,0.0064133333333333325,34673,4320,35043,completed
280,30629,586,1,0-2,1,0.3208880972222222,0.010157333333333332,34949,4320,35535,completed
104,12664,741,1,12-24,1,0.4039791388888889,0.06422,34984,22320,35725,completed
282,31235,110,1,0-2,1,0.0593297222222222,0.0019066666666666665,35555,4320,35665,completed
283,31921,268,1,0-2,1,0.1461865555555556,0.004645333333333333,36241,4320,36509,completed
284,32262,1421,1,0-2,1,0.8172832361111109,0.024630666666666665,36582,4320,38003,completed
285,32302,67,1,0-2,1,0.0365466388888889,0.0011613333333333332,36622,4320,36689,completed
287,32401,403,1,0-2,1,0.23356648611111103,0.006985333333333333,36721,4320,37124,completed
288,32442,68,1,0-2,1,0.0394107222222222,0.0011786666666666666,36762,4320,36830,completed
289,32572,127,2,0-2,2,0.14721063888888883,0.004402666666666667,36892,4320,37019,completed
291,32694,108,1,0-2,1,0.06259349999999997,0.001872,37014,4320,37122,completed
292,33074,95,2,0-2,2,0.10984324999999995,0.003293333333333333,37394,4320,37489,completed
293,33083,95,2,0-2,2,0.10979274999999997,0.003293333333333333,37403,4320,37498,completed
294,33652,190,1,0-2,1,0.1094236111111111,0.003293333333333333,37972,4320,38162,completed
295,33694,82,1,0-2,1,0.04729463888888888,0.0014213333333333333,38014,4320,38096,completed
296,33771,77,1,0-2,1,0.043764708333333346,0.0013346666666666665,38091,4320,38168,completed
297,33838,68,4,0-2,3-4,0.13555811111111116,0.0047146666666666665,38158,4320,38226,completed
133,15873,17253,1,24-48,1,4.2271980000000005,1.49526,38193,22320,55446,completed
298,33978,91,3,0-2,3-4,0.13540800000000003,0.004732,38298,4320,38389,completed
300,34153,65,1,0-2,1,0.032240000000000005,0.0011266666666666667,38473,4320,38538,completed
301,34156,83,2,0-2,2,0.08233600000000002,0.0028773333333333333,38476,4320,38559,completed
302,34382,133,1,0-2,1,0.06596800000000003,0.0023053333333333333,38702,4320,38835,completed
304,34486,1338,1,0-2,1,0.4904071111111112,0.023191999999999997,38806,4320,40144,completed
305,34840,62,1,0-2,1,0.021992777777777778,0.0010746666666666667,39160,4320,39222,completed
141,16929,1382,2,12-24,2,0.9380393333333334,0.23954666666666666,39249,22320,40631,completed
306,35170,62,1,0-2,1,0.021992777777777778,0.0010746666666666667,39490,4320,39552,completed
307,35197,67,1,0-2,1,0.023766388888888892,0.0011613333333333332,39517,4320,39584,completed
309,35609,1228,1,0-2,1,0.35452048611111114,0.021285333333333333,39929,4320,41157,completed
310,35609,1047,1,0-2,1,0.3156050277777778,0.018147999999999997,39929,4320,40976,completed
313,35610,1108,1,0-2,1,0.3315981666666667,0.01920533333333333,39930,4320,41038,completed
312,35610,1122,1,0-2,1,0.33438533333333337,0.019448,39930,4320,41052,completed
315,35760,69,1,0-2,1,0.02515241666666666,0.001196,40080,4320,40149,completed
316,35765,721,1,0-2,1,0.2138870277777778,0.012497333333333333,40085,4320,40806,completed
317,36083,192,1,0-2,1,0.05065600000000001,0.003328,40403,4320,40595,completed
318,36201,63,1,0-2,1,0.016621500000000004,0.0010919999999999999,40521,4320,40584,completed
321,36280,801,1,0-2,1,0.18405995833333333,0.013883999999999999,40600,4320,41401,completed
323,36471,658,4,0-2,3-4,0.5708231666666668,0.04562133333333333,40791,4320,41449,completed
324,36530,282,1,0-2,1,0.06745116666666667,0.004888,40850,4320,41132,completed
325,36581,217,2,0-2,2,0.10271916666666667,0.007522666666666666,40901,4320,41118,completed
170,18652,4300,3,12-24,3-4,2.5780233333333333,1.118,40972,22320,45272,completed
326,36684,94,1,0-2,1,0.02041891666666666,0.0016293333333333333,41004,4320,41098,completed
185,20036,3600,1,12-24,1,0.69432,0.312,41040,21004,44640,completed
192,20837,3600,1,12-24,1,0.69432,0.312,41040,20203,44640,completed
193,21039,3600,2,24-48,2,1.38864,0.624,41040,20001,44640,completed
224,24763,21600,1,48+,1,4.28458,1.872,41040,16277,62640,completed
227,25100,9019,1,24-48,1,1.9581330833333335,0.7816466666666667,41040,15940,50059,completed
228,25104,7472,1,12-24,1,1.6031282222222223,0.6475733333333333,41040,15936,48512,completed
238,26542,2855,1,6-12,1,0.5309852083333333,0.24743333333333334,41040,14498,43895,completed
253,27340,625,1,2-6,1,0.11768229166666666,0.05416666666666667,41040,13700,41665,completed
254,27826,866,2,2-6,2,0.32161138888888885,0.15010666666666667,41040,13214,41906,completed
261,28962,4050,1,6-12,1,0.799045,0.351,41040,12078,45090,completed
267,29723,5040,1,24-48,1,1.03026,0.4368,41040,11317,46080,completed
269,29797,1819,2,2-6,2,0.6591224722222222,0.3152933333333333,41040,11243,42859,completed
274,30204,1703,1,2-6,1,0.3082768472222222,0.14759333333333333,41040,10836,42743,completed
281,30697,3049,4,6-12,3-4,2.292583666666667,1.0569866666666667,41040,10343,44089,completed
286,32304,2799,1,2-6,1,0.5197968749999999,0.24258000000000002,41040,8736,43839,completed
290,32670,2561,4,2-6,3-4,1.8889858333333331,0.8878133333333333,41040,8370,43601,completed
299,34091,2289,1,2-6,1,0.41790312500000004,0.19838,41040,6949,43329,completed
303,34398,3600,2,24-48,2,1.38864,0.624,41040,6642,44640,completed
308,35461,1514,1,2-6,1,0.27359797222222226,0.13121333333333335,41040,5579,42554,completed
311,35610,1576,1,2-6,1,0.2849741111111111,0.13658666666666666,41040,5430,42616,completed
314,35613,2060,1,2-6,1,0.3737813888888889,0.17853333333333335,41040,5427,43100,completed
319,36204,2880,1,6-12,1,0.53598,0.24960000000000002,41040,4836,43920,completed
320,36269,2678,1,2-6,1,0.4956220833333333,0.23209333333333335,41040,4771,43718,completed
322,36435,2880,1,6-12,1,0.53598,0.24960000000000002,41040,4605,43920,completed
327,36816,2880,3,6-12,3-4,1.6079400000000001,0.7488,41040,4224,43920,completed
328,37065,2880,1,24-48,1,0.53598,0.24960000000000002,41040,3975,43920,completed
329,37107,2880,1,6-12,1,0.53598,0.24960000000000002,41040,3933,43920,completed
330,37189,2880,3,6-12,3-4,1.6079400000000001,0.7488,41040,3851,43920,completed
331,37335,2880,1,12-24,1,0.53598,0.24960000000000002,41040,3705,43920,completed
332,37535,242,1,0-2,1,0.04556658333333332,0.004194666666666666,41040,3505,41282,completed
333,37640,120,1,0-2,1,0.022594999999999994,0.00208,41040,3400,41160,completed
334,38060,2880,2,12-24,2,1.07196,0.49920000000000003,41040,2980,43920,completed
335,38128,1022,1,0-2,1,0.18776986111111107,0.017714666666666667,41040,2912,42062,completed
336,38669,1576,1,2-6,1,0.2849741111111111,0.13658666666666666,41040,2371,42616,completed
337,38721,1060,1,0-2,1,0.19433805555555553,0.018373333333333332,41040,2319,42100,completed
338,38746,2142,2,2-6,2,0.7776544999999999,0.37128,41040,2294,43182,completed
339,38843,136,1,0-2,1,0.025607666666666667,0.0023573333333333332,41040,2197,41176,completed
340,38845,327,1,0-2,1,0.061571375,0.005667999999999999,41040,2195,41367,completed
341,38894,870,1,0-2,1,0.16149708333333332,0.01508,41040,2146,41910,completed
342,38982,1575,1,2-6,1,0.284790625,0.1365,41040,2058,42615,completed
343,39034,1058,1,0-2,1,0.19399236111111107,0.018338666666666666,41040,2006,42098,completed
344,39119,2880,1,6-12,1,0.53598,0.24960000000000002,41040,1921,43920,completed
346,39130,2880,1,6-12,1,0.53598,0.24960000000000002,41040,1910,43920,completed
345,39130,2880,1,6-12,1,0.53598,0.24960000000000002,41040,1910,43920,completed
347,39155,1284,1,0-2,1,0.23305583333333335,0.022255999999999998,41040,1885,42324,completed
348,39174,93,1,0-2,1,0.017511125,0.001612,41040,1866,41133,completed
349,39185,2539,2,2-6,2,0.9357020833333333,0.44009333333333334,41040,1855,43579,completed
350,39237,743,1,0-2,1,0.13954548611111112,0.012878666666666667,41040,1803,41783,completed
351,39247,773,1,0-2,1,0.14473090277777778,0.013398666666666666,41040,1793,41813,completed
352,39249,1697,1,2-6,1,0.30717593055555553,0.14707333333333333,41040,1791,42737,completed
353,39363,759,1,0-2,1,0.14231104166666667,0.013156,41040,1677,41799,completed
354,39371,409,1,0-2,1,0.07701129166666665,0.007089333333333333,41040,1669,41449,completed
355,39403,1236,1,0-2,1,0.22475916666666668,0.021424,41040,1637,42276,completed
356,39481,462,1,0-2,1,0.08699074999999998,0.008008,41040,1559,41502,completed
357,39491,437,1,0-2,1,0.08228345833333331,0.007574666666666666,41040,1549,41477,completed
358,39886,65,1,0-2,1,0.012238958333333333,0.0011266666666666667,41040,1154,41105,completed
359,39922,780,2,0-2,2,0.2918816666666667,0.027039999999999998,41040,1118,41820,completed
360,40319,141,1,0-2,1,0.026549125,0.002444,41040,721,41181,completed
361,40724,1134,1,0-2,1,0.20712875,0.019656,41040,316,42174,completed
362,40724,1134,1,0-2,1,0.20712875,0.019656,41040,316,42174,completed
363,41001,173,1,0-2,1,0.032574458333333334,0.0029986666666666664,41040,39,41213,completed
364,41001,205,1,0-2,1,0.03859979166666666,0.0035533333333333333,41040,39,41245,completed
365,41312,160,1,0-2,1,0.030126666666666666,0.0027733333333333334,41312,0,41472,completed
366,41325,150,1,0-2,1,0.028243749999999998,0.0026,41325,0,41475,completed
367,41325,150,1,0-2,1,0.028243749999999998,0.0026,41325,0,41475,completed
368,41387,1487,1,2-6,1,0.26697631944444444,0.12887333333333334,41387,0,42874,completed
369,41607,1107,1,0-2,1,0.196194375,0.019188,41607,0,42714,completed
370,42489,1431,1,6-12,1,0.274308625,0.12402,42489,0,43920,completed
371,42594,1326,1,6-12,1,0.2550425833333333,0.11492000000000001,42594,0,43920,completed
372,42783,1137,1,2-6,1,0.22036370833333332,0.09854,42783,0,43920,completed
373,42786,1134,1,6-12,1,0.21981325,0.09828,42786,0,43920,completed
374,43771,149,1,6-12,1,0.02976895833333333,0.012913333333333334,43771,0,43920,completed
375,43891,29,1,0-2,1,0.005793958333333333,0.0005026666666666667,43891,0,43920,completed
376,43891,29,2,0-2,2,0.011587916666666667,0.0010053333333333333,43891,0,43920,completed
377,43910,10,1,0-2,1,0.0019979166666666665,0.00017333333333333334,43910,0,43920,completed
185,20036,2377,1,12-24,1,0.5617511111111112,0.20600666666666667,45956,25920,48333,completed
192,20837,2296,1,12-24,1,0.5175069027777778,0.19898666666666667,46757,25920,49053,completed
193,21039,22629,2,24-48,2,8.485103416666668,3.92236,46959,25920,69588,completed
267,29723,2880,1,24-48,1,0.64859,0.24960000000000002,47520,17797,50400,completed
303,34398,1440,2,24-48,2,0.62526,0.24960000000000002,47520,13122,48960,completed
319,36204,343,1,6-12,1,0.07206334722222223,0.02972666666666667,47520,11316,47863,completed
322,36435,720,1,6-12,1,0.15127000000000002,0.062400000000000004,47520,11085,48240,completed
327,36816,720,3,6-12,3-4,0.45381000000000005,0.1872,47520,10704,48240,completed
328,37065,720,1,24-48,1,0.15127000000000002,0.062400000000000004,47520,10455,48240,completed
329,37107,720,1,6-12,1,0.15127000000000002,0.062400000000000004,47520,10413,48240,completed
330,37189,720,3,6-12,3-4,0.45381000000000005,0.1872,47520,10331,48240,completed
331,37335,720,1,12-24,1,0.15127000000000002,0.062400000000000004,47520,10185,48240,completed
334,38060,720,2,12-24,2,0.30254000000000003,0.12480000000000001,47520,9460,48240,completed
375,43891,126,1,0-2,1,0.02823800000000001,0.0021839999999999997,48240,4349,48366,completed
376,43891,1121,2,0-2,2,0.5055982777777779,0.03886133333333333,48240,4349,49361,completed
377,43910,170,1,0-2,1,0.03809888888888889,0.0029466666666666664,48240,4330,48410,completed
378,43982,171,2,0-2,2,0.07664600000000002,0.005927999999999999,48302,4320,48473,completed
379,44138,140,1,0-2,1,0.03137555555555556,0.0024266666666666664,48458,4320,48598,completed
381,44214,1049,1,0-2,1,0.23753263888888893,0.018182666666666666,48534,4320,49583,completed
382,44268,198,1,0-2,1,0.04437400000000001,0.0034319999999999997,48588,4320,48786,completed
383,44357,786,1,0-2,1,0.1781214166666667,0.013623999999999999,48677,4320,49463,completed
384,44409,949,1,0-2,1,0.21549361111111118,0.016449333333333333,48729,4320,49678,completed
385,44459,1168,1,0-2,1,0.26844586111111113,0.02024533333333333,48779,4320,49947,completed
386,44536,824,1,0-2,1,0.1874875555555556,0.014282666666666666,48856,4320,49680,completed
387,44538,185,1,0-2,1,0.04178563888888889,0.0032066666666666663,48858,4320,49043,completed
388,44818,689,1,0-2,1,0.15866280555555556,0.011942666666666666,49138,4320,49827,completed
390,44963,535,1,0-2,1,0.12345152777777779,0.009273333333333333,49283,4320,49818,completed
391,45053,472,1,0-2,1,0.10937077777777779,0.008181333333333332,49373,4320,49845,completed
392,45193,394,1,0-2,1,0.09223905555555556,0.006829333333333333,49513,4320,49907,completed
393,45295,1179,1,0-2,1,0.28576941666666666,0.020436,49615,4320,50794,completed
394,45498,1080,1,0-2,1,0.2641993333333333,0.01872,49818,4320,50898,completed
395,45499,847,1,0-2,1,0.20556763888888888,0.014681333333333333,49819,4320,50666,completed
396,45622,356,1,0-2,1,0.08493566666666666,0.006170666666666666,49942,4320,50298,completed
398,45710,292,1,0-2,1,0.06966633333333333,0.005061333333333333,50030,4320,50322,completed
399,45711,281,1,0-2,1,0.06704191666666666,0.004870666666666666,50031,4320,50312,completed
400,45732,848,1,0-2,1,0.20887422222222224,0.014698666666666665,50052,4320,50900,completed
402,45862,294,1,0-2,1,0.07113994444444444,0.005096,50182,4320,50476,completed
403,46142,593,1,0-2,1,0.14925480555555554,0.010278666666666667,50462,4320,51055,completed
404,46424,350,1,0-2,1,0.08809305555555555,0.006066666666666666,50744,4320,51094,completed
407,46720,71,2,0-2,2,0.03574061111111109,0.002461333333333333,51040,4320,51111,completed
267,29723,11520,1,24-48,1,2.06387,0.9984000000000001,51120,21397,62640,completed
408,47229,187,1,0-2,1,0.04411122222222221,0.003241333333333333,51549,4320,51736,completed
409,47241,72,1,0-2,1,0.016983999999999996,0.001248,51561,4320,51633,completed
303,34398,2880,2,24-48,2,1.24462,0.49920000000000003,51840,17442,54720,completed
410,47700,817,1,0-2,1,0.17795126388888888,0.014161333333333333,52020,4320,52837,completed
412,47824,111,1,0-2,1,0.024967291666666655,0.001924,52144,4320,52255,completed
413,47910,61,1,0-2,1,0.01372076388888889,0.0010573333333333333,52230,4320,52291,completed
415,48123,63,1,0-2,1,0.014170625000000003,0.0010919999999999999,52443,4320,52506,completed
416,48154,199,2,0-2,2,0.08477636111111109,0.006898666666666667,52474,4320,52673,completed
322,36435,1440,1,6-12,1,0.29656000000000005,0.12480000000000001,52560,16125,54000,completed
327,36816,1114,3,6-12,3-4,0.6862967500000001,0.28964,52560,15744,53674,completed
328,37065,1440,1,24-48,1,0.29656000000000005,0.12480000000000001,52560,15495,54000,completed
329,37107,11,1,6-12,1,0.0022432361111111116,0.0009533333333333334,52560,15453,52571,completed
330,37189,1440,3,6-12,3-4,0.8896800000000001,0.3744,52560,15371,54000,completed
331,37335,1440,1,12-24,1,0.29656000000000005,0.12480000000000001,52560,15225,54000,completed
334,38060,1440,2,12-24,2,0.5931200000000001,0.24960000000000002,52560,14500,54000,completed
344,39119,623,1,6-12,1,0.12704873611111112,0.05399333333333334,52560,13441,53183,completed
345,39130,1440,1,6-12,1,0.29656000000000005,0.12480000000000001,52560,13430,54000,completed
346,39130,1440,1,6-12,1,0.29656000000000005,0.12480000000000001,52560,13430,54000,completed
417,48606,112,1,0-2,1,0.022840222222222227,0.001941333333333333,52926,4320,53038,completed
418,48670,137,1,0-2,1,0.027938486111111112,0.0023746666666666664,52990,4320,53127,completed
420,48927,94,1,0-2,1,0.019415166666666678,0.0016293333333333333,53247,4320,53341,completed
421,49475,449,1,0-2,1,0.09814145833333333,0.007782666666666666,53795,4320,54244,completed
422,49515,607,3,0-2,3-4,0.404604375,0.031563999999999995,53835,4320,54442,completed
423,49616,589,3,0-2,3-4,0.3982405,0.030628,53936,4320,54525,completed
424,49690,1004,3,0-2,3-4,0.6860017499999999,0.052208,54010,4320,55014,completed
425,49978,169,1,0-2,1,0.038447499999999996,0.0029293333333333333,54298,4320,54467,completed
426,49982,138,1,0-2,1,0.031395,0.002392,54302,4320,54440,completed
427,50035,126,1,0-2,1,0.028664999999999986,0.0021839999999999997,54355,4320,54481,completed
428,50136,123,1,0-2,1,0.02798249999999999,0.0021319999999999998,54456,4320,54579,completed
429,50677,127,1,0-2,1,0.02900362499999999,0.0022013333333333334,54997,4320,55124,completed
430,50698,377,1,0-2,1,0.086097375,0.006534666666666666,55018,4320,55395,completed
303,34398,7200,2,24-48,2,2.21458,1.248,55440,21042,62640,completed
433,51206,126,4,0-2,3-4,0.11222399999999996,0.008735999999999999,55526,4320,55652,completed
435,51572,107,3,0-2,3-4,0.07147599999999998,0.0055639999999999995,55892,4320,55999,completed
436,51611,856,2,0-2,2,0.2765834166666666,0.029674666666666665,55931,4320,56787,completed
437,51799,92,1,0-2,1,0.016230374999999995,0.0015946666666666665,56119,4320,56211,completed
322,36435,246,1,6-12,1,0.03425208333333332,0.02132,56160,19725,56406,completed
328,37065,6480,1,24-48,1,0.9469700000000001,0.5616,56160,19095,62640,completed
330,37189,375,3,6-12,3-4,0.15664062499999998,0.0975,56160,18971,56535,completed
331,37335,4857,1,12-24,1,0.6615870416666667,0.42094,56160,18825,61017,completed
334,38060,3216,2,12-24,2,0.8935586666666668,0.55744,56160,18100,59376,completed
346,39130,514,1,6-12,1,0.0715673611111111,0.044546666666666665,56160,17030,56674,completed
345,39130,514,1,6-12,1,0.0715673611111111,0.044546666666666665,56160,17030,56674,completed
370,42489,2230,1,6-12,1,0.3277502777777778,0.19326666666666667,56160,13671,58390,completed
371,42594,3259,1,6-12,1,0.4513761527777778,0.2824466666666667,56160,13566,59419,completed
372,42783,1519,1,2-6,1,0.21383625,0.13164666666666666,56160,13377,57679,completed
373,42786,1875,1,6-12,1,0.27213125,0.1625,56160,13374,58035,completed
374,43771,4497,1,6-12,1,0.6129320416666668,0.38974000000000003,56160,12389,60657,completed
380,44187,1440,1,6-12,1,0.2009,0.12480000000000001,56160,11973,57600,completed
389,44928,1440,1,12-24,1,0.2009,0.12480000000000001,56160,11232,57600,completed
397,45674,1440,1,2-6,1,0.2009,0.12480000000000001,56160,10486,57600,completed
401,45811,1440,1,24-48,1,0.2009,0.12480000000000001,56160,10349,57600,completed
405,46610,1440,4,12-24,3-4,0.8036,0.49920000000000003,56160,9550,57600,completed
406,46681,1440,1,2-6,1,0.2009,0.12480000000000001,56160,9479,57600,completed
411,47790,1440,4,2-6,3-4,0.8036,0.49920000000000003,56160,8370,57600,completed
414,48049,1440,1,2-6,1,0.2009,0.12480000000000001,56160,8111,57600,completed
419,48727,1440,2,6-12,2,0.4018,0.24960000000000002,56160,7433,57600,completed
431,51075,720,1,2-6,1,0.10024999999999998,0.062400000000000004,56160,5085,56880,completed
432,51154,720,1,2-6,1,0.10024999999999998,0.062400000000000004,56160,5006,56880,completed
438,52072,1154,1,0-2,1,0.16104847222222224,0.020002666666666665,56392,4320,57546,completed
442,52367,1348,1,0-2,1,0.19875381944444448,0.02336533333333333,56687,4320,58035,completed
440,52367,1299,1,0-2,1,0.19073006944444448,0.022515999999999998,56687,4320,57986,completed
448,52368,277,1,0-2,1,0.038615625,0.004801333333333333,56688,4320,56965,completed
447,52368,277,1,0-2,1,0.038615625,0.004801333333333333,56688,4320,56965,completed
452,53549,397,2,0-2,2,0.1300175,0.013762666666666666,57869,4320,58266,completed
453,53555,480,1,0-2,1,0.07734388888888888,0.00832,57875,4320,58355,completed
454,53584,132,1,0-2,1,0.021615000000000006,0.0022879999999999997,57904,4320,58036,completed
380,44187,2170,1,6-12,1,0.2715615277777778,0.18806666666666666,58320,14133,60490,completed
389,44928,3600,1,12-24,1,0.47562000000000004,0.312,58320,13392,61920,completed
397,45674,1279,1,2-6,1,0.15181865277777779,0.11084666666666666,58320,12646,59599,completed
401,45811,3600,1,24-48,1,0.47562000000000004,0.312,58320,12509,61920,completed
405,46610,3600,4,12-24,3-4,1.9024800000000002,1.248,58320,11710,61920,completed
406,46681,764,1,2-6,1,0.09676372222222224,0.06621333333333333,58320,11639,59084,completed
411,47790,819,4,2-6,3-4,0.41057350000000004,0.28392,58320,10530,59139,completed
414,48049,331,1,2-6,1,0.042322027777777785,0.028686666666666666,58320,10271,58651,completed
419,48727,2880,2,6-12,2,0.7350400000000001,0.49920000000000003,58320,9593,61200,completed
431,51075,1440,1,2-6,1,0.16903,0.12480000000000001,58320,7245,59760,completed
432,51154,1199,1,2-6,1,0.14326643055555555,0.10391333333333333,58320,7166,59519,completed
434,51515,1440,1,12-24,1,0.16903,0.12480000000000001,58320,6805,59760,completed
439,52366,1440,1,2-6,1,0.16903,0.12480000000000001,58320,5954,59760,completed
441,52367,1440,1,12-24,1,0.16903,0.12480000000000001,58320,5953,59760,completed
445,52367,1440,1,2-6,1,0.16903,0.12480000000000001,58320,5953,59760,completed
446,52367,1440,1,6-12,1,0.16903,0.12480000000000001,58320,5953,59760,completed
444,52367,1440,1,12-24,1,0.16903,0.12480000000000001,58320,5953,59760,completed
443,52367,1440,1,2-6,1,0.16903,0.12480000000000001,58320,5953,59760,completed
449,52785,720,1,12-24,1,0.07697000000000001,0.062400000000000004,59040,6255,59760,completed
450,53223,720,1,6-12,1,0.07697000000000001,0.062400000000000004,59040,5817,59760,completed
451,53310,720,1,6-12,1,0.07697000000000001,0.062400000000000004,59040,5730,59760,completed
455,55418,720,1,24-48,1,0.07697000000000001,0.062400000000000004,59040,3622,59760,completed
456,55423,720,1,24-48,1,0.07697000000000001,0.062400000000000004,59040,3617,59760,completed
457,55424,720,1,12-24,1,0.07697000000000001,0.062400000000000004,59040,3616,59760,completed
458,55424,720,1,24-48,1,0.07697000000000001,0.062400000000000004,59040,3616,59760,completed
460,55424,720,1,24-48,1,0.07697000000000001,0.062400000000000004,59040,3616,59760,completed
459,55424,720,1,24-48,1,0.07697000000000001,0.062400000000000004,59040,3616,59760,completed
461,55453,720,1,6-12,1,0.07697000000000001,0.062400000000000004,59040,3587,59760,completed
462,56158,691,1,0-2,1,0.07386981944444446,0.011977333333333333,59040,2882,59731,completed
463,56269,720,1,0-2,1,0.07697000000000001,0.01248,59040,2771,59760,completed
464,56297,720,1,2-6,1,0.07697000000000001,0.062400000000000004,59040,2743,59760,completed
465,56454,257,1,0-2,1,0.02747401388888889,0.004454666666666667,59040,2586,59297,completed
466,56456,720,1,0-2,1,0.07697000000000001,0.01248,59040,2584,59760,completed
467,56645,720,1,0-2,1,0.07697000000000001,0.01248,59040,2395,59760,completed
468,56835,720,1,6-12,1,0.07697000000000001,0.062400000000000004,59040,2205,59760,completed
469,56909,720,1,6-12,1,0.07697000000000001,0.062400000000000004,59040,2131,59760,completed
470,57089,720,3,6-12,3-4,0.23091000000000003,0.1872,59040,1951,59760,completed
471,57157,306,1,0-2,1,0.03271225,0.005304,59040,1883,59346,completed
472,57384,160,1,0-2,1,0.017104444444444446,0.0027733333333333334,59040,1656,59200,completed
473,57541,91,1,0-2,1,0.009728152777777777,0.0015773333333333331,59040,1499,59131,completed
474,57542,318,1,0-2,1,0.03399508333333333,0.0055119999999999995,59040,1498,59358,completed
475,57699,105,1,0-2,1,0.011224791666666668,0.0018199999999999998,59040,1341,59145,completed
476,57839,365,1,0-2,1,0.039019513888888885,0.006326666666666666,59040,1201,59405,completed
477,57840,544,1,0-2,1,0.058155111111111116,0.009429333333333333,59040,1200,59584,completed
478,57919,67,1,0-2,1,0.007162486111111112,0.0011613333333333332,59040,1121,59107,completed
479,58363,664,1,0-2,1,0.07098344444444446,0.011509333333333333,59040,677,59704,completed
480,58498,257,1,0-2,1,0.02747401388888889,0.004454666666666667,59040,542,59297,completed
481,58787,245,1,0-2,1,0.026191180555555554,0.004246666666666667,59040,253,59285,completed
482,59218,130,1,0-2,1,0.013897361111111112,0.0022533333333333333,59218,0,59348,completed
483,59286,474,1,0-2,1,0.05067191666666668,0.008216,59286,0,59760,completed
484,59569,191,3,6-12,3-4,0.06125529166666666,0.04966,59569,0,59760,completed
431,51075,301,1,2-6,1,0.04068098611111112,0.026086666666666668,60480,9405,60781,completed
434,51515,720,1,12-24,1,0.09731000000000004,0.062400000000000004,60480,8965,61200,completed
463,56269,11,1,0-2,1,0.0016515277777777776,0.00019066666666666665,61309,5040,61320,completed
466,56456,199,1,0-2,1,0.029877638888888884,0.0034493333333333333,61496,5040,61695,completed
467,56645,203,1,0-2,1,0.03047819444444444,0.0035186666666666665,61685,5040,61888,completed
224,24763,17280,1,48+,1,2.21939,1.4976,64080,39317,81360,completed
483,59286,143,1,0-2,1,0.036256458333333325,0.0024786666666666663,64080,4794,64223,completed
488,60350,751,1,0-2,1,0.1483887916666667,0.013017333333333332,64670,4320,65421,completed
267,29723,4097,1,24-48,1,0.5465234305555555,0.35507333333333335,64800,35077,68897,completed
303,34398,8131,2,24-48,2,2.1761648888888887,1.4093733333333334,64800,30402,72931,completed
328,37065,78,1,24-48,1,0.014498250000000004,0.00676,64800,27735,64878,completed
491,61146,137,1,0-2,1,0.022028444444444448,0.0023746666666666664,65466,4320,65603,completed
492,61158,123,1,0-2,1,0.019509000000000002,0.0021319999999999998,65478,4320,65601,completed
493,61159,121,1,0-2,1,0.01917865277777778,0.002097333333333333,65479,4320,65600,completed
389,44928,5257,1,12-24,1,0.6167277222222223,0.45560666666666666,65520,20592,70777,completed
401,45811,6480,1,24-48,1,0.7772300000000001,0.5616,65520,19709,72000,completed
405,46610,1491,4,12-24,3-4,0.7981223333333334,0.51688,65520,18910,67011,completed
419,48727,37,2,6-12,2,0.010690944444444442,0.006413333333333333,65520,16793,65557,completed
494,61220,427,2,0-2,2,0.1233792777777778,0.014802666666666665,65540,4320,65967,completed
495,61226,156,2,0-2,2,0.04507533333333334,0.005408,65546,4320,65702,completed
497,61312,431,1,0-2,1,0.06226752777777779,0.007470666666666666,65632,4320,66063,completed
496,61312,431,1,0-2,1,0.06226752777777779,0.007470666666666666,65632,4320,66063,completed
498,61330,712,1,0-2,1,0.10045472222222224,0.012341333333333333,65650,4320,66362,completed
500,61602,601,1,0-2,1,0.08123855555555556,0.010417333333333332,65922,4320,66523,completed
501,61704,641,1,0-2,1,0.08421294444444445,0.011110666666666666,66024,4320,66665,completed
502,61805,974,1,0-2,1,0.12197844444444446,0.016882666666666667,66125,4320,67099,completed
434,51515,5040,1,12-24,1,0.5699099999999999,0.4368,66240,14725,71280,completed
439,52366,164,1,2-6,1,0.020454444444444445,0.014213333333333333,66240,13874,66404,completed
445,52367,873,1,2-6,1,0.10693175000000002,0.07566,66240,13873,67113,completed
441,52367,5040,1,12-24,1,0.5699099999999999,0.4368,66240,13873,71280,completed
443,52367,555,1,2-6,1,0.06922083333333334,0.048100000000000004,66240,13873,66795,completed
444,52367,5040,1,12-24,1,0.5699099999999999,0.4368,66240,13873,71280,completed
446,52367,2501,1,6-12,1,0.2903195972222222,0.21675333333333333,66240,13873,68741,completed
449,52785,5040,1,12-24,1,0.5699099999999999,0.4368,66240,13455,71280,completed
450,53223,3511,1,6-12,1,0.4013402777777778,0.30428666666666665,66240,13017,69751,completed
451,53310,3304,1,6-12,1,0.3795477777777778,0.2863466666666667,66240,12930,69544,completed
503,62001,206,1,0-2,1,0.02569277777777778,0.0035706666666666664,66321,4320,66527,completed
504,62001,508,1,0-2,1,0.06335888888888888,0.008805333333333333,66321,4320,66829,completed
507,62292,619,1,0-2,1,0.07374780555555557,0.010729333333333332,66612,4320,67231,completed
508,62553,389,1,0-2,1,0.04466644444444445,0.006742666666666666,66873,4320,67262,completed
455,55418,4320,1,24-48,1,0.48011000000000004,0.3744,66960,11542,71280,completed
456,55423,4320,1,24-48,1,0.48011000000000004,0.3744,66960,11537,71280,completed
460,55424,4320,1,24-48,1,0.48011000000000004,0.3744,66960,11536,71280,completed
459,55424,4320,1,24-48,1,0.48011000000000004,0.3744,66960,11536,71280,completed
458,55424,4320,1,24-48,1,0.48011000000000004,0.3744,66960,11536,71280,completed
457,55424,4320,1,12-24,1,0.48011000000000004,0.3744,66960,11536,71280,completed
461,55453,4320,1,6-12,1,0.48011000000000004,0.3744,66960,11507,71280,completed
464,56297,833,1,2-6,1,0.09314102777777782,0.07219333333333333,66960,10663,67793,completed
468,56835,1440,1,6-12,1,0.16040000000000007,0.12480000000000001,66960,10125,68400,completed
469,56909,1440,1,6-12,1,0.16040000000000007,0.12480000000000001,66960,10051,68400,completed
470,57089,1440,3,6-12,3-4,0.4812000000000002,0.3744,66960,9871,68400,completed
509,62705,823,1,0-2,1,0.09195713888888893,0.014265333333333333,67025,4320,67848,completed
511,63329,217,1,0-2,1,0.024080972222222233,0.003761333333333333,67649,4320,67866,completed
512,63601,281,1,0-2,1,0.03113636111111112,0.004870666666666666,67921,4320,68202,completed
513,63622,113,1,0-2,1,0.012521027777777782,0.0019586666666666667,67942,4320,68055,completed
514,64516,177,1,0-2,1,0.02082454166666666,0.003068,68836,4320,69013,completed
468,56835,997,1,6-12,1,0.1055467222222222,0.08640666666666667,69120,12285,70117,completed
469,56909,2160,1,6-12,1,0.235,0.1872,69120,12211,71280,completed
470,57089,1277,3,6-12,3-4,0.4068468333333334,0.33202,69120,12031,70397,completed
484,59569,1440,3,6-12,3-4,0.45935999999999994,0.3744,69120,9551,70560,completed
485,59825,1440,1,6-12,1,0.15311999999999998,0.12480000000000001,69120,9295,70560,completed
486,59996,1440,1,6-12,1,0.15311999999999998,0.12480000000000001,69120,9124,70560,completed
487,60129,1440,1,12-24,1,0.15311999999999998,0.12480000000000001,69120,8991,70560,completed
489,60658,720,1,2-6,1,0.0758,0.062400000000000004,69120,8462,69840,completed
490,61016,720,1,2-6,1,0.0758,0.062400000000000004,69120,8104,69840,completed
515,65228,557,3,0-2,3-4,0.1775975,0.028963999999999997,69548,4320,70105,completed
517,65675,126,1,0-2,1,0.013531000000000001,0.0021839999999999997,69995,4320,70121,completed
518,65700,114,1,0-2,1,0.012242333333333332,0.001976,70020,4320,70134,completed
521,65753,459,4,0-2,3-4,0.19716599999999995,0.031824,70073,4320,70532,completed
524,66003,955,1,0-2,1,0.10710372222222224,0.016553333333333333,70323,4320,71278,completed
525,66117,85,1,0-2,1,0.009128055555555558,0.0014733333333333332,70437,4320,70522,completed
526,66143,412,1,0-2,1,0.04623922222222222,0.007141333333333333,70463,4320,70875,completed
527,66348,712,1,0-2,1,0.08394522222222223,0.012341333333333333,70668,4320,71380,completed
528,66571,118,1,0-2,1,0.013419222222222221,0.002045333333333333,70891,4320,71009,completed
531,68136,77,1,0-2,1,0.014664222222222223,0.0013346666666666665,72456,4320,72533,completed
532,68137,90,1,0-2,1,0.01714,0.00156,72457,4320,72547,completed
533,68294,753,2,0-2,2,0.285084,0.026104,72614,4320,73367,completed
534,68348,762,1,0-2,1,0.144172,0.013208,72668,4320,73430,completed
536,68479,91,1,0-2,1,0.017209111111111113,0.0015773333333333331,72799,4320,72890,completed
537,68645,362,1,0-2,1,0.06845822222222223,0.006274666666666666,72965,4320,73327,completed
401,45811,5122,1,24-48,1,0.3923239722222222,0.44390666666666667,73440,27629,78562,completed
434,51515,3325,1,12-24,1,0.2693510416666667,0.2881666666666667,73440,21925,76765,completed
441,52367,737,1,12-24,1,0.07988518055555555,0.06387333333333334,73440,21073,74177,completed
444,52367,818,1,12-24,1,0.08572280555555556,0.07089333333333334,73440,21073,74258,completed
449,52785,45,1,12-24,1,0.00491625,0.0039000000000000003,73440,20655,73485,completed
455,55418,6480,1,24-48,1,0.52997,0.5616,73440,18022,79920,completed
456,55423,6480,1,24-48,1,0.52997,0.5616,73440,18017,79920,completed
460,55424,6480,1,24-48,1,0.52997,0.5616,73440,18016,79920,completed
458,55424,6480,1,24-48,1,0.52997,0.5616,73440,18016,79920,completed
459,55424,6480,1,24-48,1,0.52997,0.5616,73440,18016,79920,completed
457,55424,6402,1,12-24,1,0.52080175,0.55484,73440,18016,79842,completed
461,55453,329,1,6-12,1,0.035943249999999996,0.028513333333333335,73440,17987,73769,completed
469,56909,38,1,6-12,1,0.0041515,0.0032933333333333334,73440,16531,73478,completed
484,59569,3925,3,6-12,3-4,0.9348093749999999,1.0205,73440,13871,77365,completed
485,59825,2407,1,6-12,1,0.2022190972222222,0.20860666666666666,73440,13615,75847,completed
545,69150,1256,1,0-2,1,0.11617380555555555,0.021770666666666664,73470,4320,74726,completed
543,69150,1394,1,0-2,1,0.12611938888888888,0.024162666666666666,73470,4320,74864,completed
542,69150,1292,1,0-2,1,0.11876830555555555,0.022394666666666667,73470,4320,74762,completed
549,69156,969,1,0-2,1,0.09526679166666666,0.016796,73476,4320,74445,completed
548,69156,1050,1,0-2,1,0.10110441666666667,0.018199999999999997,73476,4320,74526,completed
550,69536,176,2,0-2,2,0.038456,0.006101333333333333,73856,4320,74032,completed
582,74054,1374,1,0-2,1,0.10416711111111111,0.023815999999999997,74054,0,75428,completed
486,59996,2514,1,6-12,1,0.18408975,0.21788,74160,14164,76674,completed
487,60129,5040,1,12-24,1,0.36668,0.4368,74160,14031,79200,completed
489,60658,1026,1,2-6,1,0.07461475000000001,0.08892,74160,13502,75186,completed
490,61016,852,1,2-6,1,0.06169283333333334,0.07384,74160,13144,75012,completed
499,61384,1609,4,2-6,3-4,0.4712480555555556,0.5577866666666667,74160,12776,75769,completed
505,62004,2531,1,2-6,1,0.18532295833333334,0.21935333333333334,74160,12156,76691,completed
506,62191,5040,1,24-48,1,0.36668,0.4368,74160,11969,79200,completed
510,63097,5040,1,24-48,1,0.36668,0.4368,74160,11063,79200,completed
516,65662,4909,1,6-12,1,0.3557942638888889,0.4254466666666667,74160,8498,79069,completed
519,65748,1777,1,2-6,1,0.13019034722222222,0.15400666666666668,74160,8412,75937,completed
520,65752,2528,1,2-6,1,0.18510533333333334,0.21909333333333333,74160,8408,76688,completed
522,65754,2078,1,2-6,1,0.15236819444444444,0.18009333333333333,74160,8406,76238,completed
523,65776,3221,1,6-12,1,0.23404112500000002,0.27915333333333336,74160,8384,77381,completed
529,67484,2584,1,2-6,1,0.18916766666666668,0.22394666666666668,74160,6676,76744,completed
530,67621,2588,1,2-6,1,0.18945783333333335,0.22429333333333334,74160,6539,76748,completed
535,68351,3347,3,6-12,3-4,0.728063625,0.87022,74160,5809,77507,completed
538,68776,1500,1,2-6,1,0.10978083333333334,0.13,74160,5384,75660,completed
539,68928,1528,2,2-6,2,0.22368777777777782,0.26485333333333333,74160,5232,75688,completed
540,69143,5040,1,24-48,1,0.36668,0.4368,74160,5017,79200,completed
546,69150,1509,1,2-6,1,0.11044395833333334,0.13078,74160,5010,75669,completed
544,69150,1519,1,2-6,1,0.1111807638888889,0.13164666666666666,74160,5010,75679,completed
541,69150,1521,1,2-6,1,0.11132812500000001,0.13182,74160,5010,75681,completed
547,69152,1773,1,2-6,1,0.12989562500000001,0.15366,74160,5008,75933,completed
551,70034,2646,1,2-6,1,0.19366525,0.22932,74160,4126,76806,completed
552,70055,2597,1,2-6,1,0.19011070833333332,0.22507333333333335,74160,4105,76757,completed
553,70088,2538,1,2-6,1,0.18583075,0.21996000000000002,74160,4072,76698,completed
554,70122,686,2,0-2,2,0.09887927777777777,0.02378133333333333,74160,4038,74846,completed
555,70789,333,2,0-2,2,0.04799825,0.011543999999999999,74160,3371,74493,completed
556,70912,435,1,0-2,1,0.03135020833333334,0.00754,74160,3248,74595,completed
557,71499,217,3,0-2,3-4,0.046917208333333335,0.011283999999999999,74160,2661,74377,completed
558,72030,1966,1,2-6,1,0.14411597222222222,0.17038666666666666,74160,2130,76126,completed
559,72338,105,1,0-2,1,0.0075672916666666675,0.0018199999999999998,74160,1822,74265,completed
560,72783,120,1,0-2,1,0.008648333333333334,0.00208,74160,1377,74280,completed
561,72897,671,1,0-2,1,0.04835859722222222,0.011630666666666666,74160,1263,74831,completed
562,72955,1274,1,0-2,1,0.09303219444444444,0.022082666666666664,74160,1205,75434,completed
563,73115,148,1,0-2,1,0.010666277777777776,0.002565333333333333,74160,1045,74308,completed
564,73391,579,1,0-2,1,0.041728208333333336,0.010036,74160,769,74739,completed
565,73422,1438,1,0-2,1,0.10521147222222224,0.02492533333333333,74160,738,75598,completed
566,73571,682,1,0-2,1,0.04915136111111111,0.011821333333333333,74160,589,74842,completed
567,73593,472,1,0-2,1,0.034016777777777785,0.008181333333333332,74160,567,74632,completed
568,73653,1847,1,2-6,1,0.1353479861111111,0.16007333333333335,74160,507,76007,completed
569,73662,864,1,0-2,1,0.062584,0.014976,74160,498,75024,completed
570,73759,791,1,0-2,1,0.05716273611111112,0.013710666666666666,74160,401,74951,completed
571,73764,1282,1,0-2,1,0.09362630555555557,0.022221333333333333,74160,396,75442,completed
572,73770,943,1,0-2,1,0.06845084722222222,0.016345333333333333,74160,390,75103,completed
573,73794,1014,1,0-2,1,0.07372358333333334,0.017575999999999998,74160,366,75174,completed
574,73816,1368,1,0-2,1,0.10001300000000002,0.023711999999999997,74160,344,75528,completed
575,73838,2024,1,2-6,1,0.14838944444444446,0.17541333333333334,74160,322,76184,completed
576,73878,649,1,0-2,1,0.04677306944444445,0.011249333333333333,74160,282,74809,completed
577,73925,1200,1,0-2,1,0.08753666666666667,0.0208,74160,235,75360,completed
578,73925,1940,1,2-6,1,0.14220027777777777,0.16813333333333333,74160,235,76100,completed
579,73971,1976,1,2-6,1,0.14485277777777777,0.17125333333333334,74160,189,76136,completed
580,73972,2848,1,2-6,1,0.2083186666666667,0.24682666666666667,74160,188,77008,completed
581,73974,2462,1,2-6,1,0.18031758333333334,0.21337333333333333,74160,186,76622,completed
583,74174,62,1,0-2,1,0.004468305555555553,0.0010746666666666667,74174,0,74236,completed
584,74275,62,1,0-2,1,0.004468305555555553,0.0010746666666666667,74275,0,74337,completed
585,74877,1153,1,0-2,1,0.08536884722222222,0.01998533333333333,74877,0,76030,completed
586,74878,946,1,0-2,1,0.07011858333333335,0.016397333333333333,74878,0,75824,completed
588,75379,198,1,0-2,1,0.014704249999999999,0.0034319999999999997,75379,0,75577,completed
587,75379,692,1,0-2,1,0.051115861111111105,0.011994666666666666,75379,0,76071,completed
589,75854,692,1,0-2,1,0.050729555555555556,0.011994666666666666,75854,0,76546,completed
590,76739,3181,1,6-12,1,0.26250504166666666,0.2756866666666667,76739,0,79920,completed
591,76755,1813,1,2-6,1,0.12419693055555553,0.15712666666666666,76755,0,78568,completed
592,76756,3164,1,6-12,1,0.2612718333333333,0.27421333333333336,76756,0,79920,completed
593,76767,3153,1,12-24,1,0.26047387499999997,0.27326,76767,0,79920,completed
594,76796,258,1,0-2,1,0.01866091666666667,0.004471999999999999,76796,0,77054,completed
595,77026,2894,1,6-12,1,0.24168558333333331,0.25081333333333333,77026,0,79920,completed
596,77317,392,1,0-2,1,0.026900999999999994,0.006794666666666666,77317,0,77709,completed
597,77736,118,1,0-2,1,0.007756999999999997,0.002045333333333333,77736,0,77854,completed
598,77778,129,1,0-2,1,0.008385,0.0022359999999999997,77778,0,77907,completed
599,78040,64,1,0-2,1,0.00416,0.0011093333333333333,78040,0,78104,completed
600,78044,62,1,0-2,1,0.00403,0.0010746666666666667,78044,0,78106,completed
601,78351,1569,1,6-12,1,0.15284499999999998,0.13598,78351,0,79920,completed
602,78351,1569,1,6-12,1,0.15284499999999998,0.13598,78351,0,79920,completed
603,78423,149,1,0-2,1,0.011349944444444447,0.0025826666666666667,78423,0,78572,completed
604,78425,136,1,0-2,1,0.010305875000000003,0.0023573333333333332,78425,0,78561,completed
605,78430,162,1,0-2,1,0.012556888888888892,0.0028079999999999997,78430,0,78592,completed
606,78800,511,1,0-2,1,0.046286013888888894,0.008857333333333333,78800,0,79311,completed
607,78848,1058,1,0-2,1,0.11223463888888888,0.018338666666666666,78848,0,79906,completed
608,79013,907,1,0-2,1,0.10016918055555554,0.015721333333333334,79013,0,79920,completed
609,79046,83,1,0-2,1,0.006897069444444446,0.0014386666666666667,79046,0,79129,completed
610,79049,871,1,0-2,1,0.09717768055555553,0.015097333333333332,79049,0,79920,completed
611,79067,853,1,0-2,1,0.09568193055555554,0.014785333333333333,79067,0,79920,completed
612,79103,817,1,0-2,1,0.09269043055555554,0.014161333333333333,79103,0,79920,completed
614,79134,320,1,0-2,1,0.035339999999999996,0.005546666666666667,79134,0,79454,completed
613,79134,409,1,0-2,1,0.04580120833333332,0.007089333333333333,79134,0,79543,completed
615,79145,775,1,0-2,1,0.0892003472222222,0.013433333333333332,79145,0,79920,completed
616,79182,738,1,0-2,1,0.08612574999999997,0.012792,79182,0,79920,completed
617,79247,673,1,2-6,1,0.07910554166666664,0.058326666666666666,79247,0,79920,completed
618,79555,365,1,0-2,1,0.042902708333333324,0.006326666666666666,79555,0,79920,completed
224,24763,40,1,48+,1,0.009734444444444445,0.0034666666666666665,83520,58757,83560,completed
487,60129,1493,1,12-24,1,0.31558424999999996,0.12939333333333333,83889,23760,85382,completed
455,55418,182,1,24-48,1,0.04011394444444443,0.015773333333333334,84218,28800,84400,completed
456,55423,1,1,24-48,1,0.0002433611111111111,8.666666666666667e-05,84223,28800,84224,completed
459,55424,267,1,24-48,1,0.05842352777777776,0.02314,84224,28800,84491,completed
460,55424,327,1,24-48,1,0.07145852777777775,0.02834,84224,28800,84551,completed
458,55424,348,1,24-48,1,0.07602077777777776,0.03016,84224,28800,84572,completed
608,79013,212,1,0-2,1,0.04605699999999999,0.0036746666666666664,84240,5227,84452,completed
610,79049,471,1,0-2,1,0.10232474999999996,0.008164,84240,5191,84711,completed
611,79067,251,1,0-2,1,0.054529749999999995,0.004350666666666667,84240,5173,84491,completed
612,79103,552,1,0-2,1,0.11992199999999997,0.009568,84240,5137,84792,completed
615,79145,416,1,0-2,1,0.09037599999999998,0.0072106666666666664,84240,5095,84656,completed
616,79182,324,1,0-2,1,0.07038899999999998,0.0056159999999999995,84240,5058,84564,completed
618,79555,488,1,0-2,1,0.10601799999999999,0.008458666666666666,84240,4685,84728,completed
506,62191,8702,1,24-48,1,1.7871385,0.7541733333333334,84511,22320,93213,completed
619,80266,119,1,0-2,1,0.025852749999999987,0.0020626666666666666,84586,4320,84705,completed
620,80684,567,1,0-2,1,0.09908325,0.009828,85004,4320,85571,completed
621,80690,892,1,0-2,1,0.1533455833333333,0.015461333333333332,85010,4320,85902,completed
622,81007,483,1,0-2,1,0.08292188888888888,0.008372,85327,4320,85810,completed
510,63097,11856,1,24-48,1,2.078178597222222,1.02752,85417,22320,97273,completed
624,81107,370,1,0-2,1,0.063323375,0.0064133333333333325,85427,4320,85797,completed
626,81326,351,1,0-2,1,0.057722569444444455,0.006084,85646,4320,85997,completed
627,81444,71,3,0-2,3-4,0.034792958333333346,0.003692,85764,4320,85835,completed
628,81518,407,1,0-2,1,0.06648231944444444,0.0070546666666666666,85838,4320,86245,completed
630,81838,183,1,0-2,1,0.029892541666666675,0.003172,86158,4320,86341,completed
631,81861,478,1,0-2,1,0.07463383333333334,0.008285333333333332,86181,4320,86659,completed
632,81988,229,1,0-2,1,0.03558365277777778,0.003969333333333333,86308,4320,86537,completed
633,82056,98,1,0-2,1,0.015023416666666664,0.0016986666666666665,86376,4320,86474,completed
635,82448,133,1,0-2,1,0.019955541666666667,0.0023053333333333333,86768,4320,86901,completed
637,82658,1329,4,0-2,3-4,0.8056284444444444,0.09214399999999999,86978,4320,88307,completed
590,76739,231,1,6-12,1,0.03293995833333332,0.02002,87120,10381,87351,completed
592,76756,487,1,6-12,1,0.0694448472222222,0.04220666666666667,87120,10364,87607,completed
593,76767,720,1,12-24,1,0.10266999999999997,0.062400000000000004,87120,10353,87840,completed
595,77026,539,1,6-12,1,0.07685990277777777,0.046713333333333336,87120,10094,87659,completed
601,78351,720,1,6-12,1,0.10266999999999997,0.062400000000000004,87120,8769,87840,completed
602,78351,720,1,6-12,1,0.10266999999999997,0.062400000000000004,87120,8769,87840,completed
617,79247,720,1,2-6,1,0.10266999999999997,0.062400000000000004,87120,7873,87840,completed
623,81056,720,4,2-6,3-4,0.4106799999999999,0.24960000000000002,87120,6064,87840,completed
625,81161,720,1,6-12,1,0.10266999999999997,0.062400000000000004,87120,5959,87840,completed
629,81691,720,1,6-12,1,0.10266999999999997,0.062400000000000004,87120,5429,87840,completed
634,82122,720,1,12-24,1,0.10266999999999997,0.062400000000000004,87120,4998,87840,completed
636,82581,720,1,6-12,1,0.10266999999999997,0.062400000000000004,87120,4539,87840,completed
638,82710,720,3,2-6,3-4,0.3080099999999999,0.1872,87120,4410,87840,completed
639,82755,720,3,2-6,3-4,0.3080099999999999,0.1872,87120,4365,87840,completed
640,82817,197,2,0-2,2,0.05618330555555555,0.006829333333333333,87120,4303,87317,completed
641,83717,60,1,0-2,1,0.008555833333333335,0.00104,87120,3403,87180,completed
642,83979,199,1,0-2,1,0.028376847222222217,0.0034493333333333333,87120,3141,87319,completed
643,83998,80,2,0-2,2,0.02281555555555555,0.0027733333333333334,87120,3122,87200,completed
644,84474,461,3,0-2,3-4,0.19721195833333324,0.023972,87120,2646,87581,completed
645,84511,517,3,0-2,3-4,0.22116829166666663,0.026883999999999998,87120,2609,87637,completed
646,84699,504,1,0-2,1,0.07186899999999999,0.008735999999999999,87120,2421,87624,completed
647,84705,228,2,0-2,2,0.06502433333333331,0.007904,87120,2415,87348,completed
648,84709,261,1,0-2,1,0.037217875,0.004523999999999999,87120,2411,87381,completed
649,84751,105,2,0-2,2,0.02994541666666666,0.0036399999999999996,87120,2369,87225,completed
650,84908,76,2,0-2,2,0.02167477777777778,0.0026346666666666667,87120,2212,87196,completed
651,85178,720,4,0-2,3-4,0.4106799999999999,0.04992,87120,1942,87840,completed
652,85293,270,1,0-2,1,0.03850125,0.00468,87120,1827,87390,completed
653,85354,666,4,0-2,3-4,0.3798789999999999,0.046175999999999995,87120,1766,87786,completed
654,85396,61,1,0-2,1,0.008698430555555558,0.0010573333333333333,87120,1724,87181,completed
655,85418,63,1,0-2,1,0.008983625000000004,0.0010919999999999999,87120,1702,87183,completed
656,85495,493,1,0-2,1,0.07030043055555554,0.008545333333333334,87120,1625,87613,completed
657,85563,720,1,12-24,1,0.10266999999999997,0.062400000000000004,87120,1557,87840,completed
658,85564,643,1,0-2,1,0.09169001388888887,0.011145333333333333,87120,1556,87763,completed
659,85675,720,1,2-6,1,0.10266999999999997,0.062400000000000004,87120,1445,87840,completed
660,86045,720,1,0-2,1,0.10266999999999997,0.01248,87120,1075,87840,completed
661,86070,720,1,2-6,1,0.10266999999999997,0.062400000000000004,87120,1050,87840,completed
662,86074,138,1,0-2,1,0.019678416666666664,0.002392,87120,1046,87258,completed
663,86296,125,1,0-2,1,0.01782465277777777,0.0021666666666666666,87120,824,87245,completed
664,86522,385,1,0-2,1,0.054899930555555546,0.006673333333333333,87120,598,87505,completed
665,86604,172,1,0-2,1,0.02452672222222222,0.0029813333333333332,87120,516,87292,completed
666,86701,93,1,0-2,1,0.013261541666666666,0.001612,87120,419,87213,completed
667,86819,325,2,0-2,2,0.09268819444444443,0.011266666666666666,87120,301,87445,completed
668,86844,231,1,0-2,1,0.03293995833333332,0.004004,87120,276,87351,completed
669,87124,450,1,0-2,1,0.06416874999999998,0.0078,87124,0,87574,completed
670,87136,704,1,2-6,1,0.10038844444444442,0.061013333333333336,87136,0,87840,completed
671,87193,647,1,24-48,1,0.09226040277777775,0.056073333333333336,87193,0,87840,completed
672,87228,403,1,0-2,1,0.05746668055555554,0.006985333333333333,87228,0,87631,completed
673,87262,578,1,24-48,1,0.08242119444444443,0.05009333333333334,87262,0,87840,completed
674,87361,479,2,0-2,2,0.13660813888888884,0.016605333333333333,87361,0,87840,completed
675,87453,214,1,0-2,1,0.03051580555555555,0.003709333333333333,87453,0,87667,completed
676,87483,357,1,2-6,1,0.05090720833333332,0.030940000000000002,87483,0,87840,completed
678,87484,356,1,0-2,1,0.0507646111111111,0.006170666666666666,87484,0,87840,completed
677,87484,356,1,2-6,1,0.0507646111111111,0.030853333333333333,87484,0,87840,completed
679,87592,248,1,0-2,1,0.03536411111111111,0.004298666666666667,87592,0,87840,completed
680,87691,146,1,0-2,1,0.020819194444444442,0.0025306666666666663,87691,0,87837,completed
651,85178,257,4,0-2,3-4,0.353375,0.017818666666666667,90218,5040,90475,completed
660,86045,184,1,0-2,1,0.03698911111111111,0.003189333333333333,91085,5040,91269,completed
540,69143,7813,1,24-48,1,1.46007125,0.6771266666666667,91463,22320,99276,completed
712,92117,1258,1,0-2,1,0.183088,0.021805333333333333,92117,0,93375,completed
713,92120,627,1,0-2,1,0.09567488888888889,0.010868,92120,0,92747,completed
714,92125,1196,1,0-2,1,0.17457650000000002,0.020730666666666665,92125,0,93321,completed
715,92125,884,1,0-2,1,0.13255183333333334,0.015322666666666665,92125,0,93009,completed
716,92137,1332,1,0-2,1,0.19265427777777777,0.023087999999999997,92137,0,93469,completed
717,92143,450,1,0-2,1,0.06863919444444444,0.0078,92143,0,92593,completed
674,87361,221,2,0-2,2,0.06738044444444444,0.0076613333333333325,92160,4799,92381,completed
678,87484,786,1,0-2,1,0.11864983333333332,0.013623999999999999,92160,4676,92946,completed
679,87592,137,1,0-2,1,0.02088488888888889,0.0023746666666666664,92160,4568,92297,completed
681,88122,359,1,0-2,1,0.05472755555555556,0.006222666666666666,92160,4038,92519,completed
682,88187,82,1,0-2,1,0.012500444444444444,0.0014213333333333333,92160,3973,92242,completed
683,88513,81,1,0-2,1,0.012348,0.0014039999999999999,92160,3647,92241,completed
684,88524,621,1,0-2,1,0.094668,0.010764,92160,3636,92781,completed
685,88528,107,1,0-2,1,0.016311555555555555,0.0018546666666666666,92160,3632,92267,completed
686,88622,120,1,0-2,1,0.018293333333333335,0.00208,92160,3538,92280,completed
687,88704,343,1,0-2,1,0.05228844444444444,0.005945333333333333,92160,3456,92503,completed
688,88704,345,1,0-2,1,0.052593333333333325,0.005979999999999999,92160,3456,92505,completed
689,88794,245,1,0-2,1,0.03734888888888889,0.004246666666666667,92160,3366,92405,completed
690,88984,5040,1,24-48,1,0.6042000000000001,0.4368,92160,3176,97200,completed
691,89062,373,1,0-2,1,0.056861777777777775,0.006465333333333333,92160,3098,92533,completed
692,89169,167,3,0-2,3-4,0.07637466666666667,0.008683999999999999,92160,2991,92327,completed
693,89170,169,3,0-2,3-4,0.07728933333333333,0.008787999999999999,92160,2990,92329,completed
694,89211,959,1,0-2,1,0.14195197222222222,0.016622666666666664,92160,2949,93119,completed
695,89564,240,2,0-2,2,0.07317333333333334,0.00832,92160,2596,92400,completed
696,89577,68,1,0-2,1,0.010366222222222223,0.0011786666666666666,92160,2583,92228,completed
697,89631,722,1,0-2,1,0.11002938888888888,0.012514666666666665,92160,2529,92882,completed
698,89770,1655,1,2-6,1,0.22984354166666665,0.14343333333333333,92160,2390,93815,completed
699,90614,442,1,0-2,1,0.06738044444444444,0.0076613333333333325,92160,1546,92602,completed
700,90619,460,1,0-2,1,0.07012444444444445,0.007973333333333332,92160,1541,92620,completed
701,90662,67,1,0-2,1,0.010213777777777778,0.0011613333333333332,92160,1498,92227,completed
702,90818,1543,1,2-6,1,0.21780820833333334,0.13372666666666666,92160,1342,93703,completed
703,90856,590,1,0-2,1,0.08994222222222223,0.010226666666666667,92160,1304,92750,completed
704,90966,542,1,0-2,1,0.08262488888888889,0.009394666666666666,92160,1194,92702,completed
705,91015,475,1,0-2,1,0.07241111111111112,0.008233333333333332,92160,1145,92635,completed
706,91063,1270,1,0-2,1,0.18384194444444446,0.022013333333333333,92160,1097,93430,completed
707,91145,833,1,0-2,1,0.12498047222222222,0.014438666666666666,92160,1015,92993,completed
708,91221,711,1,0-2,1,0.108388,0.012324,92160,939,92871,completed
709,91223,668,1,0-2,1,0.10183288888888888,0.011578666666666666,92160,937,92828,completed
710,91877,70,1,0-2,1,0.010671111111111112,0.0012133333333333332,92160,283,92230,completed
711,91995,87,1,0-2,1,0.013262666666666667,0.001508,92160,165,92247,completed
718,92355,459,1,0-2,1,0.069972,0.007956,92355,0,92814,completed
719,92426,63,1,0-2,1,0.009604000000000001,0.0010919999999999999,92426,0,92489,completed
720,92515,1432,1,0-2,1,0.1899102638888889,0.02482133333333333,92515,0,93947,completed
721,92665,4535,1,12-24,1,0.5272155555555555,0.39303333333333335,92665,0,97200,completed
722,92822,1767,1,2-6,1,0.21141062500000002,0.15314,92822,0,94589,completed
723,92867,188,1,0-2,1,0.02555330555555556,0.0032586666666666667,92867,0,93055,completed
593,76767,2205,1,12-24,1,0.25467,0.1911,92880,16113,95085,completed
602,78351,2641,1,6-12,1,0.30107977777777784,0.22888666666666668,92880,14529,95521,completed
601,78351,1246,1,6-12,1,0.15350308333333335,0.10798666666666668,92880,14529,94126,completed
617,79247,130,1,2-6,1,0.01751027777777778,0.011266666666666666,92880,13633,93010,completed
623,81056,1923,4,2-6,3-4,0.9000721666666668,0.66664,92880,11824,94803,completed
625,81161,3929,1,6-12,1,0.4400475555555555,0.34051333333333333,92880,11719,96809,completed
629,81691,4320,1,6-12,1,0.4944400000000001,0.3744,92880,11189,97200,completed
634,82122,4320,1,12-24,1,0.4944400000000001,0.3744,92880,10758,97200,completed
636,82581,3539,1,6-12,1,0.38853922222222226,0.30671333333333334,92880,10299,96419,completed
638,82710,1870,3,2-6,3-4,0.6583745833333334,0.4862,92880,10170,94750,completed
639,82755,1440,3,2-6,3-4,0.52305,0.3744,92880,10125,94320,completed
657,85563,4320,1,12-24,1,0.4944400000000001,0.3744,92880,7317,97200,completed
659,85675,796,1,2-6,1,0.10514683333333336,0.06898666666666667,92880,7205,93676,completed
661,86070,1929,1,2-6,1,0.22564745833333336,0.16718,92880,6810,94809,completed
670,87136,2053,1,2-6,1,0.23865540277777778,0.17792666666666668,92880,5744,94933,completed
671,87193,4320,1,24-48,1,0.4944400000000001,0.3744,92880,5687,97200,completed
673,87262,4320,1,24-48,1,0.4944400000000001,0.3744,92880,5618,97200,completed
676,87483,1803,1,2-6,1,0.21242970833333336,0.15626,92880,5397,94683,completed
677,87484,1671,1,2-6,1,0.1985825416666667,0.14482,92880,5396,94551,completed
724,92881,481,1,0-2,1,0.06478802777777778,0.008337333333333332,92881,0,93362,completed
725,92944,4256,1,12-24,1,0.48581955555555556,0.36885333333333337,92944,0,97200,completed
726,92990,3894,3,6-12,3-4,1.3069935,1.01244,92990,0,96884,completed
727,93062,119,1,0-2,1,0.01602863888888889,0.0020626666666666666,93062,0,93181,completed
728,93210,987,1,0-2,1,0.11668345833333334,0.017107999999999998,93210,0,94197,completed
729,93257,3943,1,12-24,1,0.44366019444444443,0.3417266666666667,93257,0,97200,completed
730,93606,79,1,0-2,1,0.00848920833333333,0.0013693333333333333,93606,0,93685,completed
731,93699,2446,1,2-6,1,0.25513440277777777,0.21198666666666666,93699,0,96145,completed
732,93778,879,1,0-2,1,0.09359465277777779,0.015236,93778,0,94657,completed
733,93815,1628,1,2-6,1,0.17269356944444447,0.14109333333333335,93815,0,95443,completed
734,93825,1369,1,0-2,1,0.14511431944444447,0.02372933333333333,93825,0,95194,completed
735,93850,1584,1,2-6,1,0.16797452777777777,0.13728,93850,0,95434,completed
736,94023,88,1,0-2,1,0.009456333333333334,0.0015253333333333332,94023,0,94111,completed
737,94276,626,1,0-2,1,0.06578158333333334,0.010850666666666666,94276,0,94902,completed
738,94296,93,1,0-2,1,0.00981729166666667,0.001612,94296,0,94389,completed
739,94301,2072,1,2-6,1,0.21190181944444447,0.17957333333333333,94301,0,96373,completed
740,94320,1986,1,2-6,1,0.20355466666666666,0.17212,94320,0,96306,completed
741,94527,2673,1,6-12,1,0.29837512499999996,0.23166,94527,0,97200,completed
742,94690,1322,1,0-2,1,0.13707197222222223,0.022914666666666667,94690,0,96012,completed
743,94742,67,1,0-2,1,0.00702848611111111,0.0011613333333333332,94742,0,94809,completed
744,94782,2393,1,2-6,1,0.2681471388888889,0.20739333333333335,94782,0,97175,completed
745,94791,1603,1,2-6,1,0.16242723611111112,0.13892666666666667,94791,0,96394,completed
746,94826,1834,1,2-6,1,0.19188919444444447,0.15894666666666668,94826,0,96660,completed
747,94835,1126,1,0-2,1,0.1170614027777778,0.01951733333333333,94835,0,95961,completed
748,94838,1175,1,0-2,1,0.12164047222222223,0.020366666666666665,94838,0,96013,completed
749,94871,518,1,0-2,1,0.05487768055555556,0.008978666666666666,94871,0,95389,completed
750,95088,2112,1,2-6,1,0.23945066666666667,0.18304,95088,0,97200,completed
751,95429,223,1,0-2,1,0.023737111111111105,0.003865333333333333,95429,0,95652,completed
752,95476,473,1,0-2,1,0.04801722222222223,0.008198666666666667,95476,0,95949,completed
753,95513,936,3,0-2,3-4,0.27340300000000006,0.048672,95513,0,96449,completed
754,95684,1516,1,6-12,1,0.17600977777777777,0.13138666666666668,95684,0,97200,completed
755,95692,533,1,0-2,1,0.0509998888888889,0.009238666666666666,95692,0,96225,completed
756,95736,242,1,0-2,1,0.023070888888888894,0.004194666666666666,95736,0,95978,completed
757,95816,181,1,0-2,1,0.017034111111111108,0.003137333333333333,95816,0,95997,completed
758,96075,608,1,0-2,1,0.06635455555555556,0.010538666666666667,96075,0,96683,completed
759,96145,118,1,0-2,1,0.01110511111111111,0.002045333333333333,96145,0,96263,completed
760,96189,64,1,0-2,1,0.006023111111111111,0.0011093333333333333,96189,0,96253,completed
761,96223,545,1,0-2,1,0.06425055555555556,0.009446666666666666,96223,0,96768,completed
762,96333,867,1,2-6,1,0.11399433333333334,0.07514,96333,0,97200,completed
763,96346,73,1,0-2,1,0.006870111111111111,0.0012653333333333332,96346,0,96419,completed
764,96546,64,1,0-2,1,0.008903111111111112,0.0011093333333333333,96546,0,96610,completed
765,96596,604,1,0-2,1,0.0840231111111111,0.010469333333333332,96596,0,97200,completed
766,96612,588,1,0-2,1,0.08179733333333333,0.010192,96612,0,97200,completed
767,96624,576,1,0-2,1,0.080128,0.009984,96624,0,97200,completed
768,96632,568,1,0-2,1,0.07901511111111112,0.009845333333333333,96632,0,97200,completed
769,96649,443,1,0-2,1,0.06162622222222222,0.007678666666666666,96649,0,97092,completed
770,96649,436,1,0-2,1,0.060652444444444446,0.007557333333333333,96649,0,97085,completed
771,96779,97,1,0-2,1,0.013493777777777778,0.0016813333333333333,96779,0,96876,completed
772,96901,164,1,0-2,1,0.022814222222222222,0.0028426666666666665,96901,0,97065,completed
773,96962,238,1,12-24,1,0.03310844444444444,0.020626666666666668,96962,0,97200,completed
774,97046,154,1,0-2,1,0.02142311111111111,0.002669333333333333,97046,0,97200,completed
765,96596,626,1,0-2,1,0.33072797222222217,0.010850666666666666,101520,4924,102146,completed
766,96612,535,1,0-2,1,0.2826509027777777,0.009273333333333333,101520,4908,102055,completed
767,96624,120,1,0-2,1,0.06339833333333332,0.00208,101520,4896,101640,completed
768,96632,716,1,0-2,1,0.3782767222222222,0.012410666666666665,101520,4888,102236,completed
774,97046,898,1,0-2,1,0.4694715833333333,0.015565333333333332,101520,4474,102418,completed
775,97271,313,2,0-2,2,0.33072797222222217,0.010850666666666666,101591,4320,101904,completed
776,97317,1032,1,0-2,1,0.5332732499999999,0.017887999999999998,101637,4320,102669,completed
777,97345,937,1,0-2,1,0.4849495972222222,0.016241333333333333,101665,4320,102602,completed
779,97345,740,1,0-2,1,0.38635930555555553,0.012826666666666665,101665,4320,102405,completed
778,97345,499,1,0-2,1,0.26363140277777775,0.008649333333333334,101665,4320,102164,completed
780,97369,986,1,0-2,1,0.5088033888888889,0.017090666666666667,101689,4320,102675,completed
781,97407,963,1,0-2,1,0.496234125,0.016692,101727,4320,102690,completed
782,97443,476,1,0-2,1,0.25148005555555547,0.008250666666666667,101763,4320,102239,completed
783,97512,748,1,0-2,1,0.3857101666666667,0.012965333333333332,101832,4320,102580,completed
784,97626,444,1,0-2,1,0.23039466666666666,0.007696,101946,4320,102390,completed
785,97627,274,1,0-2,1,0.14475952777777779,0.004749333333333333,101947,4320,102221,completed
786,97812,817,1,0-2,1,0.4118834583333334,0.014161333333333333,102132,4320,102949,completed
787,97992,735,1,0-2,1,0.3634204166666667,0.01274,102312,4320,103047,completed
788,98475,304,1,0-2,1,0.14508315277777778,0.005269333333333333,102795,4320,103099,completed
789,98476,265,1,0-2,1,0.12749430555555558,0.004593333333333333,102796,4320,103061,completed
790,98581,114,1,0-2,1,0.05426023611111111,0.001976,102901,4320,103015,completed
791,98597,306,1,0-2,1,0.1397893472222222,0.005304,102917,4320,103223,completed
792,98762,1178,1,0-2,1,0.5179386666666668,0.020418666666666665,103082,4320,104260,completed
793,98763,73,1,0-2,1,0.032827694444444444,0.0012653333333333332,103083,4320,103156,completed
794,99005,64,1,0-2,1,0.028780444444444442,0.0011093333333333333,103325,4320,103389,completed
795,99024,265,1,0-2,1,0.11916902777777777,0.004593333333333333,103344,4320,103609,completed
796,99205,105,1,0-2,1,0.047217916666666665,0.0018199999999999998,103525,4320,103630,completed
797,99205,74,1,0-2,1,0.03327738888888889,0.0012826666666666665,103525,4320,103599,completed
798,99269,143,1,0-2,1,0.06324825,0.0024786666666666663,103589,4320,103732,completed
799,99269,374,1,0-2,1,0.16242745833333339,0.006482666666666666,103589,4320,103963,completed
800,99535,275,4,0-2,3-4,0.4722819444444446,0.019066666666666666,103855,4320,104130,completed
801,99612,132,1,0-2,1,0.056673833333333354,0.0022879999999999997,103932,4320,104064,completed
629,81691,269,1,6-12,1,0.11549440277777782,0.023313333333333335,104011,22320,104280,completed
803,99779,1078,1,0-2,1,0.40476393055555565,0.01868533333333333,104099,4320,105177,completed
806,99886,288,1,0-2,1,0.11666597222222225,0.004992,104206,4320,104494,completed
807,99886,288,1,0-2,1,0.11666597222222225,0.004992,104206,4320,104494,completed
634,82122,5885,1,12-24,1,1.9472030416666664,0.5100333333333333,104442,22320,110327,completed
808,100315,167,1,0-2,1,0.0592896388888889,0.0028946666666666665,104635,4320,104802,completed
811,100695,77,1,0-2,1,0.02733713888888889,0.0013346666666666665,105015,4320,105092,completed
812,100875,84,1,0-2,1,0.029341666666666655,0.0014559999999999998,105195,4320,105279,completed
813,100964,63,1,0-2,1,0.022006249999999988,0.0010919999999999999,105284,4320,105347,completed
815,101325,74,1,0-2,1,0.025848611111111103,0.0012826666666666665,105645,4320,105719,completed
817,101670,581,3,0-2,3-4,0.7824742499999998,0.030212,105990,4320,106571,completed
819,102027,150,3,0-2,3-4,0.20176249999999993,0.0078,106347,4320,106497,completed
820,102501,72,1,0-2,1,0.034422,0.001248,106821,4320,106893,completed
821,102511,200,1,0-2,1,0.09561666666666666,0.0034666666666666665,106831,4320,107031,completed
824,102800,250,1,0-2,1,0.10983458333333332,0.004333333333333333,107120,4320,107370,completed
825,102857,87,1,0-2,1,0.04159324999999998,0.001508,107177,4320,107264,completed
826,102886,518,1,0-2,1,0.19986166666666672,0.008978666666666666,107206,4320,107724,completed
828,102945,401,1,0-2,1,0.1501681666666667,0.006950666666666667,107265,4320,107666,completed
833,103403,593,1,0-2,1,0.19965529166666668,0.010278666666666667,107723,4320,108316,completed
834,103502,682,1,0-2,1,0.22071158333333332,0.011821333333333333,107822,4320,108504,completed
657,85563,4812,1,12-24,1,0.7975713333333333,0.41704,107883,22320,112695,completed
835,103631,411,2,0-2,2,0.25863325,0.014247999999999999,107951,4320,108362,completed
836,103685,642,1,0-2,1,0.19714749999999998,0.011127999999999999,108005,4320,108647,completed
837,103788,230,2,0-2,2,0.14125833333333332,0.007973333333333332,108108,4320,108338,completed
838,103830,123,1,0-2,1,0.03777125,0.0021319999999999998,108150,4320,108273,completed
839,103934,922,1,0-2,1,0.24943749999999998,0.015981333333333334,108254,4320,109176,completed
840,103982,312,3,0-2,3-4,0.28742999999999996,0.016224,108302,4320,108614,completed
841,104065,99,1,0-2,1,0.030401249999999994,0.0017159999999999999,108385,4320,108484,completed
842,104071,1378,2,0-2,2,0.6408743888888888,0.04777066666666666,108391,4320,109769,completed
847,104723,698,1,0-2,1,0.1397014166666667,0.012098666666666666,109043,4320,109741,completed
850,104872,77,1,0-2,1,0.017955972222222227,0.0013346666666666665,109192,4320,109269,completed
671,87193,12549,1,24-48,1,1.3621670833333335,1.08758,109440,22247,121989,completed
673,87262,7204,1,24-48,1,0.8230973333333333,0.6243466666666667,109440,22178,116644,completed
721,92665,1380,1,12-24,1,0.18980250000000004,0.1196,109440,16775,110820,completed
725,92944,1708,1,12-24,1,0.22225138888888893,0.14802666666666667,109440,16496,111148,completed
729,93257,5772,1,12-24,1,0.6053470000000001,0.50024,109440,16183,115212,completed
741,94527,241,1,6-12,1,0.037729888888888896,0.020886666666666668,109440,14913,109681,completed
750,95088,730,1,2-6,1,0.1138879166666667,0.06326666666666667,109440,14352,110170,completed
754,95684,2314,1,6-12,1,0.2794370833333334,0.20054666666666668,109440,13756,111754,completed
762,96333,675,1,2-6,1,0.10567500000000002,0.0585,109440,13107,110115,completed
773,96962,7546,1,12-24,1,0.8801543333333334,0.6539866666666667,109440,12478,116986,completed
852,105263,402,1,0-2,1,0.06293533333333334,0.006967999999999999,109583,4320,109985,completed
851,105263,402,1,0-2,1,0.06293533333333334,0.006967999999999999,109583,4320,109985,completed
853,105454,65,1,0-2,1,0.010176111111111113,0.0011266666666666667,109774,4320,109839,completed
854,105528,602,2,0-2,2,0.16542983333333333,0.020869333333333333,109848,4320,110450,completed
855,105541,797,2,0-2,2,0.20994472222222224,0.027629333333333332,109861,4320,110658,completed
856,105673,104,1,0-2,1,0.01628177777777778,0.0018026666666666666,109993,4320,110097,completed
690,88984,5760,1,24-48,1,0.5868500000000001,0.49920000000000003,110160,21176,115920,completed
802,99736,3345,1,6-12,1,0.324990625,0.2899,110160,10424,113505,completed
804,99871,2133,1,2-6,1,0.216686875,0.18486,110160,10289,112293,completed
805,99879,5040,1,24-48,1,0.4910300000000001,0.4368,110160,10281,115200,completed
809,100423,3848,3,6-12,3-4,1.1174046666666666,1.00048,110160,9737,114008,completed
810,100455,1951,3,2-6,3-4,0.599441875,0.50726,110160,9705,112111,completed
857,105850,85,1,0-2,1,0.009927291666666664,0.0014733333333333332,110170,4320,110255,completed
858,105999,398,1,0-2,1,0.04648308333333334,0.006898666666666667,110319,4320,110717,completed
859,106059,278,1,0-2,1,0.03246808333333333,0.004818666666666666,110379,4320,110657,completed
860,106185,90,1,0-2,1,0.01051125,0.00156,110505,4320,110595,completed
861,106198,117,1,0-2,1,0.013664625,0.002028,110518,4320,110635,completed
863,106299,1215,1,0-2,1,0.12052637499999999,0.02106,110619,4320,111834,completed
864,106369,997,1,0-2,1,0.09863012500000001,0.017281333333333333,110689,4320,111686,completed
865,106375,541,1,0-2,1,0.05540173611111111,0.009377333333333333,110695,4320,111236,completed
866,106481,1161,1,0-2,1,0.11113695833333334,0.020124,110801,4320,111962,completed
867,106504,94,1,0-2,1,0.010147694444444438,0.0016293333333333333,110824,4320,110918,completed
814,101263,2033,1,2-6,1,0.18778640277777778,0.17619333333333334,110880,9617,112913,completed
816,101398,1705,1,2-6,1,0.1586445138888889,0.14776666666666666,110880,9482,112585,completed
818,101850,2230,1,2-6,1,0.2053670833333333,0.19326666666666667,110880,9030,113110,completed
822,102513,4320,2,12-24,2,0.81388,0.7488,110880,8367,115200,completed
823,102651,1877,1,2-6,1,0.17392623611111108,0.16267333333333334,110880,8229,112757,completed
827,102904,4320,1,12-24,1,0.40694,0.3744,110880,7976,115200,completed
829,103379,3038,1,6-12,1,0.27947322222222226,0.2632933333333333,110880,7501,113918,completed
830,103380,4320,1,6-12,1,0.40694,0.3744,110880,7500,115200,completed
831,103381,4320,1,6-12,1,0.40694,0.3744,110880,7499,115200,completed
832,103381,4320,1,6-12,1,0.40694,0.3744,110880,7499,115200,completed
843,104279,3600,2,6-12,2,0.67016,0.624,110880,6601,114480,completed
844,104413,3600,1,6-12,1,0.33508,0.312,110880,6467,114480,completed
845,104607,1694,1,2-6,1,0.15766719444444444,0.14681333333333332,110880,6273,112574,completed
846,104607,1538,1,2-6,1,0.1438070277777778,0.13329333333333335,110880,6273,112418,completed
848,104727,2880,1,6-12,1,0.26384,0.24960000000000002,110880,6153,113760,completed
849,104793,2880,1,12-24,1,0.26384,0.24960000000000002,110880,6087,113760,completed
868,106720,77,1,0-2,1,0.007309652777777778,0.0013346666666666665,111040,4320,111117,completed
869,106809,1064,1,0-2,1,0.09968833333333332,0.018442666666666666,111129,4320,112193,completed
870,106964,102,1,0-2,1,0.00968291666666666,0.0017679999999999998,111284,4320,111386,completed
871,107138,64,1,0-2,1,0.006075555555555555,0.0011093333333333333,111458,4320,111522,completed
872,107321,479,1,0-2,1,0.04440729166666667,0.008302666666666667,111641,4320,112120,completed
873,107500,119,1,0-2,1,0.011032291666666668,0.0020626666666666666,111820,4320,111939,completed
875,107627,201,1,0-2,1,0.018634375,0.0034839999999999997,111947,4320,112148,completed
876,107651,708,1,0-2,1,0.06425136111111111,0.012272,111971,4320,112679,completed
877,107933,703,1,0-2,1,0.06271829166666668,0.012185333333333333,112253,4320,112956,completed
878,107947,450,1,0-2,1,0.04018588888888888,0.0078,112267,4320,112717,completed
879,107963,784,1,0-2,1,0.06982908333333332,0.013589333333333332,112283,4320,113067,completed
862,106229,1440,1,12-24,1,0.12874000000000002,0.12480000000000001,112320,6091,113760,completed
880,108094,369,1,0-2,1,0.032784625000000005,0.006396,112414,4320,112783,completed
881,108133,1275,2,0-2,2,0.2280893055555556,0.044199999999999996,112453,4320,113728,completed
882,108157,75,1,0-2,1,0.006663541666666667,0.0013,112477,4320,112552,completed
883,108172,290,1,0-2,1,0.025765694444444445,0.005026666666666666,112492,4320,112782,completed
884,108215,95,1,0-2,1,0.008440486111111116,0.0016466666666666665,112535,4320,112630,completed
885,108216,204,1,0-2,1,0.018124833333333333,0.0035359999999999996,112536,4320,112740,completed
886,108220,264,1,0-2,1,0.023455666666666666,0.004575999999999999,112540,4320,112804,completed
887,108250,1234,2,0-2,2,0.2217635,0.042778666666666666,112570,4320,113804,completed
888,108320,75,1,0-2,1,0.006663541666666667,0.0013,112640,4320,112715,completed
889,108373,1398,1,0-2,1,0.12835059722222222,0.024232,112693,4320,114091,completed
890,108435,742,1,0-2,1,0.06643241666666666,0.012861333333333332,112755,4320,113497,completed
891,108648,456,1,0-2,1,0.040941000000000005,0.007904,112968,4320,113424,completed
892,108706,1418,1,0-2,1,0.13369186111111114,0.024578666666666665,113026,4320,114444,completed
893,108817,136,1,0-2,1,0.012234333333333333,0.0023573333333333332,113137,4320,113273,completed
894,108931,427,1,0-2,1,0.038412208333333336,0.007401333333333333,113251,4320,113678,completed
895,108946,299,1,0-2,1,0.026897541666666667,0.005182666666666666,113266,4320,113565,completed
896,108951,562,1,0-2,1,0.051212569444444446,0.009741333333333333,113271,4320,113833,completed
898,108952,499,1,0-2,1,0.04498805555555556,0.008649333333333334,113272,4320,113771,completed
897,108952,962,1,0-2,1,0.09079933333333334,0.016674666666666664,113272,4320,114234,completed
899,108952,814,1,0-2,1,0.07615555555555556,0.014109333333333333,113272,4320,114086,completed
900,109011,526,1,0-2,1,0.04818973611111112,0.009117333333333333,113331,4320,113857,completed
901,109016,586,1,0-2,1,0.054171333333333335,0.010157333333333332,113336,4320,113922,completed
902,109119,91,1,0-2,1,0.008186208333333332,0.0015773333333333331,113439,4320,113530,completed
903,109316,1186,1,0-2,1,0.11652833333333334,0.020557333333333334,113636,4320,114822,completed
904,109316,79,1,0-2,1,0.007106708333333334,0.0013693333333333333,113636,4320,113715,completed
906,109456,468,1,0-2,1,0.04630600000000001,0.008112,113776,4320,114244,completed
907,109519,74,1,0-2,1,0.007321888888888889,0.0012826666666666665,113839,4320,113913,completed
909,109651,78,1,0-2,1,0.007717666666666665,0.001352,113971,4320,114049,completed
910,109655,66,1,0-2,1,0.006530333333333333,0.0011439999999999998,113975,4320,114041,completed
911,109655,86,1,0-2,1,0.008509222222222225,0.0014906666666666666,113975,4320,114061,completed
913,109785,927,1,0-2,1,0.09219683333333331,0.016068,114105,4320,115032,completed
914,109861,88,1,0-2,1,0.008707111111111112,0.0015253333333333332,114181,4320,114269,completed
915,109862,278,1,0-2,1,0.027506555555555555,0.004818666666666666,114182,4320,114460,completed
916,109884,87,1,0-2,1,0.00860816666666667,0.001508,114204,4320,114291,completed
917,109965,505,1,0-2,1,0.050233888888888883,0.008753333333333333,114285,4320,114790,completed
919,110105,100,1,0-2,1,0.009933194444444446,0.0017333333333333333,114425,4320,114525,completed
920,110182,83,1,0-2,1,0.008283861111111112,0.0014386666666666667,114502,4320,114585,completed
921,110362,183,1,0-2,1,0.018264416666666665,0.003172,114682,4320,114865,completed
923,110601,105,1,0-2,1,0.01047958333333333,0.0018199999999999998,114921,4320,115026,completed
924,110703,72,1,0-2,1,0.007186,0.001248,115023,4320,115095,completed
925,111374,402,1,0-2,1,0.060109277777777775,0.006967999999999999,115694,4320,116096,completed
928,112349,550,1,0-2,1,0.09175833333333333,0.009533333333333333,116669,4320,117219,completed
929,112639,1270,3,0-2,3-4,0.5482606666666665,0.06604,116959,4320,118229,completed
930,112696,1214,3,0-2,3-4,0.5200569999999998,0.06312799999999999,117016,4320,118230,completed
931,112702,1114,3,0-2,3-4,0.4865196666666666,0.05792799999999999,117022,4320,118136,completed
690,88984,6436,1,24-48,1,0.549674611111111,0.5577866666666667,117064,28080,123500,completed
933,112811,720,1,0-2,1,0.10620833333333331,0.01248,117131,4320,117851,completed
935,112900,116,1,0-2,1,0.019352666666666674,0.0020106666666666667,117220,4320,117336,completed
936,113017,70,4,0-2,3-4,0.041386666666666655,0.004853333333333333,117337,4320,117407,completed
937,113040,148,2,0-2,2,0.04099599999999999,0.005130666666666666,117360,4320,117508,completed
938,113060,103,1,0-2,1,0.014265499999999995,0.0017853333333333332,117380,4320,117483,completed
939,113238,83,1,0-2,1,0.011495499999999997,0.0014386666666666667,117558,4320,117641,completed
940,113302,958,1,0-2,1,0.11757188888888885,0.016605333333333333,117622,4320,118580,completed
941,113340,102,1,0-2,1,0.014126999999999995,0.0017679999999999998,117660,4320,117762,completed
942,113354,165,1,0-2,1,0.022852499999999994,0.0028599999999999997,117674,4320,117839,completed
943,113357,320,1,0-2,1,0.04431999999999999,0.005546666666666667,117677,4320,117997,completed
944,113364,850,1,0-2,1,0.10400411111111107,0.014733333333333333,117684,4320,118534,completed
945,113465,754,1,0-2,1,0.09055699999999997,0.013069333333333332,117785,4320,118539,completed
946,113465,826,1,0-2,1,0.09835299999999997,0.014317333333333333,117785,4320,118611,completed
947,113514,81,1,0-2,1,0.011218499999999998,0.0014039999999999999,117834,4320,117915,completed
948,113564,877,1,0-2,1,0.10088316666666663,0.015201333333333332,117884,4320,118761,completed
949,113700,451,1,0-2,1,0.050646611111111094,0.007817333333333332,118020,4320,118471,completed
805,99879,6949,1,24-48,1,0.4803315138888889,0.6022466666666667,118080,18201,125029,completed
950,113809,235,1,0-2,1,0.025445277777777768,0.004073333333333333,118129,4320,118364,completed
951,114110,479,1,0-2,1,0.05178179166666665,0.008302666666666667,118430,4320,118909,completed
952,114424,1265,1,0-2,1,0.13443143055555556,0.021926666666666664,118744,4320,120009,completed
954,114786,108,1,0-2,1,0.011611500000000005,0.001872,119106,4320,119214,completed
955,114816,210,1,0-2,1,0.022577916666666673,0.0036399999999999996,119136,4320,119346,completed
956,115124,605,1,0-2,1,0.0632972638888889,0.010486666666666667,119444,4320,120049,completed
822,102513,3258,2,12-24,2,0.4142445,0.56472,119520,17007,122778,completed
827,102904,5314,1,12-24,1,0.3142338055555556,0.46054666666666666,119520,16616,124834,completed
830,103380,329,1,6-12,1,0.016358611111111112,0.028513333333333335,120240,16860,120569,completed
832,103381,472,1,6-12,1,0.023468888888888897,0.04090666666666667,120240,16859,120712,completed
831,103381,542,1,6-12,1,0.026949444444444446,0.04697333333333333,120240,16859,120782,completed
843,104279,980,2,6-12,2,0.09851000000000003,0.16986666666666667,120240,15961,121220,completed
844,104413,1083,1,6-12,1,0.05458525,0.09386,120240,15827,121323,completed
848,104727,932,1,6-12,1,0.046771000000000014,0.08077333333333334,120240,15513,121172,completed
849,104793,7049,1,12-24,1,0.37604272222222224,0.6109133333333333,120240,15447,127289,completed
862,106229,8041,1,12-24,1,0.4344,0.6968866666666667,120240,14011,128281,completed
874,107593,2632,2,2-6,2,0.2744957777777777,0.45621333333333336,120240,12647,122872,completed
905,109421,4320,1,24-48,1,0.22413,0.3744,120240,10819,124560,completed
908,109597,3814,1,6-12,1,0.1983591388888889,0.33054666666666666,120240,10643,124054,completed
912,109740,1933,1,2-6,1,0.09928486111111112,0.16752666666666666,120240,10500,122173,completed
918,109971,4320,3,12-24,3-4,0.67239,1.1232,120240,10269,124560,completed
922,110491,1462,1,2-6,1,0.07423027777777778,0.12670666666666666,120240,9749,121702,completed
926,111690,1963,1,2-6,1,0.10088069444444446,0.17012666666666668,120240,8550,122203,completed
927,111967,3919,2,6-12,2,0.4074136944444445,0.6792933333333333,120240,8273,124159,completed
932,112707,2483,1,2-6,1,0.12907565277777777,0.21519333333333335,120240,7533,122723,completed
934,112813,4320,1,12-24,1,0.22413,0.3744,120240,7427,124560,completed
953,114680,4320,1,6-12,1,0.22413,0.3744,120240,5560,124560,completed
957,115594,3865,1,6-12,1,0.20095659722222223,0.3349666666666667,120240,4646,124105,completed
958,115594,3997,1,6-12,1,0.20767943055555554,0.3464066666666667,120240,4646,124237,completed
959,115742,4320,1,6-12,1,0.22413,0.3744,120240,4498,124560,completed
960,116147,3921,2,6-12,2,0.4076174166666667,0.67964,120240,4093,124161,completed
961,116179,107,1,0-2,1,0.005320277777777778,0.0018546666666666666,120240,4061,120347,completed
962,116366,422,1,0-2,1,0.02098277777777778,0.007314666666666666,120240,3874,120662,completed
963,116384,504,1,0-2,1,0.02506000000000001,0.008735999999999999,120240,3856,120744,completed
964,116389,860,1,0-2,1,0.043045000000000014,0.014906666666666665,120240,3851,121100,completed
965,116391,166,1,0-2,1,0.008253888888888887,0.0028773333333333333,120240,3849,120406,completed
966,116396,529,1,0-2,1,0.02630305555555556,0.009169333333333333,120240,3844,120769,completed
967,116425,3654,1,6-12,1,0.19021025000000003,0.31668,120240,3815,123894,completed
968,116852,77,1,0-2,1,0.003828611111111111,0.0013346666666666665,120240,3388,120317,completed
969,116940,82,1,0-2,1,0.004077222222222222,0.0014213333333333333,120240,3300,120322,completed
970,117908,197,4,0-2,3-4,0.03918111111111111,0.013658666666666666,120240,2332,120437,completed
971,118075,2160,1,6-12,1,0.11135999999999999,0.1872,120240,2165,122400,completed
972,118415,524,3,0-2,3-4,0.07816333333333335,0.027247999999999998,120240,1825,120764,completed
973,118433,2160,1,6-12,1,0.11135999999999999,0.1872,120240,1807,122400,completed
974,118440,2160,1,6-12,1,0.11135999999999999,0.1872,120240,1800,122400,completed
975,118737,60,1,0-2,1,0.0029833333333333335,0.00104,120240,1503,120300,completed
976,119044,492,1,0-2,1,0.02446333333333334,0.008527999999999999,120240,1196,120732,completed
977,119133,1301,1,0-2,1,0.06586675,0.022550666666666667,120240,1107,121541,completed
978,119139,2160,2,24-48,2,0.22271999999999997,0.3744,120240,1101,122400,completed
979,119140,2160,2,24-48,2,0.22271999999999997,0.3744,120240,1100,122400,completed
980,119164,1395,1,0-2,1,0.07073125000000001,0.02418,120240,1076,121635,completed
981,119416,800,1,0-2,1,0.03994000000000001,0.013866666666666666,120240,824,121040,completed
982,119581,439,1,0-2,1,0.02182805555555556,0.0076093333333333325,120240,659,120679,completed
983,119818,1083,1,0-2,1,0.05458525,0.018772,120240,422,121323,completed
984,119826,435,1,0-2,1,0.02162916666666667,0.00754,120240,414,120675,completed
985,119964,2160,1,12-24,1,0.11135999999999999,0.1872,120240,276,122400,completed
986,119977,90,1,0-2,1,0.004475,0.00156,120240,263,120330,completed
987,120082,406,1,0-2,1,0.020187222222222224,0.007037333333333333,120240,158,120646,completed
988,120092,80,1,0-2,1,0.003977777777777778,0.0013866666666666667,120240,148,120320,completed
989,120141,428,1,0-2,1,0.021281111111111115,0.007418666666666666,120240,99,120668,completed
990,120214,1767,1,2-6,1,0.09045458333333334,0.15314,120240,26,122007,completed
991,120215,1337,1,0-2,1,0.06772975,0.023174666666666666,120240,25,121577,completed
992,120215,1221,1,0-2,1,0.06172675,0.021164,120240,25,121461,completed
993,120305,98,1,0-2,1,0.004872777777777778,0.0016986666666666665,120305,0,120403,completed
994,120358,97,1,0-2,1,0.004823055555555556,0.0016813333333333333,120358,0,120455,completed
995,120458,63,1,0-2,1,0.0031325000000000003,0.0010919999999999999,120458,0,120521,completed
996,120649,227,1,0-2,1,0.011286944444444447,0.003934666666666666,120649,0,120876,completed
997,120665,67,1,0-2,1,0.003331388888888889,0.0011613333333333332,120665,0,120732,completed
998,120678,132,1,0-2,1,0.006563333333333333,0.0022879999999999997,120678,0,120810,completed
999,120951,272,1,0-2,1,0.014057749999999999,0.0047146666666666665,120951,0,121223,completed
971,118075,1407,1,6-12,1,0.07159929166666668,0.12194,123120,5045,124527,completed
973,118433,1440,1,6-12,1,0.07328,0.12480000000000001,123120,4687,124560,completed
974,118440,1440,1,6-12,1,0.07328,0.12480000000000001,123120,4680,124560,completed
978,119139,1440,2,24-48,2,0.14656,0.24960000000000002,123120,3981,124560,completed
979,119140,1440,2,24-48,2,0.14656,0.24960000000000002,123120,3980,124560,completed
985,119964,1440,1,12-24,1,0.07328,0.12480000000000001,123120,3156,124560,completed
905,109421,720,1,24-48,1,0.039430000000000014,0.062400000000000004,126000,16579,126720,completed
918,109971,720,3,12-24,3-4,0.11829000000000003,0.1872,126000,16029,126720,completed
934,112813,720,1,12-24,1,0.039430000000000014,0.062400000000000004,126000,13187,126720,completed
953,114680,647,1,6-12,1,0.035432236111111126,0.056073333333333336,126000,11320,126647,completed
959,115742,720,1,6-12,1,0.039430000000000014,0.062400000000000004,126000,10258,126720,completed
973,118433,720,1,6-12,1,0.039430000000000014,0.062400000000000004,126000,7567,126720,completed
974,118440,720,1,6-12,1,0.039430000000000014,0.062400000000000004,126000,7560,126720,completed
978,119139,720,2,24-48,2,0.07886000000000003,0.12480000000000001,126000,6861,126720,completed
979,119140,720,2,24-48,2,0.07886000000000003,0.12480000000000001,126000,6860,126720,completed
985,119964,720,1,12-24,1,0.039430000000000014,0.062400000000000004,126000,6036,126720,completed
905,109421,23502,1,24-48,1,2.552107625,2.03684,131741,22320,155243,completed
918,109971,1095,3,12-24,3-4,0.26605700000000004,0.2847,132291,22320,133386,completed
934,112813,720,1,12-24,1,0.03926000000000001,0.062400000000000004,134640,21827,135360,completed
959,115742,14,1,6-12,1,0.000763388888888889,0.0012133333333333334,134640,18898,134654,completed
973,118433,668,1,6-12,1,0.03642455555555556,0.05789333333333333,134640,16207,135308,completed
974,118440,511,1,6-12,1,0.02786369444444445,0.04428666666666667,134640,16200,135151,completed
978,119139,720,2,24-48,2,0.07852000000000002,0.12480000000000001,134640,15501,135360,completed
979,119140,720,2,24-48,2,0.07852000000000002,0.12480000000000001,134640,15500,135360,completed
985,119964,720,1,12-24,1,0.03926000000000001,0.062400000000000004,134640,14676,135360,completed
934,112813,4663,1,12-24,1,0.2614955972222222,0.4041266666666667,135853,23040,140516,completed
978,119139,2880,2,24-48,2,0.30188000000000004,0.49920000000000003,137520,18381,140400,completed
979,119140,2880,2,24-48,2,0.30188000000000004,0.49920000000000003,137520,18380,140400,completed
985,119964,2629,1,12-24,1,0.13793331944444445,0.22784666666666667,137520,17556,140149,completed
978,119139,11922,2,24-48,2,3.9895093333333334,2.06648,144339,25200,156261,completed
979,119140,11928,2,24-48,2,3.992869333333333,2.06752,144340,25200,156268,completed
-1,0,0,0,0,0,0.0,0.0,0,0,0,0
