ID,arrival_time,length,cpus,length_class,resource_class,carbon_cost,dollar_cost,start_time,waiting_time,exit_time,reason
0,0,1260,1,0-2,1,0.17048750000000001,0.02184,0,0,1260,completed
1,13,200,1,0-2,1,0.02670555555555556,0.0034666666666666665,13,0,213,completed
2,92,314,3,0-2,3-4,0.12578316666666667,0.016328,92,0,406,completed
9,810,4732,3,6-12,3-4,1.4933004166666668,1.23032,3690,2880,8422,completed
3,167,4709,1,6-12,1,0.4909705555555556,0.40811333333333333,3767,3600,8476,completed
25,3134,34571,2,48+,2,21.86251,5.992306666666667,3854,720,38425,completed
21,2555,3388,1,6-12,1,0.356517375,0.29362666666666665,3995,1440,7383,completed
28,3284,2472,1,2-6,1,0.27679838888888886,0.21424,4004,720,6476,completed
17,1997,1667,1,2-6,1,0.20267327777777777,0.14447333333333334,4157,2160,5824,completed
12,1284,5424,1,6-12,1,0.5739153333333333,0.47008,4164,2880,9588,completed
7,587,10992,1,12-24,1,2.1507993888888883,0.95264,4187,3600,15179,completed
8,601,10569,1,12-24,1,2.041220694444444,0.91598,4201,3600,14770,completed
32,3505,2215,1,2-6,1,0.2402913888888889,0.19196666666666667,4225,720,6440,completed
13,1389,2434,2,2-6,2,0.5114412777777778,0.42189333333333334,4269,2880,6703,completed
35,4543,2548,1,2-6,1,0.2490442916666667,0.22082666666666667,4543,0,7091,completed
36,4712,5939,1,12-24,1,0.698753861111111,0.5147133333333334,4712,0,10651,completed
4,397,133,1,0-2,1,0.019083652777777783,0.0023053333333333333,4717,4320,4850,completed
5,523,125,2,0-2,2,0.03587152777777779,0.004333333333333333,4843,4320,4968,completed
6,523,125,2,0-2,2,0.03587152777777779,0.004333333333333333,4843,4320,4968,completed
33,4268,61,1,0-2,1,0.008330277777777782,0.0010573333333333333,4988,720,5049,completed
34,4465,709,1,0-2,1,0.06595841666666666,0.012289333333333333,5185,720,5894,completed
10,958,350,2,0-2,2,0.06758888888888889,0.012133333333333333,5278,4320,5628,completed
29,3291,95,2,0-2,2,0.018345555555555566,0.003293333333333333,5451,2160,5546,completed
11,1159,565,1,0-2,1,0.049256499999999995,0.009793333333333333,5479,4320,6044,completed
30,3349,704,1,0-2,1,0.05952540277777777,0.012202666666666665,5509,2160,6213,completed
22,2660,97,1,0-2,1,0.009365888888888889,0.0016813333333333333,5540,2880,5637,completed
41,5540,4093,1,6-12,1,0.4064175555555556,0.3547266666666667,5540,0,9633,completed
37,4901,471,2,0-2,2,0.07856988888888888,0.016328,5621,720,6092,completed
31,3487,285,3,0-2,3-4,0.07293016666666666,0.01482,5647,2160,5932,completed
18,2096,83,1,0-2,1,0.007659708333333332,0.0014386666666666667,5696,3600,5779,completed
23,2887,183,4,0-2,3-4,0.057024833333333316,0.012688,5767,2880,5950,completed
14,1515,408,1,0-2,1,0.03178433333333333,0.007071999999999999,5835,4320,6243,completed
19,2253,494,1,0-2,1,0.03848397222222222,0.008562666666666666,5853,3600,6347,completed
20,2299,112,1,0-2,1,0.00872511111111111,0.001941333333333333,5899,3600,6011,completed
24,3055,65,1,0-2,1,0.005063680555555555,0.0011266666666666667,5935,2880,6000,completed
15,1725,222,1,0-2,1,0.017294416666666663,0.003848,6045,4320,6267,completed
16,1725,222,1,0-2,1,0.017294416666666663,0.003848,6045,4320,6267,completed
26,3178,74,1,0-2,1,0.005764805555555554,0.0012826666666666665,6058,2880,6132,completed
27,3179,68,1,0-2,1,0.005297388888888887,0.0011786666666666666,6059,2880,6127,completed
38,5372,118,2,0-2,2,0.01838505555555555,0.004090666666666666,6092,720,6210,completed
39,5372,118,2,0-2,2,0.01838505555555555,0.004090666666666666,6092,720,6210,completed
40,5375,67,4,0-2,3-4,0.02087794444444444,0.004645333333333333,6095,720,6162,completed
42,6242,427,1,0-2,1,0.03466361111111111,0.007401333333333333,6242,0,6669,completed
43,6624,320,2,0-2,2,0.05459555555555557,0.011093333333333334,6624,0,6944,completed
44,6646,707,1,0-2,1,0.06115040277777779,0.012254666666666665,6646,0,7353,completed
45,6666,2386,1,2-6,1,0.22753772222222224,0.20678666666666667,6666,0,9052,completed
46,6676,4359,1,6-12,1,0.5972655972222223,0.37778,6676,0,11035,completed
47,6699,67,2,0-2,2,0.011430944444444447,0.0023226666666666665,6699,0,6766,completed
48,6819,3748,1,6-12,1,0.47969683333333335,0.32482666666666665,6819,0,10567,completed
49,6921,77,1,0-2,1,0.006568527777777779,0.0013346666666666665,6921,0,6998,completed
51,7487,296,1,0-2,1,0.026874333333333333,0.005130666666666666,7487,0,7783,completed
52,7691,88,3,0-2,3-4,0.023969000000000004,0.004575999999999999,7691,0,7779,completed
54,7991,77,1,0-2,1,0.00705298611111111,0.0013346666666666665,7991,0,8068,completed
59,8170,69,1,0-2,1,0.006320208333333332,0.001196,8170,0,8239,completed
60,8215,254,1,0-2,1,0.023265694444444443,0.004402666666666667,8215,0,8469,completed
69,9287,328,1,0-2,1,0.05363030555555555,0.005685333333333333,9287,0,9615,completed
72,9366,756,1,0-2,1,0.1337618333333333,0.013104,9366,0,10122,completed
74,9486,131,1,0-2,1,0.022939555555555553,0.0022706666666666665,9486,0,9617,completed
76,9583,85,1,0-2,1,0.01488444444444444,0.0014733333333333332,9583,0,9668,completed
77,9585,69,1,0-2,1,0.012082666666666662,0.001196,9585,0,9654,completed
78,9614,117,1,0-2,1,0.020488000000000003,0.002028,9614,0,9731,completed
80,9670,1169,3,0-2,3-4,0.6928282916666666,0.060787999999999995,9670,0,10839,completed
85,10387,1318,2,0-2,2,0.6423662499999999,0.045690666666666664,10387,0,11705,completed
89,11103,302,1,0-2,1,0.07315530555555554,0.005234666666666666,11103,0,11405,completed
91,11404,79,1,0-2,1,0.024638125,0.0013693333333333333,14284,2880,14363,completed
92,11435,465,1,0-2,1,0.12524076388888888,0.00806,14315,2880,14780,completed
112,13597,1366,3,0-2,3-4,1.1114115416666663,0.071032,14317,720,15683,completed
117,14363,970,1,0-2,1,0.25820204166666666,0.016813333333333333,14363,0,15333,completed
118,14370,67,1,0-2,1,0.01896956944444444,0.0011613333333333332,14370,0,14437,completed
110,12955,1388,3,0-2,3-4,1.1223661249999999,0.07217599999999999,14395,1440,15783,completed
119,14525,96,1,0-2,1,0.024942666666666665,0.001664,14525,0,14621,completed
114,13823,61,1,0-2,1,0.01584898611111111,0.0010573333333333333,14543,720,14604,completed
99,12477,220,1,0-2,1,0.057160277777777775,0.003813333333333333,14637,2160,14857,completed
111,13242,189,1,0-2,1,0.04910587499999999,0.003276,14682,1440,14871,completed
93,11821,91,1,0-2,1,0.023643569444444443,0.0015773333333333331,14701,2880,14792,completed
94,11855,68,1,0-2,1,0.01766772222222222,0.0011786666666666666,14735,2880,14803,completed
95,11860,1379,3,0-2,3-4,1.2063911666666667,0.071708,14740,2880,16119,completed
90,11213,175,1,0-2,1,0.04546840277777778,0.003033333333333333,14813,3600,14988,completed
121,14823,81,3,0-2,3-4,0.06313612499999999,0.004212,14823,0,14904,completed
96,11952,277,1,0-2,1,0.0719699861111111,0.004801333333333333,14832,2880,15109,completed
97,11979,62,1,0-2,1,0.016108805555555553,0.0010746666666666667,14859,2880,14921,completed
116,14272,471,2,0-2,2,0.2584413333333333,0.016328,14992,720,15463,completed
123,15017,98,1,0-2,1,0.025462305555555554,0.0016986666666666665,15017,0,15115,completed
124,15068,1330,1,0-2,1,0.41886861111111107,0.023053333333333332,15068,0,16398,completed
126,15263,125,1,0-2,1,0.0349722222222222,0.0021666666666666666,15263,0,15388,completed
127,15338,105,1,0-2,1,0.02937666666666666,0.0018199999999999998,15338,0,15443,completed
132,15766,67,1,0-2,1,0.018745111111111108,0.0011613333333333332,15766,0,15833,completed
137,16372,415,1,0-2,1,0.14857918055555558,0.007193333333333333,16372,0,16787,completed
138,16667,292,1,0-2,1,0.10274750000000003,0.005061333333333333,16667,0,16959,completed
134,16100,884,1,0-2,1,0.31576861111111115,0.015322666666666665,16820,720,17704,completed
139,16918,91,1,0-2,1,0.03202062500000001,0.0015773333333333331,16918,0,17009,completed
140,16919,621,1,0-2,1,0.22140326388888895,0.010764,16919,0,17540,completed
142,16963,60,1,0-2,1,0.02111250000000001,0.00104,16963,0,17023,completed
136,16330,104,1,0-2,1,0.03659500000000001,0.0018026666666666666,17050,720,17154,completed
144,17338,1163,1,0-2,1,0.37131591666666663,0.020158666666666665,21658,4320,22821,completed
143,17338,1175,1,0-2,1,0.37452325,0.020366666666666665,21658,4320,22833,completed
145,17338,1168,1,0-2,1,0.3726523055555555,0.02024533333333333,21658,4320,22826,completed
189,20538,884,1,0-2,1,0.26751430555555555,0.015322666666666665,21978,1440,22862,completed
147,17682,861,3,0-2,3-4,0.77752375,0.044772,22002,4320,22863,completed
148,17703,378,1,0-2,1,0.128161125,0.006552,22023,4320,22401,completed
149,17795,1518,1,2-6,1,0.3973735138888889,0.13156,22115,4320,23633,completed
183,19962,388,1,0-2,1,0.12179052777777778,0.006725333333333333,22122,2160,22510,completed
184,19996,103,1,0-2,1,0.03693837500000001,0.0017853333333333332,22156,2160,22259,completed
150,17871,2813,1,2-6,1,0.6238424027777778,0.24379333333333333,22191,4320,25004,completed
194,21484,69,1,0-2,1,0.024745125000000007,0.001196,22204,720,22273,completed
151,17888,69,1,0-2,1,0.024745125000000007,0.001196,22208,4320,22277,completed
152,17930,62,1,0-2,1,0.022234750000000008,0.0010746666666666667,22250,4320,22312,completed
170,18652,9340,3,12-24,3-4,6.9201955,2.4284,22252,3600,31592,completed
195,21563,745,1,0-2,1,0.20250179166666665,0.012913333333333332,22283,720,23028,completed
186,20149,440,1,0-2,1,0.11860704166666666,0.007626666666666666,22309,2160,22749,completed
196,21591,610,1,0-2,1,0.16386156944444444,0.010573333333333332,22311,720,22921,completed
125,15128,3727,2,6-12,2,1.4745735555555557,0.6460133333333333,22328,7200,26055,completed
187,20173,261,1,0-2,1,0.0697595,0.004523999999999999,22333,2160,22594,completed
133,15873,22293,1,24-48,1,7.383436166666667,1.93206,22353,6480,44646,completed
197,21637,784,1,0-2,1,0.20493344444444445,0.013589333333333332,22357,720,23141,completed
198,21673,782,1,0-2,1,0.2028462222222222,0.013554666666666666,22393,720,23175,completed
179,19580,255,4,0-2,3-4,0.27262333333333344,0.017679999999999998,22460,2880,22715,completed
120,14545,4946,1,6-12,1,0.9002458055555556,0.42865333333333333,22465,7920,27411,completed
155,18145,1322,1,0-2,1,0.3183754722222223,0.022914666666666667,22465,4320,23787,completed
157,18145,1479,1,2-6,1,0.3482098333333334,0.12818,22465,4320,23944,completed
153,18145,1319,1,0-2,1,0.31780538888888893,0.022862666666666667,22465,4320,23784,completed
156,18145,949,1,0-2,1,0.2365672777777778,0.016449333333333333,22465,4320,23414,completed
158,18145,1042,1,0-2,1,0.2571771111111112,0.018061333333333332,22465,4320,23507,completed
159,18145,358,1,0-2,1,0.09568544444444446,0.006205333333333333,22465,4320,22823,completed
154,18145,1347,1,0-2,1,0.3231261666666667,0.023347999999999997,22465,4320,23812,completed
160,18146,1686,1,2-6,1,0.3874683333333334,0.14612,22466,4320,24152,completed
161,18146,1643,1,2-6,1,0.37929713888888894,0.14239333333333334,22466,4320,24109,completed
162,18172,1862,1,2-6,1,0.4189047222222223,0.16137333333333334,22492,4320,24354,completed
163,18178,1994,1,2-6,1,0.44327722222222227,0.17281333333333335,22498,4320,24492,completed
199,21778,1145,1,0-2,1,0.27849605555555557,0.019846666666666665,22498,720,23643,completed
164,18222,581,1,0-2,1,0.15149805555555557,0.010070666666666665,22542,4320,23123,completed
165,18273,1440,1,2-6,1,0.33091075000000003,0.12480000000000001,22593,4320,24033,completed
180,19717,80,1,0-2,1,0.021382222222222223,0.0013866666666666667,22597,2880,22677,completed
181,19736,176,1,0-2,1,0.04704088888888889,0.0030506666666666664,22616,2880,22792,completed
101,12539,3275,1,6-12,1,0.6359374722222222,0.2838333333333333,22619,10080,25894,completed
100,12539,3768,1,6-12,1,0.7077965,0.32656,22619,10080,26387,completed
103,12549,1730,1,2-6,1,0.3832378055555556,0.14993333333333334,22629,10080,24359,completed
102,12549,1730,1,2-6,1,0.3832378055555556,0.14993333333333334,22629,10080,24359,completed
166,18309,1759,1,2-6,1,0.38874861111111114,0.15244666666666667,22629,4320,24388,completed
146,17611,2681,1,2-6,1,0.5422962222222223,0.23235333333333333,22651,5040,25332,completed
200,21946,611,1,0-2,1,0.15248372222222223,0.010590666666666667,22666,720,23277,completed
167,18357,1426,1,0-2,1,0.3217613611111112,0.02471733333333333,22677,4320,24103,completed
188,20527,93,1,0-2,1,0.024856833333333342,0.001612,22687,2160,22780,completed
141,16929,6422,2,12-24,2,2.4444833333333333,1.1131466666666667,22689,5760,29111,completed
190,20543,1531,1,2-6,1,0.3397057777777778,0.13268666666666667,22703,2160,24234,completed
135,16234,2495,1,2-6,1,0.5068351805555555,0.21623333333333333,22714,6480,25209,completed
88,10477,12607,1,24-48,1,3.935582611111111,1.0926066666666667,22717,12240,35324,completed
191,20566,1466,1,2-6,1,0.3255772222222223,0.12705333333333332,22726,2160,24192,completed
104,12664,5781,1,12-24,1,1.033587,0.50102,22744,10080,28525,completed
122,14830,1875,1,2-6,1,0.3984519444444445,0.1625,22750,7920,24625,completed
176,19151,156,4,0-2,3-4,0.16678133333333336,0.010816,22751,3600,22907,completed
81,9793,5813,1,12-24,1,1.0400147222222222,0.5037933333333333,22753,12960,28566,completed
177,19153,64,1,0-2,1,0.01710577777777778,0.0011093333333333333,22753,3600,22817,completed
128,15562,1740,1,2-6,1,0.37440977777777784,0.1508,22762,7200,24502,completed
129,15565,1927,1,2-6,1,0.40579183333333335,0.16700666666666666,22765,7200,24692,completed
182,19900,375,1,0-2,1,0.09497749999999999,0.0065,22780,2880,23155,completed
168,18471,374,2,0-2,2,0.18850711111111113,0.012965333333333332,22791,4320,23165,completed
82,9840,6355,1,12-24,1,1.2088025,0.5507666666666666,22800,12960,29155,completed
169,18508,193,4,0-2,3-4,0.20633844444444444,0.013381333333333332,22828,4320,23021,completed
201,22124,84,1,0-2,1,0.02245133333333334,0.0014559999999999998,22844,720,22928,completed
98,12054,2661,1,2-6,1,0.5157455416666668,0.23062,22854,10800,25515,completed
115,14245,4271,2,6-12,2,1.4988577777777778,0.7403066666666667,22885,8640,27156,completed
68,9224,9360,1,12-24,1,2.375909,0.8112,22904,13680,32264,completed
178,19312,230,2,0-2,2,0.11363177777777778,0.007973333333333332,22912,3600,23142,completed
185,20036,11017,1,12-24,1,3.146419527777778,0.9548066666666667,22916,2880,33933,completed
130,15724,3285,1,6-12,1,0.6003876666666668,0.2847,22924,7200,26209,completed
131,15730,3684,1,6-12,1,0.657689,0.31928,22930,7200,26614,completed
106,12851,4743,1,6-12,1,0.8197395555555556,0.41106,22931,10080,27674,completed
105,12851,4752,1,6-12,1,0.8212468055555555,0.41184,22931,10080,27683,completed
107,12852,4772,1,6-12,1,0.8244964444444445,0.41357333333333335,22932,10080,27704,completed
108,12857,4809,1,6-12,1,0.830193888888889,0.41678,22937,10080,27746,completed
109,12877,3134,1,6-12,1,0.5744050555555555,0.2716133333333333,22957,10080,26091,completed
70,9317,9595,1,12-24,1,2.4841649444444442,0.8315666666666667,22997,13680,32592,completed
192,20837,10936,1,12-24,1,3.1247700277777777,0.9477866666666667,22997,2160,33933,completed
53,7879,4327,1,6-12,1,0.7439751944444444,0.37500666666666665,22999,15120,27326,completed
71,9334,10055,1,12-24,1,2.6844132222222226,0.8714333333333334,23014,13680,33069,completed
64,8680,4991,1,6-12,1,0.8482283055555556,0.43255333333333335,23080,14400,28071,completed
73,9461,6613,1,12-24,1,1.3559637777777778,0.5731266666666667,23141,13680,29754,completed
83,10187,8318,1,12-24,1,2.0199755277777776,0.7208933333333334,23147,12960,31465,completed
113,13795,1553,1,2-6,1,0.3095153888888889,0.13459333333333334,23155,9360,24708,completed
75,9489,7096,1,12-24,1,1.5650889027777777,0.6149866666666667,23169,13680,30265,completed
55,8059,7351,1,12-24,1,1.6643861944444442,0.6370866666666667,23179,15120,30530,completed
65,8791,2081,1,2-6,1,0.3957777222222223,0.18035333333333334,23191,14400,25272,completed
193,21039,31269,2,24-48,2,18.848787666666666,5.41996,23199,2160,54468,completed
171,18888,157,4,0-2,3-4,0.13917177777777778,0.010885333333333332,23208,4320,23365,completed
211,23227,2388,1,2-6,1,0.439730875,0.20696,23227,0,25615,completed
172,18909,195,1,0-2,1,0.04321416666666668,0.0033799999999999998,23229,4320,23424,completed
56,8115,6930,1,12-24,1,1.50913375,0.6006,23235,15120,30165,completed
57,8139,2558,1,2-6,1,0.46322268055555554,0.22169333333333333,23259,15120,25817,completed
58,8157,6180,1,12-24,1,1.2035216666666668,0.5356,23277,15120,29457,completed
84,10348,2954,1,6-12,1,0.5177002222222222,0.2560133333333333,23308,12960,26262,completed
50,7474,11448,4,12-24,3-4,13.911450111111112,3.96864,23314,15840,34762,completed
173,19019,327,1,0-2,1,0.07246683333333334,0.005667999999999999,23339,4320,23666,completed
79,9665,4987,1,6-12,1,0.8453006111111112,0.4322066666666667,23345,13680,28332,completed
61,8229,2321,1,2-6,1,0.4210214722222222,0.20115333333333332,23349,15120,25670,completed
86,10396,9304,1,12-24,1,2.431837555555555,0.8063466666666667,23356,12960,32660,completed
174,19063,71,1,0-2,1,0.015734388888888895,0.0012306666666666666,23383,4320,23454,completed
62,8277,7144,1,12-24,1,1.6202887361111111,0.6191466666666666,23397,15120,30541,completed
87,10457,7078,1,12-24,1,1.5982353194444447,0.6134266666666667,23417,12960,30495,completed
63,8304,7286,1,12-24,1,1.6790439722222223,0.6314533333333333,23424,15120,30710,completed
66,9037,6248,1,12-24,1,1.2611549722222222,0.5414933333333334,23437,14400,29685,completed
175,19128,880,4,0-2,3-4,0.7083137777777777,0.06101333333333333,23448,4320,24328,completed
67,9049,4386,1,6-12,1,0.7269303611111111,0.38012,23449,14400,27835,completed
207,22888,1607,1,2-6,1,0.2947359305555556,0.13927333333333333,23608,720,25215,completed
215,23773,3220,4,6-12,3-4,2.087938277777778,1.1162666666666667,23773,0,26993,completed
202,22438,277,1,0-2,1,0.05263769444444445,0.004801333333333333,23878,1440,24155,completed
203,22509,78,1,0-2,1,0.014822166666666671,0.001352,23949,1440,24027,completed
204,22509,122,1,0-2,1,0.023183388888888885,0.0021146666666666666,23949,1440,24071,completed
205,22647,224,1,0-2,1,0.042566222222222214,0.003882666666666666,24087,1440,24311,completed
206,22818,61,1,0-2,1,0.01159169444444445,0.0010573333333333333,24258,1440,24319,completed
208,22931,197,1,0-2,1,0.03561924999999999,0.0034146666666666665,24371,1440,24568,completed
209,22988,199,1,0-2,1,0.03478161111111111,0.0034493333333333333,24428,1440,24627,completed
210,23087,542,1,0-2,1,0.09180877777777777,0.009394666666666666,24527,1440,25069,completed
212,23478,251,1,0-2,1,0.042516611111111116,0.004350666666666667,24918,1440,25169,completed
219,24289,203,1,0-2,1,0.03417011111111111,0.0035186666666666665,25009,720,25212,completed
220,24359,96,1,0-2,1,0.016261333333333333,0.001664,25079,720,25175,completed
221,24363,87,1,0-2,1,0.014736833333333333,0.001508,25083,720,25170,completed
213,23710,897,1,0-2,1,0.1359508888888889,0.015548,25150,1440,26047,completed
214,23725,67,1,0-2,1,0.010773500000000002,0.0011613333333333332,25165,1440,25232,completed
222,24481,378,1,0-2,1,0.05723025000000001,0.006552,25201,720,25579,completed
216,23810,879,1,0-2,1,0.13183775000000003,0.015236,25250,1440,26129,completed
217,23906,337,1,0-2,1,0.05102273611111112,0.005841333333333333,25346,1440,25683,completed
218,24058,65,1,0-2,1,0.009841180555555556,0.0011266666666666667,25498,1440,25563,completed
225,24890,103,1,0-2,1,0.015594486111111116,0.0017853333333333332,25610,720,25713,completed
226,25081,67,1,0-2,1,0.010143986111111112,0.0011613333333333332,25801,720,25868,completed
230,25585,1313,1,0-2,1,0.1978817222222222,0.022758666666666667,26305,720,27618,completed
231,25598,189,2,0-2,2,0.054977999999999985,0.006552,26318,720,26507,completed
232,25598,189,2,0-2,2,0.054977999999999985,0.006552,26318,720,26507,completed
236,26334,88,1,0-2,1,0.012799111111111108,0.0015253333333333332,26334,0,26422,completed
234,25678,125,1,0-2,1,0.018180555555555554,0.0021666666666666666,26398,720,26523,completed
235,25725,83,2,0-2,2,0.024143777777777774,0.0028773333333333333,26445,720,26528,completed
237,26539,534,1,0-2,1,0.07840704166666665,0.009255999999999999,26539,0,27073,completed
239,26559,592,1,0-2,1,0.08697606944444444,0.010261333333333332,26559,0,27151,completed
240,26611,73,1,0-2,1,0.01069261111111111,0.0012653333333333332,26611,0,26684,completed
241,26639,197,1,0-2,1,0.028987388888888882,0.0034146666666666665,26639,0,26836,completed
242,26777,143,1,0-2,1,0.021042847222222216,0.0024786666666666663,26777,0,26920,completed
243,26797,231,1,0-2,1,0.03399229166666666,0.004004,26797,0,27028,completed
244,26884,67,1,0-2,1,0.009859236111111109,0.0011613333333333332,26884,0,26951,completed
245,26885,65,1,0-2,1,0.009564930555555554,0.0011266666666666667,26885,0,26950,completed
246,26889,283,1,0-2,1,0.04164423611111111,0.004905333333333333,26889,0,27172,completed
247,26892,107,1,0-2,1,0.01574534722222222,0.0018546666666666666,26892,0,26999,completed
248,26993,784,1,0-2,1,0.12384098611111112,0.013589333333333332,26993,0,27777,completed
249,27169,459,1,0-2,1,0.0729887361111111,0.007956,27169,0,27628,completed
250,27246,67,1,0-2,1,0.009859236111111109,0.0011613333333333332,27246,0,27313,completed
251,27251,114,1,0-2,1,0.016877013888888886,0.001976,27251,0,27365,completed
252,27321,949,1,0-2,1,0.16725340277777778,0.016449333333333333,27321,0,28270,completed
255,27921,1215,1,0-2,1,0.30567608333333335,0.02106,27921,0,29136,completed
256,28282,798,1,0-2,1,0.21487355555555557,0.013831999999999999,28282,0,29080,completed
257,28287,753,1,0-2,1,0.19904300000000003,0.013052,28287,0,29040,completed
258,28360,133,1,0-2,1,0.02865411111111112,0.0023053333333333333,28360,0,28493,completed
259,28672,1075,1,0-2,1,0.3892398611111111,0.01863333333333333,28672,0,29747,completed
268,29728,247,1,0-2,1,0.0946181527777778,0.004281333333333333,30448,720,30695,completed
270,29934,288,1,0-2,1,0.11032400000000002,0.004992,30654,720,30942,completed
271,29949,186,1,0-2,1,0.07125091666666668,0.003224,30669,720,30855,completed
264,29282,1011,3,0-2,3-4,1.1188233749999998,0.052571999999999994,30722,1440,31733,completed
265,29298,70,1,0-2,1,0.026814861111111105,0.0012133333333333332,30738,1440,30808,completed
272,30024,284,1,0-2,1,0.10748933333333333,0.004922666666666666,30744,720,31028,completed
273,30093,457,1,0-2,1,0.16912537500000002,0.007921333333333332,30813,720,31270,completed
266,29466,77,1,0-2,1,0.029055833333333322,0.0013346666666666665,30906,1440,30983,completed
260,28863,317,1,0-2,1,0.1153615833333333,0.005494666666666666,31023,2160,31340,completed
275,30345,124,1,0-2,1,0.04512566666666666,0.0021493333333333334,31065,720,31189,completed
276,30346,324,1,0-2,1,0.11790899999999996,0.0056159999999999995,31066,720,31390,completed
277,30347,142,1,0-2,1,0.05167616666666665,0.002461333333333333,31067,720,31209,completed
278,30349,123,1,0-2,1,0.044761749999999996,0.0021319999999999998,31069,720,31192,completed
279,30353,370,1,0-2,1,0.13464916666666665,0.0064133333333333325,31073,720,31443,completed
262,29069,1100,4,0-2,3-4,1.623912277777778,0.07626666666666666,31229,2160,32329,completed
282,31235,110,1,0-2,1,0.04003083333333332,0.0019066666666666665,31235,0,31345,completed
263,29169,160,1,0-2,1,0.05822666666666665,0.0027733333333333334,31329,2160,31489,completed
280,30629,586,1,0-2,1,0.21548287499999996,0.010157333333333332,31349,720,31935,completed
283,31921,268,1,0-2,1,0.09987094444444447,0.004645333333333333,31921,0,32189,completed
284,32262,1421,1,0-2,1,0.6478559305555556,0.024630666666666665,32262,0,33683,completed
285,32302,67,1,0-2,1,0.02496773611111111,0.0011613333333333332,32302,0,32369,completed
287,32401,403,1,0-2,1,0.17302133333333333,0.006985333333333333,32401,0,32804,completed
288,32442,68,1,0-2,1,0.029194666666666664,0.0011786666666666666,32442,0,32510,completed
289,32572,127,2,0-2,2,0.10905066666666664,0.004402666666666667,32572,0,32699,completed
291,32694,108,1,0-2,1,0.04636799999999999,0.001872,32694,0,32802,completed
294,33652,190,1,0-2,1,0.09693977777777776,0.003293333333333333,33652,0,33842,completed
295,33694,82,1,0-2,1,0.041846194444444436,0.0014213333333333333,33694,0,33776,completed
296,33771,77,1,0-2,1,0.03921093055555555,0.0013346666666666665,33771,0,33848,completed
292,33074,95,2,0-2,2,0.09593577777777776,0.003293333333333333,33794,720,33889,completed
293,33083,95,2,0-2,2,0.09574752777777776,0.003293333333333333,33803,720,33898,completed
297,33838,68,4,0-2,3-4,0.13555811111111116,0.0047146666666666665,38158,4320,38226,completed
298,33978,91,3,0-2,3-4,0.13540800000000003,0.004732,38298,4320,38389,completed
300,34153,65,1,0-2,1,0.032240000000000005,0.0011266666666666667,38473,4320,38538,completed
301,34156,83,2,0-2,2,0.08233600000000002,0.0028773333333333333,38476,4320,38559,completed
302,34382,133,1,0-2,1,0.06596800000000003,0.0023053333333333333,38702,4320,38835,completed
306,35170,62,1,0-2,1,0.030751999999999998,0.0010746666666666667,38770,3600,38832,completed
307,35197,67,1,0-2,1,0.03323200000000001,0.0011613333333333332,38797,3600,38864,completed
304,34486,1338,1,0-2,1,0.4904071111111112,0.023191999999999997,38806,4320,40144,completed
326,36684,94,1,0-2,1,0.03842988888888889,0.0016293333333333333,38844,2160,38938,completed
335,38128,1022,1,0-2,1,0.3696945000000001,0.017714666666666667,38848,720,39870,completed
332,37535,242,1,0-2,1,0.08584277777777781,0.004194666666666666,38975,1440,39217,completed
308,35461,1514,1,2-6,1,0.5209327777777779,0.13121333333333335,39061,3600,40575,completed
333,37640,120,1,0-2,1,0.04256666666666668,0.00208,39080,1440,39200,completed
299,34091,2289,1,2-6,1,0.6903355555555556,0.19838,39131,5040,41420,completed
290,32670,2561,4,2-6,3-4,2.953554833333334,0.8878133333333333,39150,6480,41711,completed
305,34840,62,1,0-2,1,0.021992777777777778,0.0010746666666666667,39160,4320,39222,completed
309,35609,1228,1,0-2,1,0.43202488888888896,0.021285333333333333,39209,3600,40437,completed
310,35609,1047,1,0-2,1,0.37782661111111115,0.018147999999999997,39209,3600,40256,completed
312,35610,1122,1,0-2,1,0.4039676666666667,0.019448,39210,3600,40332,completed
313,35610,1108,1,0-2,1,0.40007261111111114,0.01920533333333333,39210,3600,40318,completed
311,35610,1576,1,2-6,1,0.5237480000000001,0.13658666666666666,39210,3600,40786,completed
314,35613,2060,1,2-6,1,0.6335694583333334,0.17853333333333335,39213,3600,41273,completed
303,34398,23251,2,24-48,2,9.615063333333334,4.030173333333334,39438,5040,62689,completed
319,36204,3223,1,6-12,1,0.7384432361111111,0.27932666666666667,39804,3600,43027,completed
320,36269,2678,1,2-6,1,0.6266755972222222,0.23209333333333335,39869,3600,42547,completed
328,37065,11598,1,24-48,1,2.6471489166666666,1.00516,39945,2880,51543,completed
329,37107,3611,1,6-12,1,0.7829948333333333,0.31295333333333336,39987,2880,43598,completed
322,36435,5286,1,6-12,1,1.14665425,0.45812,40035,3600,45321,completed
281,30697,3049,4,6-12,3-4,2.6428524444444443,1.0569866666666667,40057,9360,43106,completed
330,37189,5415,3,6-12,3-4,3.5170057500000005,1.4079,40069,2880,45484,completed
315,35760,69,1,0-2,1,0.02515241666666666,0.001196,40080,4320,40149,completed
316,35765,721,1,0-2,1,0.2138870277777778,0.012497333333333333,40085,4320,40806,completed
331,37335,9897,1,12-24,1,2.199013416666667,0.8577400000000001,40215,2880,50112,completed
334,38060,8256,2,12-24,2,3.6429460000000007,1.43104,40220,2160,48476,completed
286,32304,2799,1,2-6,1,0.5846076250000001,0.24258000000000002,40224,7920,43023,completed
274,30204,1703,1,2-6,1,0.3778893194444445,0.14759333333333333,40284,10080,41987,completed
253,27340,2085,1,2-6,1,0.44085006944444444,0.1807,40300,12960,42385,completed
317,36083,192,1,0-2,1,0.05065600000000001,0.003328,40403,4320,40595,completed
327,36816,4714,3,6-12,3-4,2.9189576666666666,1.22564,40416,3600,45130,completed
342,38982,1575,1,2-6,1,0.3395837916666667,0.1365,40422,1440,41997,completed
261,28962,4050,1,6-12,1,0.8177880000000001,0.351,40482,11520,44532,completed
318,36201,63,1,0-2,1,0.016621500000000004,0.0010919999999999999,40521,4320,40584,completed
267,29723,23537,1,24-48,1,4.824867944444445,2.0398733333333334,40523,10800,64060,completed
344,39119,3503,1,6-12,1,0.6941120000000001,0.3035933333333333,40559,1440,44062,completed
345,39130,4834,1,6-12,1,0.9961715555555556,0.4189466666666667,40570,1440,45404,completed
346,39130,4834,1,6-12,1,0.9961715555555556,0.4189466666666667,40570,1440,45404,completed
269,29797,1819,2,2-6,2,0.7316718888888889,0.3152933333333333,40597,10800,42416,completed
321,36280,801,1,0-2,1,0.18405995833333333,0.013883999999999999,40600,4320,41401,completed
224,24763,42957,1,48+,1,7.649009611111111,3.72294,40603,15840,83560,completed
349,39185,2539,2,2-6,2,0.9900306666666667,0.44009333333333334,40625,1440,43164,completed
254,27826,1840,2,2-6,2,0.7076452777777777,0.31893333333333335,40786,12960,42626,completed
323,36471,658,4,0-2,3-4,0.5708231666666668,0.04562133333333333,40791,4320,41449,completed
233,25676,3049,1,6-12,1,0.5853709583333333,0.2642466666666667,40796,15120,43845,completed
353,39363,759,1,0-2,1,0.16081675,0.013156,40803,1440,41562,completed
354,39371,409,1,0-2,1,0.09431033333333333,0.007089333333333333,40811,1440,41220,completed
336,38669,1576,1,2-6,1,0.3027252916666666,0.13658666666666666,40829,2160,42405,completed
355,39403,1236,1,0-2,1,0.24268343055555558,0.021424,40843,1440,42079,completed
324,36530,282,1,0-2,1,0.06745116666666667,0.004888,40850,4320,41132,completed
337,38721,1060,1,0-2,1,0.2088048472222222,0.018373333333333332,40881,2160,41941,completed
325,36581,217,2,0-2,2,0.10271916666666667,0.007522666666666666,40901,4320,41118,completed
338,38746,2142,2,2-6,2,0.7991875555555555,0.37128,40906,2160,43048,completed
356,39481,462,1,0-2,1,0.09598020833333332,0.008008,40921,1440,41383,completed
357,39491,437,1,0-2,1,0.09051749999999999,0.007574666666666666,40931,1440,41368,completed
227,25100,12719,1,24-48,1,2.8045295416666667,1.1023133333333333,40940,15840,53659,completed
238,26542,5113,1,6-12,1,1.050269138888889,0.44312666666666667,40942,14400,46055,completed
228,25104,11168,1,12-24,1,2.4770591111111115,0.9678933333333334,40944,15840,52112,completed
229,25139,3460,1,6-12,1,0.6662105833333334,0.29986666666666667,40979,15840,44439,completed
339,38843,136,1,0-2,1,0.028402708333333335,0.0023573333333333332,41003,2160,41139,completed
340,38845,327,1,0-2,1,0.06421533333333333,0.005667999999999999,41005,2160,41332,completed
360,40319,141,1,0-2,1,0.026624666666666665,0.002444,41039,720,41180,completed
341,38894,870,1,0-2,1,0.16128086111111112,0.01508,41054,2160,41924,completed
223,24590,1898,1,2-6,1,0.34352802777777774,0.16449333333333332,41150,16560,43048,completed
343,39034,1058,1,0-2,1,0.19161391666666666,0.018338666666666666,41194,2160,42252,completed
347,39155,1284,1,0-2,1,0.2300746388888889,0.022255999999999998,41315,2160,42599,completed
358,39886,65,1,0-2,1,0.012238958333333333,0.0011266666666666667,41326,1440,41391,completed
348,39174,93,1,0-2,1,0.017511125,0.001612,41334,2160,41427,completed
359,39922,780,2,0-2,2,0.2819354444444444,0.027039999999999998,41362,1440,42142,completed
350,39237,743,1,0-2,1,0.13403181944444448,0.012878666666666667,41397,2160,42140,completed
351,39247,773,1,0-2,1,0.13906279166666666,0.013398666666666666,41407,2160,42180,completed
361,40724,1134,1,0-2,1,0.20193180555555557,0.019656,41444,720,42578,completed
362,40724,1134,1,0-2,1,0.20193180555555557,0.019656,41444,720,42578,completed
369,41607,1107,1,0-2,1,0.196194375,0.019188,41607,0,42714,completed
363,41001,173,1,0-2,1,0.03050490277777778,0.0029986666666666664,41721,720,41894,completed
364,41001,205,1,0-2,1,0.0360360138888889,0.0035533333333333333,41721,720,41926,completed
365,41312,160,1,0-2,1,0.027655555555555558,0.0027733333333333334,42032,720,42192,completed
367,41325,150,1,0-2,1,0.025927083333333333,0.0026,42045,720,42195,completed
366,41325,150,1,0-2,1,0.025927083333333333,0.0026,42045,720,42195,completed
402,45862,294,1,0-2,1,0.06817536111111111,0.005096,47302,1440,47596,completed
392,45193,394,1,0-2,1,0.08768625000000002,0.006829333333333333,47353,2160,47747,completed
386,44536,824,1,0-2,1,0.17617655555555556,0.014282666666666666,47416,2880,48240,completed
387,44538,185,1,0-2,1,0.041865652777777776,0.0032066666666666663,47418,2880,47603,completed
407,46720,71,2,0-2,2,0.03400702777777777,0.002461333333333333,47440,720,47511,completed
393,45295,1179,1,0-2,1,0.255136375,0.020436,47455,2160,48634,completed
375,43891,155,1,0-2,1,0.03341734722222223,0.0026866666666666666,47491,3600,47646,completed
376,43891,1150,2,0-2,2,0.4961673055555556,0.03986666666666666,47491,3600,48641,completed
377,43910,180,1,0-2,1,0.03811138888888889,0.00312,47510,3600,47690,completed
378,43982,171,2,0-2,2,0.07185325000000001,0.005927999999999999,47582,3600,47753,completed
403,46142,593,1,0-2,1,0.12458765277777778,0.010278666666666667,47582,1440,48175,completed
394,45498,1080,1,0-2,1,0.23388391666666666,0.01872,47658,2160,48738,completed
395,45499,847,1,0-2,1,0.18168004166666668,0.014681333333333333,47659,2160,48506,completed
388,44818,689,1,0-2,1,0.14681702777777778,0.011942666666666666,47698,2880,48387,completed
410,47700,817,1,0-2,1,0.17553127777777777,0.014161333333333333,47700,0,48517,completed
379,44138,140,1,0-2,1,0.029413611111111113,0.0024266666666666664,47738,3600,47878,completed
396,45622,356,1,0-2,1,0.07479461111111112,0.006170666666666666,47782,2160,48138,completed
381,44214,1049,1,0-2,1,0.2291226388888889,0.018182666666666666,47814,3600,48863,completed
412,47824,111,1,0-2,1,0.02332079166666667,0.001924,47824,0,47935,completed
390,44963,535,1,0-2,1,0.11433593055555556,0.009273333333333333,47843,2880,48378,completed
404,46424,350,1,0-2,1,0.07353402777777779,0.006066666666666666,47864,1440,48214,completed
382,44268,198,1,0-2,1,0.041599250000000004,0.0034319999999999997,47868,3600,48066,completed
398,45710,292,1,0-2,1,0.06134838888888888,0.005061333333333333,47870,2160,48162,completed
399,45711,281,1,0-2,1,0.059037319444444444,0.004870666666666666,47871,2160,48152,completed
400,45732,848,1,0-2,1,0.1851693888888889,0.014698666666666665,47892,2160,48740,completed
413,47910,61,1,0-2,1,0.012815930555555558,0.0010573333333333333,47910,0,47971,completed
391,45053,472,1,0-2,1,0.10147818055555555,0.008181333333333332,47933,2880,48405,completed
408,47229,187,1,0-2,1,0.03928818055555556,0.003241333333333333,47949,720,48136,completed
383,44357,786,1,0-2,1,0.17218540277777777,0.013623999999999999,47957,3600,48743,completed
409,47241,72,1,0-2,1,0.015127,0.001248,47961,720,48033,completed
384,44409,949,1,0-2,1,0.20944423611111113,0.016449333333333333,48009,3600,48958,completed
385,44459,1168,1,0-2,1,0.2602710138888889,0.02024533333333333,48059,3600,49227,completed
436,51611,856,2,0-2,2,0.3587471111111111,0.029674666666666665,52331,720,53187,completed
415,48123,63,1,0-2,1,0.014170625000000003,0.0010919999999999999,52443,4320,52506,completed
416,48154,199,2,0-2,2,0.08477636111111109,0.006898666666666667,52474,4320,52673,completed
423,49616,589,3,0-2,3-4,0.3643772916666666,0.030628,52496,2880,53085,completed
437,51799,92,1,0-2,1,0.019622611111111105,0.0015946666666666665,52519,720,52611,completed
420,48927,94,1,0-2,1,0.019862472222222212,0.0016293333333333333,52527,3600,52621,completed
424,49690,1004,3,0-2,3-4,0.6177913333333335,0.052208,52570,2880,53574,completed
433,51206,126,4,0-2,3-4,0.102781,0.008735999999999999,52646,1440,52772,completed
429,50677,127,1,0-2,1,0.025899180555555554,0.0022013333333333334,52837,2160,52964,completed
425,49978,169,1,0-2,1,0.03446426388888889,0.0029293333333333333,52858,2880,53027,completed
430,50698,377,1,0-2,1,0.07688181944444444,0.006534666666666666,52858,2160,53235,completed
426,49982,138,1,0-2,1,0.02814241666666667,0.002392,52862,2880,53000,completed
427,50035,126,1,0-2,1,0.02569525,0.0021839999999999997,52915,2880,53041,completed
417,48606,112,1,0-2,1,0.022840222222222227,0.001941333333333333,52926,4320,53038,completed
418,48670,137,1,0-2,1,0.027938486111111112,0.0023746666666666664,52990,4320,53127,completed
435,51572,107,3,0-2,3-4,0.06546170833333334,0.0055639999999999995,53012,1440,53119,completed
428,50136,123,1,0-2,1,0.025083458333333336,0.0021319999999999998,53016,2880,53139,completed
421,49475,449,1,0-2,1,0.09254759722222225,0.007782666666666666,53075,3600,53524,completed
422,49515,607,3,0-2,3-4,0.3766983750000001,0.031563999999999995,53115,3600,53722,completed
434,51515,10525,1,12-24,1,1.8646433333333334,0.9121666666666667,55835,4320,66360,completed
401,45811,16642,1,24-48,1,2.6119242222222225,1.4423066666666666,55891,10080,72533,completed
419,48727,4357,2,6-12,2,1.226695777777778,0.7552133333333333,55927,7200,60284,completed
439,52366,1604,1,2-6,1,0.23990358333333334,0.13901333333333332,55966,3600,57570,completed
441,52367,7217,1,12-24,1,1.1350113333333334,0.6254733333333333,55967,3600,63184,completed
446,52367,3941,1,6-12,1,0.5516027777777778,0.3415533333333333,55967,3600,59908,completed
444,52367,7298,1,12-24,1,1.1566113333333334,0.6324933333333334,55967,3600,63265,completed
443,52367,1995,1,2-6,1,0.30315216666666667,0.1729,55967,3600,57962,completed
445,52367,2313,1,2-6,1,0.3552246666666667,0.20046,55967,3600,58280,completed
414,48049,1771,1,2-6,1,0.26635433333333336,0.15348666666666666,55969,7920,57740,completed
405,46610,6531,4,12-24,3-4,3.839304166666667,2.26408,55970,9360,62501,completed
374,43771,4646,1,6-12,1,0.646109375,0.40265333333333336,56011,12240,60657,completed
406,46681,2204,1,2-6,1,0.3330160833333334,0.19101333333333334,56041,9360,58245,completed
450,53223,4231,1,6-12,1,0.5811849444444445,0.36668666666666666,56103,2880,60334,completed
431,51075,2461,1,2-6,1,0.36155244444444445,0.21328666666666668,56115,5040,58576,completed
370,42489,3661,1,6-12,1,0.4964138194444444,0.31728666666666666,56169,13680,59830,completed
451,53310,4024,1,6-12,1,0.5474525277777778,0.34874666666666665,56190,2880,60214,completed
432,51154,1919,1,2-6,1,0.2801697222222222,0.16631333333333334,56194,5040,58113,completed
371,42594,4585,1,6-12,1,0.6243599861111111,0.39736666666666665,56274,13680,60859,completed
449,52785,5805,1,12-24,1,0.8202981250000001,0.5031,56385,3600,62190,completed
438,52072,1154,1,0-2,1,0.16104847222222224,0.020002666666666665,56392,4320,57546,completed
380,44187,3610,1,6-12,1,0.4895801527777778,0.3128666666666667,56427,12240,60037,completed
452,53549,397,2,0-2,2,0.1105534722222222,0.013762666666666666,56429,2880,56826,completed
411,47790,2259,4,2-6,3-4,1.3135480000000002,0.78312,56430,8640,58689,completed
453,53555,480,1,0-2,1,0.06685277777777776,0.00832,56435,2880,56915,completed
389,44928,10297,1,12-24,1,1.8001947222222223,0.8924066666666667,56448,11520,66745,completed
372,42783,2656,1,2-6,1,0.37711677777777786,0.23018666666666668,56463,13680,59119,completed
454,53584,132,1,0-2,1,0.018379166666666665,0.0022879999999999997,56464,2880,56596,completed
373,42786,3009,1,6-12,1,0.4147564583333334,0.26078,56466,13680,59475,completed
397,45674,2719,1,2-6,1,0.38349598611111113,0.23564666666666667,56474,10800,59193,completed
368,41387,1487,1,2-6,1,0.21710256944444445,0.12887333333333334,56507,15120,57994,completed
352,39249,1697,1,2-6,1,0.252029375,0.14707333333333333,56529,17280,58226,completed
442,52367,1348,1,0-2,1,0.19875381944444448,0.02336533333333333,56687,4320,58035,completed
440,52367,1299,1,0-2,1,0.19073006944444448,0.022515999999999998,56687,4320,57986,completed
448,52368,277,1,0-2,1,0.038615625,0.004801333333333333,56688,4320,56965,completed
447,52368,277,1,0-2,1,0.038615625,0.004801333333333333,56688,4320,56965,completed
475,57699,105,1,0-2,1,0.013425416666666669,0.0018199999999999998,58419,720,58524,completed
476,57839,365,1,0-2,1,0.04666930555555557,0.006326666666666666,58559,720,58924,completed
477,57840,544,1,0-2,1,0.06821511111111112,0.009429333333333333,58560,720,59104,completed
478,57919,67,1,0-2,1,0.008566694444444446,0.0011613333333333332,58639,720,58706,completed
481,58787,245,1,0-2,1,0.03132597222222223,0.004246666666666667,58787,0,59032,completed
467,56645,923,1,0-2,1,0.10359647222222224,0.015998666666666665,58805,2160,59728,completed
472,57384,160,1,0-2,1,0.02045777777777778,0.0027733333333333334,58824,1440,58984,completed
473,57541,91,1,0-2,1,0.010964694444444442,0.0015773333333333331,58981,1440,59072,completed
474,57542,318,1,0-2,1,0.03521066666666667,0.0055119999999999995,58982,1440,59300,completed
462,56158,691,1,0-2,1,0.07391173611111113,0.011977333333333333,59038,2880,59729,completed
479,58363,664,1,0-2,1,0.07098344444444446,0.011509333333333333,59083,720,59747,completed
463,56269,731,1,0-2,1,0.08218093055555557,0.012670666666666665,59149,2880,59880,completed
480,58498,257,1,0-2,1,0.02747401388888889,0.004454666666666667,59218,720,59475,completed
482,59218,130,1,0-2,1,0.013897361111111112,0.0022533333333333333,59218,0,59348,completed
483,59286,617,1,0-2,1,0.0707673888888889,0.010694666666666667,59286,0,59903,completed
471,57157,306,1,0-2,1,0.03271225,0.005304,59317,2160,59623,completed
465,56454,257,1,0-2,1,0.02747401388888889,0.004454666666666667,59334,2880,59591,completed
466,56456,919,1,0-2,1,0.11488802777777779,0.015929333333333334,59336,2880,60255,completed
488,60350,751,1,0-2,1,0.10219848611111114,0.013017333333333332,60350,0,61101,completed
491,61146,137,1,0-2,1,0.019759777777777775,0.0023746666666666664,61146,0,61283,completed
512,63601,281,1,0-2,1,0.05223087500000001,0.004870666666666666,65041,1440,65322,completed
513,63622,113,1,0-2,1,0.021003874999999998,0.0019586666666666667,65062,1440,65175,completed
514,64516,177,1,0-2,1,0.03289987500000001,0.003068,65236,720,65413,completed
490,61016,1572,1,2-6,1,0.22153544444444448,0.13624,65336,4320,66908,completed
492,61158,123,1,0-2,1,0.019509000000000002,0.0021319999999999998,65478,4320,65601,completed
493,61159,121,1,0-2,1,0.01917865277777778,0.002097333333333333,65479,4320,65600,completed
511,63329,217,1,0-2,1,0.03263395833333334,0.003761333333333333,65489,2160,65706,completed
494,61220,427,2,0-2,2,0.1233792777777778,0.014802666666666665,65540,4320,65967,completed
495,61226,156,2,0-2,2,0.04507533333333334,0.005408,65546,4320,65702,completed
485,59825,3847,1,6-12,1,0.4623859722222223,0.3334066666666667,65585,5760,69432,completed
509,62705,823,1,0-2,1,0.11558263888888892,0.014265333333333333,65585,2880,66408,completed
505,62004,2531,1,2-6,1,0.3127208611111112,0.21935333333333334,65604,3600,68135,completed
497,61312,431,1,0-2,1,0.06226752777777779,0.007470666666666666,65632,4320,66063,completed
496,61312,431,1,0-2,1,0.06226752777777779,0.007470666666666666,65632,4320,66063,completed
498,61330,712,1,0-2,1,0.10045472222222224,0.012341333333333333,65650,4320,66362,completed
489,60658,1746,1,2-6,1,0.22229850000000004,0.15132,65698,5040,67444,completed
499,61384,1609,4,2-6,3-4,0.8270532222222224,0.5577866666666667,65704,4320,67313,completed
486,59996,3954,1,6-12,1,0.4669484444444445,0.34268,65756,5760,69710,completed
506,62191,13742,1,24-48,1,1.495839402777778,1.1909733333333334,65791,3600,79533,completed
487,60129,7973,1,12-24,1,1.0433032500000001,0.6909933333333333,65889,5760,73862,completed
500,61602,601,1,0-2,1,0.08123855555555556,0.010417333333333332,65922,4320,66523,completed
515,65228,557,3,0-2,3-4,0.2257118333333334,0.028963999999999997,65948,720,66505,completed
510,63097,16896,1,24-48,1,2.2728155,1.46432,65977,2880,82873,completed
501,61704,641,1,0-2,1,0.08421294444444445,0.011110666666666666,66024,4320,66665,completed
484,59569,5556,3,6-12,3-4,1.932398,1.44456,66049,6480,71605,completed
502,61805,974,1,0-2,1,0.12197844444444446,0.016882666666666667,66125,4320,67099,completed
508,62553,389,1,0-2,1,0.05023519444444445,0.006742666666666666,66153,3600,66542,completed
504,62001,508,1,0-2,1,0.06335888888888888,0.008805333333333333,66321,4320,66829,completed
503,62001,206,1,0-2,1,0.02569277777777778,0.0035706666666666664,66321,4320,66527,completed
507,62292,619,1,0-2,1,0.07374780555555557,0.010729333333333332,66612,4320,67231,completed
524,66003,955,1,0-2,1,0.10995522222222226,0.016553333333333333,66723,720,67678,completed
525,66117,85,1,0-2,1,0.01060138888888889,0.0014733333333333332,66837,720,66922,completed
526,66143,412,1,0-2,1,0.04736930555555557,0.007141333333333333,66863,720,67275,completed
527,66348,712,1,0-2,1,0.0796075555555556,0.012341333333333333,67068,720,67780,completed
517,65675,126,1,0-2,1,0.014108500000000003,0.0021839999999999997,67115,1440,67241,completed
518,65700,114,1,0-2,1,0.012764833333333338,0.001976,67140,1440,67254,completed
521,65753,459,4,0-2,3-4,0.20558100000000007,0.031824,67193,1440,67652,completed
528,66571,118,1,0-2,1,0.013212722222222225,0.002045333333333333,67291,720,67409,completed
533,68294,753,2,0-2,2,0.16117183333333335,0.026104,69014,720,69767,completed
534,68348,762,1,0-2,1,0.08086516666666665,0.013208,69068,720,69830,completed
545,69150,1256,1,0-2,1,0.13342377777777775,0.021770666666666664,69150,0,70406,completed
543,69150,1394,1,0-2,1,0.14824344444444443,0.024162666666666666,69150,0,70544,completed
542,69150,1292,1,0-2,1,0.1372897777777778,0.022394666666666667,69150,0,70442,completed
548,69156,1050,1,0-2,1,0.11131433333333332,0.018199999999999997,69156,0,70206,completed
549,69156,969,1,0-2,1,0.10261583333333332,0.016796,69156,0,70125,completed
536,68479,91,1,0-2,1,0.009580277777777776,0.0015773333333333331,69199,720,69290,completed
537,68645,362,1,0-2,1,0.03811055555555555,0.006274666666666666,69365,720,69727,completed
531,68136,77,1,0-2,1,0.008106388888888889,0.0013346666666666665,69576,1440,69653,completed
532,68137,90,1,0-2,1,0.009474999999999999,0.00156,69577,1440,69667,completed
455,55418,11702,1,24-48,1,1.812899777777778,1.0141733333333334,72698,17280,84400,completed
456,55423,11521,1,24-48,1,1.773293777777778,0.9984866666666666,72703,17280,84224,completed
460,55424,11847,1,24-48,1,1.8445618611111114,1.02674,72704,17280,84551,completed
457,55424,11442,1,12-24,1,1.7541211666666667,0.99164,72704,17280,84146,completed
458,55424,11868,1,24-48,1,1.8491241111111112,1.02856,72704,17280,84572,completed
459,55424,11787,1,24-48,1,1.8315268611111113,1.0215400000000001,72704,17280,84491,completed
461,55453,5369,1,6-12,1,0.4946415555555555,0.46531333333333336,72733,17280,78102,completed
535,68351,3347,3,6-12,3-4,0.8299765833333335,0.87022,73391,5040,76738,completed
540,69143,12853,1,24-48,1,2.021406083333334,1.1139266666666667,73463,4320,86316,completed
469,56909,4358,1,6-12,1,0.33989674999999997,0.3776933333333333,73469,16560,77827,completed
546,69150,1509,1,2-6,1,0.134624625,0.13078,73470,4320,74979,completed
544,69150,1519,1,2-6,1,0.13536726388888887,0.13164666666666666,73470,4320,74989,completed
541,69150,1521,1,2-6,1,0.13551579166666666,0.13182,73470,4320,74991,completed
558,72030,1966,1,2-6,1,0.1685632222222222,0.17038666666666666,73470,1440,75436,completed
547,69152,1773,1,2-6,1,0.15416031944444444,0.15366,73472,4320,75245,completed
560,72783,120,1,0-2,1,0.013109999999999998,0.00208,73503,720,73623,completed
464,56297,1553,1,2-6,1,0.1341487222222222,0.13459333333333334,73577,17280,75130,completed
516,65662,4909,1,6-12,1,0.37091056944444445,0.4254466666666667,73582,7920,78491,completed
561,72897,671,1,0-2,1,0.06854763888888887,0.011630666666666666,73617,720,74288,completed
551,70034,2646,1,2-6,1,0.21292827777777779,0.22932,73634,3600,76280,completed
470,57089,3437,3,6-12,3-4,0.8088705,0.89362,73649,16560,77086,completed
568,73653,1847,1,2-6,1,0.1533233611111111,0.16007333333333335,73653,0,75500,completed
552,70055,2597,1,2-6,1,0.20857097222222223,0.22507333333333335,73655,3600,76252,completed
519,65748,1777,1,2-6,1,0.14760009722222223,0.15400666666666668,73668,7920,75445,completed
520,65752,2528,1,2-6,1,0.20288233333333333,0.21909333333333333,73672,7920,76200,completed
522,65754,2078,1,2-6,1,0.16965494444444446,0.18009333333333333,73674,7920,75752,completed
562,72955,1274,1,0-2,1,0.11000045833333334,0.022082666666666664,73675,720,74949,completed
553,70088,2538,1,2-6,1,0.20305002777777778,0.21996000000000002,73688,3600,76226,completed
523,65776,3221,1,6-12,1,0.252409375,0.27915333333333336,73696,7920,76917,completed
559,72338,105,1,0-2,1,0.011471249999999999,0.0018199999999999998,73778,1440,73883,completed
538,68776,1500,1,2-6,1,0.12185105555555556,0.13,73816,5040,75316,completed
563,73115,148,1,0-2,1,0.016169,0.002565333333333333,73835,720,73983,completed
575,73838,2024,1,2-6,1,0.15984280555555558,0.17541333333333334,73838,0,75862,completed
550,69536,176,2,0-2,2,0.038456,0.006101333333333333,73856,4320,74032,completed
578,73925,1940,1,2-6,1,0.15055909722222222,0.16813333333333333,73925,0,75865,completed
529,67484,2584,1,2-6,1,0.19636250000000002,0.22394666666666668,73964,6480,76548,completed
539,68928,1528,2,2-6,2,0.23722511111111114,0.26485333333333333,73968,5040,75496,completed
579,73971,1976,1,2-6,1,0.15157540277777776,0.17125333333333334,73971,0,75947,completed
580,73972,2848,1,2-6,1,0.21521983333333336,0.24682666666666667,73972,0,76820,completed
581,73974,2462,1,2-6,1,0.18714533333333333,0.21337333333333333,73974,0,76436,completed
530,67621,2588,1,2-6,1,0.19162362500000002,0.22429333333333334,74101,6480,76689,completed
564,73391,579,1,0-2,1,0.04355005555555556,0.010036,74111,720,74690,completed
468,56835,3157,1,6-12,1,0.23147725000000002,0.27360666666666666,74115,17280,77272,completed
565,73422,1438,1,0-2,1,0.10584122222222223,0.02492533333333333,74142,720,75580,completed
566,73571,682,1,0-2,1,0.04935544444444445,0.011821333333333333,74291,720,74973,completed
567,73593,472,1,0-2,1,0.034016777777777785,0.008181333333333332,74313,720,74785,completed
557,71499,217,3,0-2,3-4,0.046917208333333335,0.011283999999999999,74379,2880,74596,completed
569,73662,864,1,0-2,1,0.06307116666666668,0.014976,74382,720,75246,completed
555,70789,333,2,0-2,2,0.04799825,0.011543999999999999,74389,3600,74722,completed
554,70122,686,2,0-2,2,0.09996772222222222,0.02378133333333333,74442,4320,75128,completed
570,73759,791,1,0-2,1,0.0578627638888889,0.013710666666666666,74479,720,75270,completed
571,73764,1282,1,0-2,1,0.09424047222222222,0.022221333333333333,74484,720,75766,completed
572,73770,943,1,0-2,1,0.06917501388888889,0.016345333333333333,74490,720,75433,completed
556,70912,435,1,0-2,1,0.03149723611111112,0.00754,74512,3600,74947,completed
573,73794,1014,1,0-2,1,0.07450041666666667,0.017575999999999998,74514,720,75528,completed
574,73816,1368,1,0-2,1,0.10066077777777778,0.023711999999999997,74536,720,75904,completed
576,73878,649,1,0-2,1,0.04757843055555556,0.011249333333333333,74598,720,75247,completed
577,73925,1200,1,0-2,1,0.08845805555555555,0.0208,74645,720,75845,completed
582,74054,1374,1,0-2,1,0.10148630555555554,0.023815999999999997,74774,720,76148,completed
594,76796,258,1,0-2,1,0.017654499999999997,0.004471999999999999,77516,720,77774,completed
588,75379,198,1,0-2,1,0.01358775,0.0034319999999999997,77539,2160,77737,completed
587,75379,692,1,0-2,1,0.04578112499999999,0.011994666666666666,77539,2160,78231,completed
597,77736,118,1,0-2,1,0.007756999999999997,0.002045333333333333,77736,0,77854,completed
585,74877,1153,1,0-2,1,0.08273768055555555,0.01998533333333333,77757,2880,78910,completed
586,74878,946,1,0-2,1,0.06555102777777777,0.016397333333333333,77758,2880,78704,completed
583,74174,62,1,0-2,1,0.00403,0.0010746666666666667,77774,3600,77836,completed
598,77778,129,1,0-2,1,0.008385,0.0022359999999999997,77778,0,77907,completed
584,74275,62,1,0-2,1,0.00403,0.0010746666666666667,77875,3600,77937,completed
589,75854,692,1,0-2,1,0.049069972222222216,0.011994666666666666,78014,2160,78706,completed
596,77317,392,1,0-2,1,0.025479999999999992,0.006794666666666666,78037,720,78429,completed
599,78040,64,1,0-2,1,0.00416,0.0011093333333333333,78040,0,78104,completed
600,78044,62,1,0-2,1,0.00403,0.0010746666666666667,78044,0,78106,completed
603,78423,149,1,0-2,1,0.011349944444444447,0.0025826666666666667,78423,0,78572,completed
604,78425,136,1,0-2,1,0.010305875000000003,0.0023573333333333332,78425,0,78561,completed
605,78430,162,1,0-2,1,0.012556888888888892,0.0028079999999999997,78430,0,78592,completed
606,78800,511,1,0-2,1,0.046286013888888894,0.008857333333333333,78800,0,79311,completed
607,78848,1058,1,0-2,1,0.11223463888888888,0.018338666666666666,78848,0,79906,completed
608,79013,1119,1,0-2,1,0.1402283472222222,0.019396,79013,0,80132,completed
609,79046,83,1,0-2,1,0.006897069444444446,0.0014386666666666667,79046,0,79129,completed
610,79049,1342,1,0-2,1,0.18617705555555553,0.023261333333333332,79049,0,80391,completed
611,79067,1104,1,0-2,1,0.1431104722222222,0.019136,79067,0,80171,completed
612,79103,1369,1,0-2,1,0.19699543055555552,0.02372933333333333,79103,0,80472,completed
613,79134,409,1,0-2,1,0.04580120833333332,0.007089333333333333,79134,0,79543,completed
614,79134,320,1,0-2,1,0.035339999999999996,0.005546666666666667,79134,0,79454,completed
615,79145,1191,1,0-2,1,0.16780701388888886,0.020644,79145,0,80336,completed
616,79182,1062,1,0-2,1,0.14734824999999996,0.018407999999999997,79182,0,80244,completed
618,79555,853,1,0-2,1,0.135114375,0.014785333333333333,79555,0,80408,completed
619,80266,119,1,0-2,1,0.022486041666666665,0.0020626666666666666,80266,0,80385,completed
637,82658,1329,4,0-2,3-4,0.9318106111111111,0.09214399999999999,84818,2160,86147,completed
632,81988,229,1,0-2,1,0.04392775,0.003969333333333333,84868,2880,85097,completed
626,81326,351,1,0-2,1,0.06278225,0.006084,84926,3600,85277,completed
633,82056,98,1,0-2,1,0.018145500000000002,0.0016986666666666665,84936,2880,85034,completed
640,82817,197,2,0-2,2,0.06885150000000001,0.006829333333333333,84977,2160,85174,completed
620,80684,567,1,0-2,1,0.09908325,0.009828,85004,4320,85571,completed
621,80690,892,1,0-2,1,0.1533455833333333,0.015461333333333332,85010,4320,85902,completed
627,81444,71,3,0-2,3-4,0.03722174999999999,0.003692,85044,3600,85115,completed
628,81518,407,1,0-2,1,0.07112325,0.0070546666666666666,85118,3600,85525,completed
641,83717,60,1,0-2,1,0.010484999999999998,0.00104,85157,1440,85217,completed
644,84474,461,3,0-2,3-4,0.24167925,0.023972,85194,720,85655,completed
645,84511,517,3,0-2,3-4,0.2687110833333333,0.026883999999999998,85231,720,85748,completed
622,81007,483,1,0-2,1,0.08292188888888888,0.008372,85327,4320,85810,completed
635,82448,133,1,0-2,1,0.02324175,0.0023053333333333333,85328,2880,85461,completed
642,83979,199,1,0-2,1,0.03477525000000001,0.0034493333333333333,85419,1440,85618,completed
646,84699,504,1,0-2,1,0.08530312500000001,0.008735999999999999,85419,720,85923,completed
647,84705,228,2,0-2,2,0.079686,0.007904,85425,720,85653,completed
624,81107,370,1,0-2,1,0.063323375,0.0064133333333333325,85427,4320,85797,completed
648,84709,261,1,0-2,1,0.04549572222222222,0.004523999999999999,85429,720,85690,completed
630,81838,183,1,0-2,1,0.03197925,0.003172,85438,3600,85621,completed
643,83998,80,2,0-2,2,0.02796,0.0027733333333333334,85438,1440,85518,completed
631,81861,478,1,0-2,1,0.08057718055555554,0.008285333333333332,85461,3600,85939,completed
649,84751,105,2,0-2,2,0.0366975,0.0036399999999999996,85471,720,85576,completed
650,84908,76,2,0-2,2,0.024190111111111107,0.0026346666666666667,86348,1440,86424,completed
651,85178,977,4,0-2,3-4,0.5722183888888889,0.06773866666666667,86618,1440,87595,completed
652,85293,270,1,0-2,1,0.04051125,0.00468,86733,1440,87003,completed
660,86045,904,1,0-2,1,0.13155066666666665,0.015669333333333334,86765,720,87669,completed
653,85354,666,4,0-2,3-4,0.3895865555555555,0.046175999999999995,86794,1440,87460,completed
662,86074,138,1,0-2,1,0.020705750000000002,0.002392,86794,720,86932,completed
667,86819,325,2,0-2,2,0.09716975,0.011266666666666666,86819,0,87144,completed
654,85396,61,1,0-2,1,0.009152541666666666,0.0010573333333333333,86836,1440,86897,completed
668,86844,231,1,0-2,1,0.034659625,0.004004,86844,0,87075,completed
655,85418,63,1,0-2,1,0.009452625,0.0010919999999999999,86858,1440,86921,completed
656,85495,493,1,0-2,1,0.07167765277777777,0.008545333333333334,86935,1440,87428,completed
658,85564,643,1,0-2,1,0.09255356944444443,0.011145333333333333,87004,1440,87647,completed
663,86296,125,1,0-2,1,0.018598874999999994,0.0021666666666666666,87016,720,87141,completed
669,87124,450,1,0-2,1,0.06416874999999998,0.0078,87124,0,87574,completed
672,87228,403,1,0-2,1,0.05746668055555554,0.006985333333333333,87228,0,87631,completed
664,86522,385,1,0-2,1,0.054899930555555546,0.006673333333333333,87242,720,87627,completed
665,86604,172,1,0-2,1,0.02452672222222222,0.0029813333333333332,87324,720,87496,completed
674,87361,700,2,0-2,2,0.2098941944444444,0.024266666666666666,87361,0,88061,completed
666,86701,93,1,0-2,1,0.013261541666666666,0.001612,87421,720,87514,completed
675,87453,214,1,0-2,1,0.03051580555555555,0.003709333333333333,87453,0,87667,completed
678,87484,1142,1,0-2,1,0.18641911111111112,0.019794666666666665,87484,0,88626,completed
679,87592,385,1,0-2,1,0.05807947222222222,0.006673333333333333,87592,0,87977,completed
695,89564,240,2,0-2,2,0.09649333333333335,0.00832,91004,1440,91244,completed
696,89577,68,1,0-2,1,0.01366988888888889,0.0011786666666666666,91017,1440,91085,completed
697,89631,722,1,0-2,1,0.12880599999999998,0.012514666666666665,91071,1440,91793,completed
676,87483,2160,1,2-6,1,0.341841,0.1872,91083,3600,93243,completed
677,87484,2027,1,2-6,1,0.32386030555555556,0.17567333333333335,91084,3600,93111,completed
661,86070,2649,1,2-6,1,0.40158504166666664,0.22958,91110,5040,93759,completed
690,88984,17236,1,24-48,1,5.513125888888889,1.4937866666666666,91144,2160,108380,completed
698,89770,1655,1,2-6,1,0.2651297222222222,0.14343333333333333,91210,1440,92865,completed
691,89062,373,1,0-2,1,0.06781030555555555,0.006465333333333333,91222,2160,91595,completed
625,81161,4649,1,6-12,1,0.5999389722222223,0.40291333333333335,91241,10080,95890,completed
601,78351,3535,1,6-12,1,0.47664144444444445,0.3063666666666667,91311,12960,94846,completed
602,78351,4930,1,6-12,1,0.6189000277777779,0.4272666666666667,91311,12960,96241,completed
657,85563,9852,1,12-24,1,2.3744365,0.85384,91323,5760,101175,completed
692,89169,167,3,0-2,3-4,0.09294025,0.008683999999999999,91329,2160,91496,completed
693,89170,169,3,0-2,3-4,0.09372991666666666,0.008787999999999999,91330,2160,91499,completed
699,90614,442,1,0-2,1,0.07330494444444444,0.0076613333333333325,91334,720,91776,completed
700,90619,460,1,0-2,1,0.07585905555555554,0.007973333333333332,91339,720,91799,completed
638,82710,2590,3,2-6,3-4,1.118365,0.6734,91350,8640,93940,completed
694,89211,959,1,0-2,1,0.15120647222222222,0.016622666666666664,91371,2160,92330,completed
701,90662,67,1,0-2,1,0.013052361111111114,0.0011613333333333332,91382,720,91449,completed
683,88513,81,1,0-2,1,0.014709805555555554,0.0014039999999999999,91393,2880,91474,completed
639,82755,2160,3,2-6,3-4,0.9634349999999998,0.5616,91395,8640,93555,completed
684,88524,621,1,0-2,1,0.09776574999999998,0.010764,91404,2880,92025,completed
685,88528,107,1,0-2,1,0.018039138888888882,0.0018546666666666666,91408,2880,91515,completed
595,77026,3433,1,6-12,1,0.4548869861111111,0.29752666666666666,91426,14400,94859,completed
659,85675,1516,1,2-6,1,0.23174844444444442,0.13138666666666668,91435,5760,92951,completed
670,87136,2757,1,2-6,1,0.38155595833333333,0.23894,91456,4320,94213,completed
634,82122,10925,1,12-24,1,2.9798770416666667,0.9468333333333333,91482,9360,102407,completed
617,79247,1523,1,2-6,1,0.23141702777777776,0.13199333333333332,91487,12240,93010,completed
686,88622,120,1,0-2,1,0.018569999999999996,0.00208,91502,2880,91622,completed
671,87193,17516,1,24-48,1,5.618790333333334,1.5180533333333333,91513,4320,109029,completed
702,90818,1543,1,2-6,1,0.2330880833333333,0.13372666666666666,91538,720,93081,completed
703,90856,590,1,0-2,1,0.09128866666666666,0.010226666666666667,91576,720,92166,completed
673,87262,12102,1,24-48,1,3.566652888888889,1.04884,91582,4320,103684,completed
688,88704,345,1,0-2,1,0.053388749999999985,0.005979999999999999,91584,2880,91929,completed
687,88704,343,1,0-2,1,0.05307924999999999,0.005945333333333333,91584,2880,91927,completed
689,88794,245,1,0-2,1,0.03791374999999998,0.004246666666666667,91674,2880,91919,completed
704,90966,542,1,0-2,1,0.08371772222222221,0.009394666666666666,91686,720,92228,completed
705,91015,475,1,0-2,1,0.07339097222222221,0.008233333333333332,91735,720,92210,completed
629,81691,5309,1,6-12,1,0.6477044166666666,0.4601133333333333,91771,10080,97080,completed
706,91063,1270,1,0-2,1,0.1914028888888889,0.022013333333333333,91783,720,93053,completed
623,81056,2643,4,2-6,3-4,1.399726388888889,0.91624,91856,10800,94499,completed
590,76739,3412,1,6-12,1,0.43080841666666664,0.2957066666666667,91859,15120,95271,completed
707,91145,833,1,0-2,1,0.12766636111111107,0.014438666666666666,91865,720,92698,completed
591,76755,1813,1,2-6,1,0.2603000833333333,0.15712666666666666,91875,15120,93688,completed
592,76756,3651,1,6-12,1,0.45542744444444444,0.31642,91876,15120,95527,completed
593,76767,6078,1,12-24,1,0.8492686250000001,0.52676,91887,15120,97965,completed
636,82581,4259,1,6-12,1,0.5115791388888888,0.36911333333333335,91941,9360,96200,completed
680,87691,146,1,0-2,1,0.022593499999999996,0.0025306666666666663,92011,4320,92157,completed
681,88122,359,1,0-2,1,0.05472755555555556,0.006222666666666666,92442,4320,92801,completed
682,88187,82,1,0-2,1,0.012500444444444444,0.0014213333333333333,92507,4320,92589,completed
708,91221,711,1,0-2,1,0.08236758333333333,0.012324,93381,2160,94092,completed
709,91223,668,1,0-2,1,0.07769240277777778,0.011578666666666666,93383,2160,94051,completed
711,91995,87,1,0-2,1,0.011718416666666667,0.001508,93435,1440,93522,completed
712,92117,1258,1,0-2,1,0.1350887361111111,0.021805333333333333,93557,1440,94815,completed
713,92120,627,1,0-2,1,0.06846581944444445,0.010868,93560,1440,94187,completed
714,92125,1196,1,0-2,1,0.12834643055555556,0.020730666666666665,93565,1440,94761,completed
715,92125,884,1,0-2,1,0.0956167638888889,0.015322666666666665,93565,1440,94449,completed
716,92137,1332,1,0-2,1,0.14225570833333334,0.023087999999999997,93577,1440,94909,completed
717,92143,450,1,0-2,1,0.04881926388888889,0.0078,93583,1440,94033,completed
723,92867,188,1,0-2,1,0.020556236111111112,0.0032586666666666667,93587,720,93775,completed
724,92881,481,1,0-2,1,0.05168745833333333,0.008337333333333332,93601,720,94082,completed
727,93062,119,1,0-2,1,0.012787541666666662,0.0020626666666666666,93782,720,93901,completed
718,92355,459,1,0-2,1,0.049323375,0.007956,93795,1440,94254,completed
719,92426,63,1,0-2,1,0.006769875000000002,0.0010919999999999999,93866,1440,93929,completed
728,93210,987,1,0-2,1,0.10453570833333332,0.017107999999999998,93930,720,94917,completed
720,92515,1432,1,0-2,1,0.15168851388888888,0.02482133333333333,93955,1440,95387,completed
710,91877,70,1,0-2,1,0.007522083333333335,0.0012133333333333332,94037,2160,94107,completed
742,94690,1322,1,0-2,1,0.14007155555555556,0.022914666666666667,95410,720,96732,completed
751,95429,223,1,0-2,1,0.023737111111111105,0.003865333333333333,95429,0,95652,completed
743,94742,67,1,0-2,1,0.007131777777777779,0.0011613333333333332,95462,720,95529,completed
736,94023,88,1,0-2,1,0.009367111111111113,0.0015253333333333332,95463,1440,95551,completed
752,95476,473,1,0-2,1,0.04801722222222223,0.008198666666666667,95476,0,95949,completed
753,95513,936,3,0-2,3-4,0.27340300000000006,0.048672,95513,0,96449,completed
747,94835,1126,1,0-2,1,0.11754244444444445,0.01951733333333333,95555,720,96681,completed
748,94838,1175,1,0-2,1,0.1244568888888889,0.020366666666666665,95558,720,96733,completed
749,94871,518,1,0-2,1,0.050833888888888894,0.008978666666666666,95591,720,96109,completed
755,95692,533,1,0-2,1,0.0509998888888889,0.009238666666666666,95692,0,96225,completed
737,94276,626,1,0-2,1,0.059456222222222216,0.010850666666666666,95716,1440,96342,completed
738,94296,93,1,0-2,1,0.009048333333333332,0.001612,95736,1440,95829,completed
756,95736,242,1,0-2,1,0.023070888888888894,0.004194666666666666,95736,0,95978,completed
730,93606,79,1,0-2,1,0.007434777777777775,0.0013693333333333333,95766,2160,95845,completed
757,95816,181,1,0-2,1,0.017034111111111108,0.003137333333333333,95816,0,95997,completed
732,93778,879,1,0-2,1,0.09788866666666668,0.015236,95938,2160,96817,completed
734,93825,1369,1,0-2,1,0.18653047222222224,0.02372933333333333,95985,2160,97354,completed
758,96075,608,1,0-2,1,0.06635455555555556,0.010538666666666667,96075,0,96683,completed
759,96145,118,1,0-2,1,0.01110511111111111,0.002045333333333333,96145,0,96263,completed
760,96189,64,1,0-2,1,0.006023111111111111,0.0011093333333333333,96189,0,96253,completed
761,96223,545,1,0-2,1,0.06425055555555556,0.009446666666666666,96223,0,96768,completed
763,96346,73,1,0-2,1,0.006870111111111111,0.0012653333333333332,96346,0,96419,completed
764,96546,64,1,0-2,1,0.008903111111111112,0.0011093333333333333,96546,0,96610,completed
765,96596,1230,1,0-2,1,0.24574847222222226,0.02132,96596,0,97826,completed
766,96612,1123,1,0-2,1,0.22001309722222226,0.01946533333333333,96612,0,97735,completed
767,96624,696,1,0-2,1,0.11112966666666668,0.012064,96624,0,97320,completed
768,96632,1284,1,0-2,1,0.2639917222222223,0.022255999999999998,96632,0,97916,completed
769,96649,443,1,0-2,1,0.06162622222222222,0.007678666666666666,96649,0,97092,completed
770,96649,436,1,0-2,1,0.060652444444444446,0.007557333333333333,96649,0,97085,completed
771,96779,97,1,0-2,1,0.013493777777777778,0.0016813333333333333,96779,0,96876,completed
772,96901,164,1,0-2,1,0.022814222222222222,0.0028426666666666665,96901,0,97065,completed
774,97046,1052,1,0-2,1,0.2739334166666667,0.018234666666666666,97046,0,98098,completed
775,97271,313,2,0-2,2,0.16172536111111113,0.010850666666666666,97271,0,97584,completed
776,97317,1032,1,0-2,1,0.31605658333333336,0.017887999999999998,97317,0,98349,completed
779,97345,740,1,0-2,1,0.21019319444444445,0.012826666666666665,97345,0,98085,completed
777,97345,937,1,0-2,1,0.2837918472222223,0.016241333333333333,97345,0,98282,completed
778,97345,499,1,0-2,1,0.1289152638888889,0.008649333333333334,97345,0,97844,completed
780,97369,986,1,0-2,1,0.3048641111111111,0.017090666666666667,97369,0,98355,completed
781,97407,963,1,0-2,1,0.30065087500000004,0.016692,97407,0,98370,completed
782,97443,476,1,0-2,1,0.1229732777777778,0.008250666666666667,97443,0,97919,completed
783,97512,748,1,0-2,1,0.23242872222222227,0.012965333333333332,97512,0,98260,completed
784,97626,444,1,0-2,1,0.13199366666666668,0.007696,97626,0,98070,completed
785,97627,274,1,0-2,1,0.0707871388888889,0.004749333333333333,97627,0,97901,completed
786,97812,817,1,0-2,1,0.29278193055555557,0.014161333333333333,97812,0,98629,completed
787,97992,735,1,0-2,1,0.28217262499999995,0.01274,97992,0,98727,completed
788,98475,304,1,0-2,1,0.125682,0.005269333333333333,98475,0,98779,completed
789,98476,265,1,0-2,1,0.10780148611111111,0.004593333333333333,98476,0,98741,completed
790,98581,114,1,0-2,1,0.04738119444444443,0.001976,98581,0,98695,completed
791,98597,306,1,0-2,1,0.13723097222222222,0.005304,98597,0,98903,completed
798,99269,143,1,0-2,1,0.0659889027777778,0.0024786666666666663,99989,720,100132,completed
799,99269,374,1,0-2,1,0.17084686111111114,0.006482666666666666,99989,720,100363,completed
792,98762,1178,1,0-2,1,0.5597588055555556,0.020418666666666665,100202,1440,101380,completed
793,98763,73,1,0-2,1,0.03313693055555556,0.0012653333333333332,100203,1440,100276,completed
800,99535,275,4,0-2,3-4,0.4993236111111112,0.019066666666666666,100255,720,100530,completed
801,99612,132,1,0-2,1,0.05991883333333333,0.0022879999999999997,100332,720,100464,completed
794,99005,64,1,0-2,1,0.028780444444444442,0.0011093333333333333,103325,4320,103389,completed
795,99024,265,1,0-2,1,0.11916902777777777,0.004593333333333333,103344,4320,103609,completed
797,99205,74,1,0-2,1,0.03327738888888889,0.0012826666666666665,103525,4320,103599,completed
796,99205,105,1,0-2,1,0.047217916666666665,0.0018199999999999998,103525,4320,103630,completed
803,99779,1078,1,0-2,1,0.40476393055555565,0.01868533333333333,104099,4320,105177,completed
806,99886,288,1,0-2,1,0.11666597222222225,0.004992,104206,4320,104494,completed
807,99886,288,1,0-2,1,0.11666597222222225,0.004992,104206,4320,104494,completed
824,102800,250,1,0-2,1,0.10064805555555559,0.004333333333333333,104240,1440,104490,completed
825,102857,87,1,0-2,1,0.03735320833333335,0.001508,104297,1440,104384,completed
826,102886,518,1,0-2,1,0.18940402777777782,0.008978666666666666,104326,1440,104844,completed
835,103631,411,2,0-2,2,0.299116138888889,0.014247999999999999,104351,720,104762,completed
828,102945,401,1,0-2,1,0.14348093055555555,0.006950666666666667,104385,1440,104786,completed
836,103685,642,1,0-2,1,0.22792783333333339,0.011127999999999999,104405,720,105047,completed
812,100875,84,1,0-2,1,0.029822333333333336,0.0014559999999999998,104475,3600,104559,completed
837,103788,230,2,0-2,2,0.16331277777777783,0.007973333333333332,104508,720,104738,completed
817,101670,581,3,0-2,3-4,0.6186245833333335,0.030212,104550,2880,105131,completed
838,103830,123,1,0-2,1,0.04366841666666668,0.0021319999999999998,104550,720,104673,completed
813,100964,63,1,0-2,1,0.022366749999999998,0.0010919999999999999,104564,3600,104627,completed
808,100315,167,1,0-2,1,0.0592896388888889,0.0028946666666666665,104635,4320,104802,completed
839,103934,922,1,0-2,1,0.3247262777777778,0.015981333333333334,104654,720,105576,completed
820,102501,72,1,0-2,1,0.025562000000000005,0.001248,104661,2160,104733,completed
821,102511,200,1,0-2,1,0.07100555555555557,0.0034666666666666665,104671,2160,104871,completed
840,103982,312,3,0-2,3-4,0.33230600000000005,0.016224,104702,720,105014,completed
841,104065,99,1,0-2,1,0.03514775000000001,0.0017159999999999999,104785,720,104884,completed
842,104071,1378,2,0-2,2,1.0316298888888888,0.04777066666666666,104791,720,106169,completed
833,103403,593,1,0-2,1,0.20872324999999997,0.010278666666666667,104843,1440,105436,completed
819,102027,150,3,0-2,3-4,0.15976250000000003,0.0078,104907,2880,105057,completed
815,101325,74,1,0-2,1,0.02627205555555556,0.0012826666666666665,104925,3600,104999,completed
834,103502,682,1,0-2,1,0.23924494444444444,0.011821333333333333,104942,1440,105624,completed
811,100695,77,1,0-2,1,0.02733713888888889,0.0013346666666666665,105015,4320,105092,completed
845,104607,1694,1,2-6,1,0.28618970833333335,0.14681333333333332,108927,4320,110621,completed
846,104607,1538,1,2-6,1,0.2679702083333333,0.13329333333333335,108927,4320,110465,completed
822,102513,7578,2,12-24,2,1.8297876666666666,1.31352,108993,6480,116571,completed
847,104723,698,1,0-2,1,0.1397014166666667,0.012098666666666666,109043,4320,109741,completed
848,104727,3812,1,6-12,1,0.47144406944444445,0.33037333333333335,109047,4320,112859,completed
818,101850,2230,1,2-6,1,0.3257280555555556,0.19326666666666667,109050,7200,111280,completed
809,100423,3848,3,6-12,3-4,1.4169990416666667,1.00048,109063,8640,112911,completed
810,100455,1951,3,2-6,3-4,0.8790616666666666,0.50726,109095,8640,111046,completed
802,99736,3345,1,6-12,1,0.4228794027777778,0.2899,109096,9360,112441,completed
862,106229,9481,1,12-24,1,1.1746790277777777,0.8216866666666667,109109,2880,118590,completed
849,104793,9929,1,12-24,1,1.2225029444444444,0.8605133333333334,109113,4320,119042,completed
823,102651,1877,1,2-6,1,0.2810181944444445,0.16267333333333334,109131,6480,111008,completed
829,103379,3038,1,6-12,1,0.3888442361111112,0.2632933333333333,109139,5760,112177,completed
830,103380,4649,1,6-12,1,0.5334777222222222,0.40291333333333335,109140,5760,113789,completed
832,103381,4792,1,6-12,1,0.5474925277777778,0.41530666666666666,109141,5760,113933,completed
831,103381,4862,1,6-12,1,0.5544186388888889,0.4213733333333333,109141,5760,114003,completed
814,101263,2033,1,2-6,1,0.2886376388888889,0.17619333333333334,109183,7920,111216,completed
850,104872,77,1,0-2,1,0.017955972222222227,0.0013346666666666665,109192,4320,109269,completed
773,96962,7784,1,12-24,1,0.935654611111111,0.6746133333333334,109202,12240,116986,completed
804,99871,2133,1,2-6,1,0.2914940277777778,0.18486,109231,9360,111364,completed
805,99879,11989,1,24-48,1,1.3692110833333335,1.0390466666666667,109239,9360,121228,completed
864,106369,997,1,0-2,1,0.16730422222222224,0.017281333333333333,109249,2880,110246,completed
865,106375,541,1,0-2,1,0.09887475,0.009377333333333333,109255,2880,109796,completed
762,96333,1542,1,2-6,1,0.22583395833333336,0.13364,109293,12960,110835,completed
871,107138,64,1,0-2,1,0.014924444444444445,0.0011093333333333333,109298,2160,109362,completed
816,101398,1705,1,2-6,1,0.2388347916666667,0.14776666666666666,109318,7920,111023,completed
843,104279,4580,2,6-12,2,1.005239611111111,0.7938666666666667,109319,5040,113899,completed
866,106481,1161,1,0-2,1,0.17342094444444445,0.020124,109361,2880,110522,completed
891,108648,456,1,0-2,1,0.07690733333333336,0.007904,109368,720,109824,completed
877,107933,703,1,0-2,1,0.11519336111111114,0.012185333333333333,109373,1440,110076,completed
827,102904,9634,1,12-24,1,1.1567269166666667,0.8349466666666667,109384,6480,119018,completed
867,106504,94,1,0-2,1,0.019008,0.0016293333333333333,109384,2880,109478,completed
878,107947,450,1,0-2,1,0.07451186111111113,0.0078,109387,1440,109837,completed
879,107963,784,1,0-2,1,0.12450156944444447,0.013589333333333332,109403,1440,110187,completed
892,108706,1418,1,0-2,1,0.19587022222222225,0.024578666666666665,109426,720,110844,completed
857,105850,85,1,0-2,1,0.013307222222222225,0.0014733333333333332,109450,3600,109535,completed
844,104413,4683,1,6-12,1,0.4958178888888889,0.40586,109453,5040,114136,completed
872,107321,479,1,0-2,1,0.07499011111111112,0.008302666666666667,109481,2160,109960,completed
750,95088,2842,1,2-6,1,0.3252838055555556,0.24630666666666667,109488,14400,112330,completed
880,108094,369,1,0-2,1,0.057769000000000015,0.006396,109534,1440,109903,completed
893,108817,136,1,0-2,1,0.02129155555555556,0.0023573333333333332,109537,720,109673,completed
881,108133,1275,2,0-2,2,0.3445015555555556,0.044199999999999996,109573,1440,110848,completed
851,105263,402,1,0-2,1,0.06293533333333334,0.006967999999999999,109583,4320,109985,completed
852,105263,402,1,0-2,1,0.06293533333333334,0.006967999999999999,109583,4320,109985,completed
882,108157,75,1,0-2,1,0.01174166666666667,0.0013,109597,1440,109672,completed
858,105999,398,1,0-2,1,0.06230911111111112,0.006898666666666667,109599,3600,109997,completed
868,106720,77,1,0-2,1,0.01205477777777778,0.0013346666666666665,109600,2880,109677,completed
883,108172,290,1,0-2,1,0.04540111111111112,0.005026666666666666,109612,1440,109902,completed
741,94527,2914,1,6-12,1,0.32091518055555557,0.2525466666666667,109647,15120,112561,completed
894,108931,427,1,0-2,1,0.06684922222222223,0.007401333333333333,109651,720,110078,completed
884,108215,95,1,0-2,1,0.014872777777777782,0.0016466666666666665,109655,1440,109750,completed
885,108216,204,1,0-2,1,0.03193733333333334,0.0035359999999999996,109656,1440,109860,completed
859,106059,278,1,0-2,1,0.043522444444444454,0.004818666666666666,109659,3600,109937,completed
873,107500,119,1,0-2,1,0.018630111111111115,0.0020626666666666666,109660,2160,109779,completed
886,108220,264,1,0-2,1,0.041330666666666675,0.004575999999999999,109660,1440,109924,completed
895,108946,299,1,0-2,1,0.04681011111111112,0.005182666666666666,109666,720,109965,completed
896,108951,562,1,0-2,1,0.08508145833333336,0.009741333333333333,109671,720,110233,completed
897,108952,962,1,0-2,1,0.13175836111111114,0.016674666666666664,109672,720,110634,completed
899,108952,814,1,0-2,1,0.11447319444444445,0.014109333333333333,109672,720,110486,completed
898,108952,499,1,0-2,1,0.07768381944444447,0.008649333333333334,109672,720,110171,completed
869,106809,1064,1,0-2,1,0.142995125,0.018442666666666666,109689,2880,110753,completed
735,93850,1584,1,2-6,1,0.19507375000000002,0.13728,109690,15840,111274,completed
887,108250,1234,2,0-2,2,0.3236961111111112,0.042778666666666666,109690,1440,110924,completed
900,109011,526,1,0-2,1,0.07849112500000001,0.009117333333333333,109731,720,110257,completed
901,109016,586,1,0-2,1,0.08529980555555557,0.010157333333333332,109736,720,110322,completed
874,107593,2632,2,2-6,2,0.5773663611111112,0.45621333333333336,109753,2160,112385,completed
888,108320,75,1,0-2,1,0.01174166666666667,0.0013,109760,1440,109835,completed
853,105454,65,1,0-2,1,0.010176111111111113,0.0011266666666666667,109774,4320,109839,completed
860,106185,90,1,0-2,1,0.014090000000000004,0.00156,109785,3600,109875,completed
875,107627,201,1,0-2,1,0.03146766666666667,0.0034839999999999997,109787,2160,109988,completed
861,106198,117,1,0-2,1,0.018317000000000003,0.002028,109798,3600,109915,completed
876,107651,708,1,0-2,1,0.09656609722222223,0.012272,109811,2160,110519,completed
889,108373,1398,1,0-2,1,0.16983679166666665,0.024232,109813,1440,111211,completed
729,93257,9715,1,12-24,1,1.1398690555555557,0.8419666666666666,109817,16560,119532,completed
902,109119,91,1,0-2,1,0.01424655555555556,0.0015773333333333331,109839,720,109930,completed
870,106964,102,1,0-2,1,0.01596866666666667,0.0017679999999999998,109844,2880,109946,completed
854,105528,602,2,0-2,2,0.16542983333333333,0.020869333333333333,109848,4320,110450,completed
855,105541,797,2,0-2,2,0.20994472222222224,0.027629333333333332,109861,4320,110658,completed
890,108435,742,1,0-2,1,0.09799212500000001,0.012861333333333332,109875,1440,110617,completed
863,106299,1215,1,0-2,1,0.14716475,0.02106,109899,3600,111114,completed
744,94782,2393,1,2-6,1,0.257263625,0.20739333333333335,109902,15120,112295,completed
745,94791,1603,1,2-6,1,0.18325830555555556,0.13892666666666667,109911,15120,111514,completed
721,92665,5915,1,12-24,1,0.6125244444444444,0.5126333333333334,109945,17280,115860,completed
746,94826,1834,1,2-6,1,0.2026303888888889,0.15894666666666668,109946,15120,111780,completed
856,105673,104,1,0-2,1,0.01628177777777778,0.0018026666666666666,109993,4320,110097,completed
904,109316,79,1,0-2,1,0.012367888888888892,0.0013693333333333333,110036,720,110115,completed
903,109316,1186,1,0-2,1,0.1359691388888889,0.020557333333333334,110036,720,111222,completed
754,95684,3830,1,6-12,1,0.3750656666666667,0.33193333333333336,110084,14400,113914,completed
722,92822,1767,1,2-6,1,0.18645876388888888,0.15314,110102,17280,111869,completed
739,94301,2072,1,2-6,1,0.21224476388888888,0.17957333333333333,110141,15840,112213,completed
740,94320,1986,1,2-6,1,0.20305875,0.17212,110160,15840,112146,completed
906,109456,468,1,0-2,1,0.054658500000000006,0.008112,110176,720,110644,completed
725,92944,5964,1,12-24,1,0.6251065555555556,0.51688,110224,17280,116188,completed
907,109519,74,1,0-2,1,0.008642583333333332,0.0012826666666666665,110239,720,110313,completed
731,93699,2446,1,2-6,1,0.24183380555555556,0.21198666666666666,110259,16560,112705,completed
726,92990,3894,3,6-12,3-4,1.1251694166666666,1.01244,110270,17280,114164,completed
909,109651,78,1,0-2,1,0.009109749999999996,0.001352,110371,720,110449,completed
733,93815,1628,1,2-6,1,0.16469125,0.14109333333333335,110375,16560,112003,completed
911,109655,86,1,0-2,1,0.01004408333333333,0.0014906666666666666,110375,720,110461,completed
910,109655,66,1,0-2,1,0.00770825,0.0011439999999999998,110375,720,110441,completed
913,109785,927,1,0-2,1,0.09619854166666666,0.016068,110505,720,111432,completed
914,109861,88,1,0-2,1,0.010277666666666668,0.0015253333333333332,110581,720,110669,completed
915,109862,278,1,0-2,1,0.03246808333333333,0.004818666666666666,110582,720,110860,completed
916,109884,87,1,0-2,1,0.010160874999999996,0.001508,110604,720,110691,completed
917,109965,505,1,0-2,1,0.05220284722222222,0.008753333333333333,110685,720,111190,completed
919,110105,100,1,0-2,1,0.010695416666666662,0.0017333333333333333,110825,720,110925,completed
920,110182,83,1,0-2,1,0.007879236111111111,0.0014386666666666667,110902,720,110985,completed
921,110362,183,1,0-2,1,0.017372291666666657,0.003172,111082,720,111265,completed
923,110601,105,1,0-2,1,0.009967708333333332,0.0018199999999999998,111321,720,111426,completed
924,110703,72,1,0-2,1,0.006835,0.001248,111423,720,111495,completed
925,111374,402,1,0-2,1,0.036589194444444445,0.006967999999999999,112094,720,112496,completed
928,112349,550,1,0-2,1,0.04886597222222223,0.009533333333333333,112349,0,112899,completed
929,112639,1270,3,0-2,3-4,0.34542137500000003,0.06604,112639,0,113909,completed
930,112696,1214,3,0-2,3-4,0.33052533333333334,0.06312799999999999,112696,0,113910,completed
931,112702,1114,3,0-2,3-4,0.30102375000000003,0.05792799999999999,112702,0,113816,completed
933,112811,720,1,0-2,1,0.06451555555555556,0.01248,112811,0,113531,completed
935,112900,116,1,0-2,1,0.010306277777777779,0.0020106666666666667,112900,0,113016,completed
936,113017,70,4,0-2,3-4,0.025086111111111115,0.004853333333333333,113017,0,113087,completed
937,113040,148,2,0-2,2,0.026627666666666668,0.005130666666666666,113040,0,113188,completed
938,113060,103,1,0-2,1,0.009265708333333329,0.0017853333333333332,113060,0,113163,completed
939,113238,83,1,0-2,1,0.007466541666666667,0.0014386666666666667,113238,0,113321,completed
940,113302,958,1,0-2,1,0.09067313888888891,0.016605333333333333,113302,0,114260,completed
941,113340,102,1,0-2,1,0.009175749999999996,0.0017679999999999998,113340,0,113442,completed
942,113354,165,1,0-2,1,0.014843125000000002,0.0028599999999999997,113354,0,113519,completed
943,113357,320,1,0-2,1,0.02878666666666667,0.005546666666666667,113357,0,113677,completed
944,113364,850,1,0-2,1,0.08054427777777778,0.014733333333333333,113364,0,114214,completed
946,113465,826,1,0-2,1,0.07907720833333334,0.014317333333333333,113465,0,114291,completed
945,113465,754,1,0-2,1,0.07195320833333334,0.013069333333333332,113465,0,114219,completed
947,113514,81,1,0-2,1,0.007286625000000001,0.0014039999999999999,113514,0,113595,completed
948,113564,877,1,0-2,1,0.085013,0.015201333333333332,113564,0,114441,completed
949,113700,451,1,0-2,1,0.04408477777777778,0.007817333333333332,113700,0,114151,completed
950,113809,235,1,0-2,1,0.02325194444444445,0.004073333333333333,113809,0,114044,completed
951,114110,479,1,0-2,1,0.04748825,0.008302666666666667,114110,0,114589,completed
952,114424,1265,1,0-2,1,0.1424786388888889,0.021926666666666664,114424,0,115689,completed
954,114786,108,1,0-2,1,0.010778999999999999,0.001872,114786,0,114894,completed
955,114816,210,1,0-2,1,0.02095916666666666,0.0036399999999999996,114816,0,115026,completed
968,116852,77,1,0-2,1,0.00833738888888889,0.0013346666666666665,118292,1440,118369,completed
969,116940,82,1,0-2,1,0.008878777777777777,0.0014213333333333333,118380,1440,118462,completed
956,115124,605,1,0-2,1,0.06510395833333335,0.010486666666666667,118724,3600,119329,completed
953,114680,4967,1,6-12,1,0.2853050972222222,0.4304733333333333,119720,5040,124687,completed
960,116147,3921,2,6-12,2,0.4601779722222222,0.67964,119747,3600,123668,completed
927,111967,3919,2,6-12,2,0.4450334722222222,0.6792933333333333,119887,7920,123806,completed
932,112707,2483,1,2-6,1,0.14552943055555553,0.21519333333333335,119907,7200,122390,completed
957,115594,3865,1,6-12,1,0.21833023611111113,0.3349666666666667,119914,4320,123779,completed
958,115594,3997,1,6-12,1,0.22504798611111113,0.3464066666666667,119914,4320,123911,completed
934,112813,10423,1,12-24,1,0.5947877916666667,0.9033266666666667,120013,7200,130436,completed
967,116425,3654,1,6-12,1,0.2016783888888889,0.31668,120025,3600,123679,completed
918,109971,6135,3,12-24,3-4,1.004554375,1.5951,120051,10080,126186,completed
959,115742,5054,1,6-12,1,0.27326680555555555,0.43801333333333337,120062,4320,125116,completed
981,119416,800,1,0-2,1,0.045444333333333344,0.013866666666666666,120136,720,120936,completed
975,118737,60,1,0-2,1,0.006252500000000002,0.00104,120177,1440,120237,completed
990,120214,1767,1,2-6,1,0.09178094444444446,0.15314,120214,0,121981,completed
905,109421,28542,1,24-48,1,1.8600123888888889,2.47364,120221,10800,148763,completed
971,118075,3567,1,6-12,1,0.1860488472222222,0.30914,120235,2160,123802,completed
982,119581,439,1,0-2,1,0.02182805555555556,0.0076093333333333325,120301,720,120740,completed
993,120305,98,1,0-2,1,0.004872777777777778,0.0016986666666666665,120305,0,120403,completed
926,111690,1963,1,2-6,1,0.10119319444444445,0.17012666666666668,120330,8640,122293,completed
994,120358,97,1,0-2,1,0.004823055555555556,0.0016813333333333333,120358,0,120455,completed
908,109597,3814,1,6-12,1,0.1985488472222222,0.33054666666666666,120397,10800,124211,completed
995,120458,63,1,0-2,1,0.0031325000000000003,0.0010919999999999999,120458,0,120521,completed
976,119044,492,1,0-2,1,0.024495777777777783,0.008527999999999999,120484,1440,120976,completed
961,116179,107,1,0-2,1,0.005320277777777778,0.0018546666666666666,120499,4320,120606,completed
983,119818,1083,1,0-2,1,0.055189527777777775,0.018772,120538,720,121621,completed
912,109740,1933,1,2-6,1,0.10044718055555557,0.16752666666666666,120540,10800,122473,completed
984,119826,435,1,0-2,1,0.021671750000000004,0.00754,120546,720,120981,completed
922,110491,1462,1,2-6,1,0.07537958333333333,0.12670666666666666,120571,10080,122033,completed
977,119133,1301,1,0-2,1,0.06682222222222223,0.022550666666666667,120573,1440,121874,completed
972,118415,524,3,0-2,3-4,0.07900891666666669,0.027247999999999998,120575,2160,121099,completed
978,119139,19842,2,24-48,2,2.381594833333333,3.43928,120579,1440,140421,completed
979,119140,19848,2,24-48,2,2.382404222222222,3.4403200000000003,120580,1440,140428,completed
973,118433,4988,1,6-12,1,0.26342448611111113,0.43229333333333336,120593,2160,125581,completed
974,118440,4831,1,6-12,1,0.2544868472222222,0.41868666666666665,120600,2160,125431,completed
980,119164,1395,1,0-2,1,0.07193013888888888,0.02418,120604,1440,121999,completed
996,120649,227,1,0-2,1,0.011286944444444447,0.003934666666666666,120649,0,120876,completed
997,120665,67,1,0-2,1,0.003331388888888889,0.0011613333333333332,120665,0,120732,completed
998,120678,132,1,0-2,1,0.006563333333333333,0.0022879999999999997,120678,0,120810,completed
985,119964,7669,1,12-24,1,0.41664333333333337,0.6646466666666667,120684,720,128353,completed
962,116366,422,1,0-2,1,0.021282888888888893,0.007314666666666666,120686,4320,121108,completed
986,119977,90,1,0-2,1,0.004475,0.00156,120697,720,120787,completed
963,116384,504,1,0-2,1,0.025562888888888895,0.008735999999999999,120704,4320,121208,completed
964,116389,860,1,0-2,1,0.04399602777777778,0.014906666666666665,120709,4320,121569,completed
965,116391,166,1,0-2,1,0.008253888888888887,0.0028773333333333333,120711,4320,120877,completed
966,116396,529,1,0-2,1,0.026880972222222223,0.009169333333333333,120716,4320,121245,completed
970,117908,197,4,0-2,3-4,0.03938388888888889,0.013658666666666666,120788,2880,120985,completed
987,120082,406,1,0-2,1,0.02069011111111111,0.007037333333333333,120802,720,121208,completed
988,120092,80,1,0-2,1,0.003977777777777778,0.0013866666666666667,120812,720,120892,completed
989,120141,428,1,0-2,1,0.021948250000000002,0.007418666666666666,120861,720,121289,completed
991,120215,1337,1,0-2,1,0.06999416666666666,0.023174666666666666,120935,720,122272,completed
992,120215,1221,1,0-2,1,0.0638236111111111,0.021164,120935,720,122156,completed
999,120951,272,1,0-2,1,0.01386644444444444,0.0047146666666666665,123111,2160,123383,completed
-1,0,0,0,0,0,0.0,0.0,0,0,0,0
