ID,arrival_time,length,cpus,length_class,resource_class,carbon_cost,dollar_cost,start_time,waiting_time,exit_time,reason
0,0,1260,1,0-2,1,0.17048750000000001,0.1092,0,0,1260,completed
1,13,200,1,0-2,1,0.02670555555555556,0.017333333333333333,13,0,213,completed
2,92,314,3,0-2,3-4,0.12578316666666667,0.08164,92,0,406,completed
25,3134,34571,2,48+,2,21.86251,5.992306666666667,3854,720,38425,completed
21,2555,3388,1,6-12,1,0.356517375,0.29362666666666665,3995,1440,7383,completed
28,3284,2472,1,2-6,1,0.27679838888888886,0.21424,4004,720,6476,completed
17,1997,1667,1,2-6,1,0.20267327777777777,0.14447333333333334,4157,2160,5824,completed
12,1284,5424,1,6-12,1,0.5739153333333333,0.47008,4164,2880,9588,completed
7,587,10992,1,12-24,1,2.1507993888888883,0.95264,4187,3600,15179,completed
8,601,10569,1,12-24,1,2.041220694444444,0.91598,4201,3600,14770,completed
32,3505,2215,1,2-6,1,0.2402913888888889,0.19196666666666667,4225,720,6440,completed
13,1389,2434,2,2-6,2,0.5114412777777778,0.42189333333333334,4269,2880,6703,completed
9,810,4732,3,6-12,3-4,1.4114349166666669,1.23032,4410,3600,9142,completed
3,167,4709,1,6-12,1,0.46607037500000004,0.40811333333333333,4487,4320,9196,completed
35,4543,2548,1,2-6,1,0.2490442916666667,0.22082666666666667,4543,0,7091,completed
36,4712,5939,1,12-24,1,0.698753861111111,0.5147133333333334,4712,0,10651,completed
4,397,133,1,0-2,1,0.019083652777777783,0.011526666666666668,4717,4320,4850,completed
5,523,125,2,0-2,2,0.03587152777777779,0.021666666666666667,4843,4320,4968,completed
6,523,125,2,0-2,2,0.03587152777777779,0.021666666666666667,4843,4320,4968,completed
10,958,350,2,0-2,2,0.06758888888888889,0.06066666666666667,5278,4320,5628,completed
11,1159,565,1,0-2,1,0.049256499999999995,0.048966666666666665,5479,4320,6044,completed
41,5540,4093,1,6-12,1,0.4064175555555556,0.3547266666666667,5540,0,9633,completed
31,3487,285,3,0-2,3-4,0.07293016666666666,0.0741,5647,2160,5932,completed
18,2096,83,1,0-2,1,0.007659708333333332,0.007193333333333334,5696,3600,5779,completed
33,4268,61,1,0-2,1,0.005722013888888887,0.005286666666666667,5708,1440,5769,completed
23,2887,183,4,0-2,3-4,0.057024833333333316,0.06344,5767,2880,5950,completed
14,1515,408,1,0-2,1,0.03178433333333333,0.03536,5835,4320,6243,completed
19,2253,494,1,0-2,1,0.03848397222222222,0.042813333333333335,5853,3600,6347,completed
20,2299,112,1,0-2,1,0.00872511111111111,0.009706666666666667,5899,3600,6011,completed
34,4465,709,1,0-2,1,0.05622504166666666,0.06144666666666667,5905,1440,6614,completed
24,3055,65,1,0-2,1,0.005063680555555555,0.005633333333333333,5935,2880,6000,completed
15,1725,222,1,0-2,1,0.017294416666666663,0.01924,6045,4320,6267,completed
16,1725,222,1,0-2,1,0.017294416666666663,0.01924,6045,4320,6267,completed
26,3178,74,1,0-2,1,0.005764805555555554,0.006413333333333333,6058,2880,6132,completed
27,3179,68,1,0-2,1,0.005297388888888887,0.005893333333333334,6059,2880,6127,completed
39,5372,118,2,0-2,2,0.01838505555555555,0.020453333333333334,6092,720,6210,completed
38,5372,118,2,0-2,2,0.01838505555555555,0.020453333333333334,6092,720,6210,completed
40,5375,67,4,0-2,3-4,0.02087794444444444,0.023226666666666666,6095,720,6162,completed
29,3291,95,2,0-2,2,0.014801527777777771,0.016466666666666668,6171,2880,6266,completed
30,3349,704,1,0-2,1,0.0581970138888889,0.061013333333333336,6229,2880,6933,completed
42,6242,427,1,0-2,1,0.03466361111111111,0.03700666666666667,6242,0,6669,completed
22,2660,97,1,0-2,1,0.007556569444444443,0.008406666666666666,6260,3600,6357,completed
37,4901,471,2,0-2,2,0.0782998611111111,0.08164,6341,1440,6812,completed
43,6624,320,2,0-2,2,0.05459555555555557,0.055466666666666664,6624,0,6944,completed
44,6646,707,1,0-2,1,0.06115040277777779,0.06127333333333333,6646,0,7353,completed
45,6666,2386,1,2-6,1,0.22753772222222224,0.20678666666666667,6666,0,9052,completed
46,6676,4359,1,6-12,1,0.5972655972222223,0.37778,6676,0,11035,completed
47,6699,67,2,0-2,2,0.011430944444444447,0.011613333333333333,6699,0,6766,completed
48,6819,3748,1,6-12,1,0.47969683333333335,0.32482666666666665,6819,0,10567,completed
49,6921,77,1,0-2,1,0.006568527777777779,0.006673333333333333,6921,0,6998,completed
51,7487,296,1,0-2,1,0.026874333333333333,0.025653333333333334,7487,0,7783,completed
52,7691,88,3,0-2,3-4,0.023969000000000004,0.02288,7691,0,7779,completed
54,7991,77,1,0-2,1,0.00705298611111111,0.006673333333333333,7991,0,8068,completed
59,8170,69,1,0-2,1,0.006320208333333332,0.00598,8170,0,8239,completed
60,8215,254,1,0-2,1,0.023265694444444443,0.022013333333333333,8215,0,8469,completed
69,9287,328,1,0-2,1,0.05363030555555555,0.028426666666666666,9287,0,9615,completed
72,9366,756,1,0-2,1,0.1337618333333333,0.06552,9366,0,10122,completed
74,9486,131,1,0-2,1,0.022939555555555553,0.011353333333333333,9486,0,9617,completed
76,9583,85,1,0-2,1,0.01488444444444444,0.007366666666666667,9583,0,9668,completed
77,9585,69,1,0-2,1,0.012082666666666662,0.00598,9585,0,9654,completed
78,9614,117,1,0-2,1,0.020488000000000003,0.01014,9614,0,9731,completed
80,9670,1169,3,0-2,3-4,0.6928282916666666,0.30394,9670,0,10839,completed
85,10387,1318,2,0-2,2,0.6423662499999999,0.22845333333333334,10387,0,11705,completed
89,11103,302,1,0-2,1,0.07315530555555554,0.026173333333333333,11103,0,11405,completed
91,11404,79,1,0-2,1,0.024638125,0.006846666666666667,14284,2880,14363,completed
92,11435,465,1,0-2,1,0.12524076388888888,0.0403,14315,2880,14780,completed
112,13597,1366,3,0-2,3-4,1.1114115416666663,0.35516000000000003,14317,720,15683,completed
117,14363,970,1,0-2,1,0.25820204166666666,0.08406666666666666,14363,0,15333,completed
118,14370,67,1,0-2,1,0.01896956944444444,0.005806666666666667,14370,0,14437,completed
110,12955,1388,3,0-2,3-4,1.1223661249999999,0.36088,14395,1440,15783,completed
119,14525,96,1,0-2,1,0.024942666666666665,0.008320000000000001,14525,0,14621,completed
114,13823,61,1,0-2,1,0.01584898611111111,0.005286666666666667,14543,720,14604,completed
99,12477,220,1,0-2,1,0.057160277777777775,0.019066666666666666,14637,2160,14857,completed
111,13242,189,1,0-2,1,0.04910587499999999,0.01638,14682,1440,14871,completed
93,11821,91,1,0-2,1,0.023643569444444443,0.007886666666666667,14701,2880,14792,completed
94,11855,68,1,0-2,1,0.01766772222222222,0.005893333333333334,14735,2880,14803,completed
95,11860,1379,3,0-2,3-4,1.2063911666666667,0.35854,14740,2880,16119,completed
90,11213,175,1,0-2,1,0.04546840277777778,0.015166666666666667,14813,3600,14988,completed
121,14823,81,3,0-2,3-4,0.06313612499999999,0.02106,14823,0,14904,completed
96,11952,277,1,0-2,1,0.0719699861111111,0.024006666666666666,14832,2880,15109,completed
97,11979,62,1,0-2,1,0.016108805555555553,0.005373333333333333,14859,2880,14921,completed
116,14272,471,2,0-2,2,0.2584413333333333,0.08164,14992,720,15463,completed
123,15017,98,1,0-2,1,0.025462305555555554,0.008493333333333334,15017,0,15115,completed
124,15068,1330,1,0-2,1,0.41886861111111107,0.11526666666666667,15068,0,16398,completed
126,15263,125,1,0-2,1,0.0349722222222222,0.010833333333333334,15263,0,15388,completed
127,15338,105,1,0-2,1,0.02937666666666666,0.0091,15338,0,15443,completed
132,15766,67,1,0-2,1,0.018745111111111108,0.005806666666666667,15766,0,15833,completed
137,16372,415,1,0-2,1,0.14857918055555558,0.03596666666666667,16372,0,16787,completed
138,16667,292,1,0-2,1,0.10274750000000003,0.02530666666666667,16667,0,16959,completed
134,16100,884,1,0-2,1,0.31576861111111115,0.07661333333333334,16820,720,17704,completed
139,16918,91,1,0-2,1,0.03202062500000001,0.007886666666666667,16918,0,17009,completed
140,16919,621,1,0-2,1,0.22140326388888895,0.05382,16919,0,17540,completed
142,16963,60,1,0-2,1,0.02111250000000001,0.0052,16963,0,17023,completed
136,16330,104,1,0-2,1,0.03659500000000001,0.009013333333333333,17050,720,17154,completed
144,17338,1163,1,0-2,1,0.37131591666666663,0.10079333333333333,21658,4320,22821,completed
143,17338,1175,1,0-2,1,0.37452325,0.10183333333333333,21658,4320,22833,completed
145,17338,1168,1,0-2,1,0.3726523055555555,0.10122666666666667,21658,4320,22826,completed
147,17682,861,3,0-2,3-4,0.77752375,0.22386,22002,4320,22863,completed
148,17703,378,1,0-2,1,0.128161125,0.03276,22023,4320,22401,completed
151,17888,69,1,0-2,1,0.024745125000000007,0.00598,22208,4320,22277,completed
152,17930,62,1,0-2,1,0.022234750000000008,0.005373333333333333,22250,4320,22312,completed
156,18145,949,1,0-2,1,0.2365672777777778,0.08224666666666666,22465,4320,23414,completed
158,18145,1042,1,0-2,1,0.2571771111111112,0.09030666666666667,22465,4320,23507,completed
153,18145,1319,1,0-2,1,0.31780538888888893,0.11431333333333334,22465,4320,23784,completed
159,18145,358,1,0-2,1,0.09568544444444446,0.031026666666666668,22465,4320,22823,completed
154,18145,1347,1,0-2,1,0.3231261666666667,0.11674,22465,4320,23812,completed
155,18145,1322,1,0-2,1,0.3183754722222223,0.11457333333333333,22465,4320,23787,completed
164,18222,581,1,0-2,1,0.15149805555555557,0.05035333333333333,22542,4320,23123,completed
167,18357,1426,1,0-2,1,0.3217613611111112,0.12358666666666666,22677,4320,24103,completed
168,18471,374,2,0-2,2,0.18850711111111113,0.06482666666666667,22791,4320,23165,completed
169,18508,193,4,0-2,3-4,0.20633844444444444,0.06690666666666667,22828,4320,23021,completed
130,15724,3285,1,6-12,1,0.6003876666666668,0.2847,22924,7200,26209,completed
131,15730,3684,1,6-12,1,0.657689,0.31928,22930,7200,26614,completed
106,12851,4743,1,6-12,1,0.8197395555555556,0.41106,22931,10080,27674,completed
105,12851,4752,1,6-12,1,0.8212468055555555,0.41184,22931,10080,27683,completed
107,12852,4772,1,6-12,1,0.8244964444444445,0.41357333333333335,22932,10080,27704,completed
108,12857,4809,1,6-12,1,0.830193888888889,0.41678,22937,10080,27746,completed
109,12877,3134,1,6-12,1,0.5744050555555555,0.2716133333333333,22957,10080,26091,completed
170,18652,9340,3,12-24,3-4,7.126864333333334,2.4284,22972,4320,32312,completed
70,9317,9595,1,12-24,1,2.4841649444444442,0.8315666666666667,22997,13680,32592,completed
192,20837,10936,1,12-24,1,3.1247700277777777,0.9477866666666667,22997,2160,33933,completed
53,7879,4327,1,6-12,1,0.7439751944444444,0.37500666666666665,22999,15120,27326,completed
71,9334,10055,1,12-24,1,2.6844132222222226,0.8714333333333334,23014,13680,33069,completed
125,15128,3727,2,6-12,2,1.3003254722222224,0.6460133333333333,23048,7920,26775,completed
133,15873,22293,1,24-48,1,7.36007,1.93206,23073,7200,45366,completed
64,8680,4991,1,6-12,1,0.8482283055555556,0.43255333333333335,23080,14400,28071,completed
73,9461,6613,1,12-24,1,1.3559637777777778,0.5731266666666667,23141,13680,29754,completed
83,10187,8318,1,12-24,1,2.0199755277777776,0.7208933333333334,23147,12960,31465,completed
113,13795,1553,1,2-6,1,0.3095153888888889,0.13459333333333334,23155,9360,24708,completed
75,9489,7096,1,12-24,1,1.5650889027777777,0.6149866666666667,23169,13680,30265,completed
55,8059,7351,1,12-24,1,1.6643861944444442,0.6370866666666667,23179,15120,30530,completed
120,14545,4946,1,6-12,1,0.8374540555555555,0.42865333333333333,23185,8640,28131,completed
157,18145,1479,1,2-6,1,0.29541394444444447,0.12818,23185,5040,24664,completed
160,18146,1686,1,2-6,1,0.33042522222222226,0.14612,23186,5040,24872,completed
161,18146,1643,1,2-6,1,0.3231415,0.14239333333333334,23186,5040,24829,completed
65,8791,2081,1,2-6,1,0.3957777222222223,0.18035333333333334,23191,14400,25272,completed
193,21039,31269,2,24-48,2,18.848787666666666,5.41996,23199,2160,54468,completed
171,18888,157,4,0-2,3-4,0.13917177777777778,0.054426666666666665,23208,4320,23365,completed
162,18172,1862,1,2-6,1,0.3588798888888889,0.16137333333333334,23212,5040,25074,completed
163,18178,1994,1,2-6,1,0.3807100555555556,0.17281333333333335,23218,5040,25212,completed
211,23227,2388,1,2-6,1,0.439730875,0.20696,23227,0,25615,completed
172,18909,195,1,0-2,1,0.04321416666666668,0.016900000000000002,23229,4320,23424,completed
56,8115,6930,1,12-24,1,1.50913375,0.6006,23235,15120,30165,completed
57,8139,2558,1,2-6,1,0.46322268055555554,0.22169333333333333,23259,15120,25817,completed
58,8157,6180,1,12-24,1,1.2035216666666668,0.5356,23277,15120,29457,completed
84,10348,2954,1,6-12,1,0.5177002222222222,0.2560133333333333,23308,12960,26262,completed
165,18273,1440,1,2-6,1,0.2821233333333334,0.12480000000000001,23313,5040,24753,completed
50,7474,11448,4,12-24,3-4,13.911450111111112,3.96864,23314,15840,34762,completed
101,12539,3275,1,6-12,1,0.5620267222222223,0.2838333333333333,23339,10800,26614,completed
100,12539,3768,1,6-12,1,0.6345286250000001,0.32656,23339,10800,27107,completed
173,19019,327,1,0-2,1,0.07246683333333334,0.02834,23339,4320,23666,completed
79,9665,4987,1,6-12,1,0.8453006111111112,0.4322066666666667,23345,13680,28332,completed
61,8229,2321,1,2-6,1,0.4210214722222222,0.20115333333333332,23349,15120,25670,completed
103,12549,1730,1,2-6,1,0.32936611111111114,0.14993333333333334,23349,10800,25079,completed
102,12549,1730,1,2-6,1,0.32936611111111114,0.14993333333333334,23349,10800,25079,completed
166,18309,1759,1,2-6,1,0.33427838888888894,0.15244666666666667,23349,5040,25108,completed
86,10396,9304,1,12-24,1,2.431837555555555,0.8063466666666667,23356,12960,32660,completed
146,17611,2681,1,2-6,1,0.47319538888888885,0.23235333333333333,23371,5760,26052,completed
174,19063,71,1,0-2,1,0.015734388888888895,0.006153333333333334,23383,4320,23454,completed
62,8277,7144,1,12-24,1,1.6202887361111111,0.6191466666666666,23397,15120,30541,completed
141,16929,6422,2,12-24,2,2.658341611111111,1.1131466666666667,23409,6480,29831,completed
87,10457,7078,1,12-24,1,1.5982353194444447,0.6134266666666667,23417,12960,30495,completed
190,20543,1531,1,2-6,1,0.29179327777777775,0.13268666666666667,23423,2880,24954,completed
63,8304,7286,1,12-24,1,1.6790439722222223,0.6314533333333333,23424,15120,30710,completed
135,16234,2495,1,2-6,1,0.44134422222222225,0.21623333333333333,23434,7200,25929,completed
66,9037,6248,1,12-24,1,1.2611549722222222,0.5414933333333334,23437,14400,29685,completed
88,10477,12607,1,24-48,1,4.149881166666667,1.0926066666666667,23437,12960,36044,completed
191,20566,1466,1,2-6,1,0.2795818888888889,0.12705333333333332,23446,2880,24912,completed
175,19128,880,4,0-2,3-4,0.7083137777777777,0.30506666666666665,23448,4320,24328,completed
67,9049,4386,1,6-12,1,0.7269303611111111,0.38012,23449,14400,27835,completed
104,12664,5781,1,12-24,1,1.0838877222222223,0.50102,23464,10800,29245,completed
122,14830,1875,1,2-6,1,0.34500062499999995,0.1625,23470,8640,25345,completed
176,19151,156,4,0-2,3-4,0.13828533333333337,0.05408,23471,4320,23627,completed
81,9793,5813,1,12-24,1,1.097015388888889,0.5037933333333333,23473,13680,29286,completed
177,19153,64,1,0-2,1,0.014183111111111115,0.005546666666666667,23473,4320,23537,completed
128,15562,1740,1,2-6,1,0.32371875,0.1508,23482,7920,25222,completed
129,15565,1927,1,2-6,1,0.3518204444444445,0.16700666666666666,23485,7920,25412,completed
82,9840,6355,1,12-24,1,1.323199861111111,0.5507666666666666,23520,13680,29875,completed
149,17795,1518,1,2-6,1,0.2826978888888889,0.13156,23555,5760,25073,completed
98,12054,2661,1,2-6,1,0.4548246666666666,0.23062,23574,11520,26235,completed
115,14245,4271,2,6-12,2,1.3984507777777777,0.7403066666666667,23605,9360,27876,completed
207,22888,1607,1,2-6,1,0.2947359305555556,0.13927333333333333,23608,720,25215,completed
68,9224,9360,1,12-24,1,2.5115497777777778,0.8112,23624,14400,32984,completed
150,17871,2813,1,2-6,1,0.4725907222222222,0.24379333333333333,23631,5760,26444,completed
178,19312,230,2,0-2,2,0.09549811111111112,0.03986666666666667,23632,4320,23862,completed
185,20036,11017,1,12-24,1,3.346125319444444,0.9548066666666667,23636,3600,34653,completed
215,23773,3220,4,6-12,3-4,2.087938277777778,1.1162666666666667,23773,0,26993,completed
179,19580,255,4,0-2,3-4,0.19382833333333332,0.0884,23900,4320,24155,completed
180,19717,80,1,0-2,1,0.015202222222222221,0.006933333333333333,24037,4320,24117,completed
181,19736,176,1,0-2,1,0.033444888888888885,0.015253333333333334,24056,4320,24232,completed
182,19900,375,1,0-2,1,0.06888694444444443,0.0325,24220,4320,24595,completed
183,19962,388,1,0-2,1,0.06980938888888888,0.033626666666666666,24282,4320,24670,completed
184,19996,103,1,0-2,1,0.019572861111111114,0.008926666666666666,24316,4320,24419,completed
186,20149,440,1,0-2,1,0.07475813888888888,0.03813333333333333,24469,4320,24909,completed
187,20173,261,1,0-2,1,0.0442105,0.02262,24493,4320,24754,completed
188,20527,93,1,0-2,1,0.015753166666666665,0.00806,24847,4320,24940,completed
189,20538,884,1,0-2,1,0.13999130555555556,0.07661333333333334,24858,4320,25742,completed
194,21484,69,1,0-2,1,0.010446791666666668,0.00598,25804,4320,25873,completed
209,22988,199,1,0-2,1,0.029253277777777774,0.017246666666666667,25868,2880,26067,completed
213,23710,897,1,0-2,1,0.13097854166666664,0.07774,25870,2160,26767,completed
195,21563,745,1,0-2,1,0.10857656944444442,0.06456666666666666,25883,4320,26628,completed
214,23725,67,1,0-2,1,0.009953319444444445,0.005806666666666667,25885,2160,25952,completed
196,21591,610,1,0-2,1,0.0887747361111111,0.052866666666666666,25911,4320,26521,completed
222,24481,378,1,0-2,1,0.054977999999999985,0.03276,25921,1440,26299,completed
197,21637,784,1,0-2,1,0.11420098611111108,0.06794666666666667,25957,4320,26741,completed
210,23087,542,1,0-2,1,0.07883088888888887,0.04697333333333333,25967,2880,26509,completed
216,23810,879,1,0-2,1,0.1282027083333333,0.07618,25970,2160,26849,completed
198,21673,782,1,0-2,1,0.11396818055555552,0.06777333333333334,25993,4320,26775,completed
202,22438,277,1,0-2,1,0.04028811111111111,0.024006666666666666,26038,3600,26315,completed
217,23906,337,1,0-2,1,0.04901477777777777,0.029206666666666665,26066,2160,26403,completed
199,21778,1145,1,0-2,1,0.16756401388888886,0.09923333333333334,26098,4320,27243,completed
203,22509,78,1,0-2,1,0.011344666666666666,0.00676,26109,3600,26187,completed
204,22509,122,1,0-2,1,0.01774422222222222,0.010573333333333334,26109,3600,26231,completed
218,24058,65,1,0-2,1,0.009453888888888888,0.005633333333333333,26218,2160,26283,completed
205,22647,224,1,0-2,1,0.03257955555555555,0.019413333333333335,26247,3600,26471,completed
200,21946,611,1,0-2,1,0.08927143055555554,0.05295333333333333,26266,4320,26877,completed
230,25585,1313,1,0-2,1,0.1978817222222222,0.11379333333333333,26305,720,27618,completed
232,25598,189,2,0-2,2,0.054977999999999985,0.03276,26318,720,26507,completed
231,25598,189,2,0-2,2,0.054977999999999985,0.03276,26318,720,26507,completed
225,24890,103,1,0-2,1,0.014980777777777775,0.008926666666666666,26330,1440,26433,completed
236,26334,88,1,0-2,1,0.012799111111111108,0.007626666666666667,26334,0,26422,completed
212,23478,251,1,0-2,1,0.036506555555555556,0.021753333333333333,26358,2880,26609,completed
234,25678,125,1,0-2,1,0.018180555555555554,0.010833333333333334,26398,720,26523,completed
206,22818,61,1,0-2,1,0.008872111111111112,0.005286666666666667,26418,3600,26479,completed
201,22124,84,1,0-2,1,0.012217333333333332,0.00728,26444,4320,26528,completed
235,25725,83,2,0-2,2,0.024143777777777774,0.014386666666666667,26445,720,26528,completed
219,24289,203,1,0-2,1,0.029545722222222216,0.017593333333333332,26449,2160,26652,completed
220,24359,96,1,0-2,1,0.013962666666666663,0.008320000000000001,26519,2160,26615,completed
226,25081,67,1,0-2,1,0.009744777777777778,0.005806666666666667,26521,1440,26588,completed
221,24363,87,1,0-2,1,0.012653666666666665,0.00754,26523,2160,26610,completed
208,22931,197,1,0-2,1,0.028802888888888878,0.017073333333333333,26531,3600,26728,completed
237,26539,534,1,0-2,1,0.07840704166666665,0.04628,26539,0,27073,completed
239,26559,592,1,0-2,1,0.08697606944444444,0.05130666666666667,26559,0,27151,completed
240,26611,73,1,0-2,1,0.01069261111111111,0.006326666666666667,26611,0,26684,completed
241,26639,197,1,0-2,1,0.028987388888888882,0.017073333333333333,26639,0,26836,completed
242,26777,143,1,0-2,1,0.021042847222222216,0.012393333333333334,26777,0,26920,completed
243,26797,231,1,0-2,1,0.03399229166666666,0.02002,26797,0,27028,completed
244,26884,67,1,0-2,1,0.009859236111111109,0.005806666666666667,26884,0,26951,completed
245,26885,65,1,0-2,1,0.009564930555555554,0.005633333333333333,26885,0,26950,completed
246,26889,283,1,0-2,1,0.04164423611111111,0.024526666666666665,26889,0,27172,completed
247,26892,107,1,0-2,1,0.01574534722222222,0.009273333333333333,26892,0,26999,completed
248,26993,784,1,0-2,1,0.12384098611111112,0.06794666666666667,26993,0,27777,completed
249,27169,459,1,0-2,1,0.0729887361111111,0.03978,27169,0,27628,completed
250,27246,67,1,0-2,1,0.009859236111111109,0.005806666666666667,27246,0,27313,completed
251,27251,114,1,0-2,1,0.016877013888888886,0.00988,27251,0,27365,completed
252,27321,949,1,0-2,1,0.16725340277777778,0.08224666666666666,27321,0,28270,completed
255,27921,1215,1,0-2,1,0.30567608333333335,0.1053,27921,0,29136,completed
256,28282,798,1,0-2,1,0.21487355555555557,0.06916,28282,0,29080,completed
257,28287,753,1,0-2,1,0.19904300000000003,0.06526,28287,0,29040,completed
258,28360,133,1,0-2,1,0.02865411111111112,0.011526666666666668,28360,0,28493,completed
259,28672,1075,1,0-2,1,0.3892398611111111,0.09316666666666666,28672,0,29747,completed
266,29466,77,1,0-2,1,0.029055833333333322,0.006673333333333333,30906,1440,30983,completed
260,28863,317,1,0-2,1,0.1153615833333333,0.027473333333333332,31023,2160,31340,completed
275,30345,124,1,0-2,1,0.04512566666666666,0.010746666666666667,31065,720,31189,completed
276,30346,324,1,0-2,1,0.11790899999999996,0.02808,31066,720,31390,completed
277,30347,142,1,0-2,1,0.05167616666666665,0.012306666666666667,31067,720,31209,completed
278,30349,123,1,0-2,1,0.044761749999999996,0.01066,31069,720,31192,completed
279,30353,370,1,0-2,1,0.13464916666666665,0.03206666666666667,31073,720,31443,completed
268,29728,247,1,0-2,1,0.08988741666666666,0.021406666666666668,31168,1440,31415,completed
262,29069,1100,4,0-2,3-4,1.623912277777778,0.38133333333333336,31229,2160,32329,completed
282,31235,110,1,0-2,1,0.04003083333333332,0.009533333333333333,31235,0,31345,completed
263,29169,160,1,0-2,1,0.05822666666666665,0.013866666666666666,31329,2160,31489,completed
280,30629,586,1,0-2,1,0.21548287499999996,0.05078666666666667,31349,720,31935,completed
270,29934,288,1,0-2,1,0.10480799999999997,0.02496,31374,1440,31662,completed
271,29949,186,1,0-2,1,0.06768849999999998,0.01612,31389,1440,31575,completed
264,29282,1011,3,0-2,3-4,1.1330305000000003,0.26286,31442,2160,32453,completed
265,29298,70,1,0-2,1,0.025474166666666652,0.006066666666666666,31458,2160,31528,completed
272,30024,284,1,0-2,1,0.10394638888888887,0.024613333333333334,31464,1440,31748,completed
273,30093,457,1,0-2,1,0.16901811111111115,0.039606666666666665,31533,1440,31990,completed
283,31921,268,1,0-2,1,0.09987094444444447,0.023226666666666666,31921,0,32189,completed
284,32262,1421,1,0-2,1,0.6478559305555556,0.12315333333333334,32262,0,33683,completed
285,32302,67,1,0-2,1,0.02496773611111111,0.005806666666666667,32302,0,32369,completed
287,32401,403,1,0-2,1,0.17302133333333333,0.03492666666666667,32401,0,32804,completed
288,32442,68,1,0-2,1,0.029194666666666664,0.005893333333333334,32442,0,32510,completed
289,32572,127,2,0-2,2,0.10905066666666664,0.022013333333333333,32572,0,32699,completed
291,32694,108,1,0-2,1,0.04636799999999999,0.00936,32694,0,32802,completed
294,33652,190,1,0-2,1,0.09693977777777776,0.016466666666666668,33652,0,33842,completed
295,33694,82,1,0-2,1,0.041846194444444436,0.0071066666666666665,33694,0,33776,completed
296,33771,77,1,0-2,1,0.03921093055555555,0.006673333333333333,33771,0,33848,completed
292,33074,95,2,0-2,2,0.09593577777777776,0.016466666666666668,33794,720,33889,completed
293,33083,95,2,0-2,2,0.09574752777777776,0.016466666666666668,33803,720,33898,completed
297,33838,68,4,0-2,3-4,0.13555811111111116,0.023573333333333335,38158,4320,38226,completed
298,33978,91,3,0-2,3-4,0.13540800000000003,0.02366,38298,4320,38389,completed
300,34153,65,1,0-2,1,0.032240000000000005,0.005633333333333333,38473,4320,38538,completed
301,34156,83,2,0-2,2,0.08233600000000002,0.014386666666666667,38476,4320,38559,completed
302,34382,133,1,0-2,1,0.06596800000000003,0.011526666666666668,38702,4320,38835,completed
304,34486,1338,1,0-2,1,0.4904071111111112,0.11596000000000001,38806,4320,40144,completed
305,34840,62,1,0-2,1,0.021992777777777778,0.005373333333333333,39160,4320,39222,completed
306,35170,62,1,0-2,1,0.021992777777777778,0.005373333333333333,39490,4320,39552,completed
307,35197,67,1,0-2,1,0.023766388888888892,0.005806666666666667,39517,4320,39584,completed
309,35609,1228,1,0-2,1,0.35452048611111114,0.10642666666666667,39929,4320,41157,completed
310,35609,1047,1,0-2,1,0.3156050277777778,0.09074,39929,4320,40976,completed
312,35610,1122,1,0-2,1,0.33438533333333337,0.09724000000000001,39930,4320,41052,completed
313,35610,1108,1,0-2,1,0.3315981666666667,0.09602666666666666,39930,4320,41038,completed
315,35760,69,1,0-2,1,0.02515241666666666,0.00598,40080,4320,40149,completed
316,35765,721,1,0-2,1,0.2138870277777778,0.06248666666666667,40085,4320,40806,completed
317,36083,192,1,0-2,1,0.05065600000000001,0.016640000000000002,40403,4320,40595,completed
261,28962,4050,1,6-12,1,0.8177880000000001,0.351,40482,11520,44532,completed
318,36201,63,1,0-2,1,0.016621500000000004,0.0054600000000000004,40521,4320,40584,completed
267,29723,23537,1,24-48,1,4.824867944444445,2.0398733333333334,40523,10800,64060,completed
299,34091,2289,1,2-6,1,0.45348255555555556,0.19838,40571,6480,42860,completed
290,32670,2561,4,2-6,3-4,2.0074567222222224,0.8878133333333333,40590,7920,43151,completed
269,29797,1819,2,2-6,2,0.7316718888888889,0.3152933333333333,40597,10800,42416,completed
321,36280,801,1,0-2,1,0.18405995833333333,0.06942,40600,4320,41401,completed
224,24763,42957,1,48+,1,7.649009611111111,3.72294,40603,15840,83560,completed
281,30697,3049,4,6-12,3-4,2.346351,1.0569866666666667,40777,10080,43826,completed
254,27826,1840,2,2-6,2,0.7076452777777777,0.31893333333333335,40786,12960,42626,completed
323,36471,658,4,0-2,3-4,0.5708231666666668,0.22810666666666668,40791,4320,41449,completed
233,25676,3049,1,6-12,1,0.5853709583333333,0.2642466666666667,40796,15120,43845,completed
324,36530,282,1,0-2,1,0.06745116666666667,0.02444,40850,4320,41132,completed
303,34398,23251,2,24-48,2,9.499369083333335,4.030173333333334,40878,6480,64129,completed
325,36581,217,2,0-2,2,0.10271916666666667,0.03761333333333333,40901,4320,41118,completed
227,25100,12719,1,24-48,1,2.8045295416666667,1.1023133333333333,40940,15840,53659,completed
238,26542,5113,1,6-12,1,1.050269138888889,0.44312666666666667,40942,14400,46055,completed
228,25104,11168,1,12-24,1,2.4770591111111115,0.9678933333333334,40944,15840,52112,completed
286,32304,2799,1,2-6,1,0.525944875,0.24258000000000002,40944,8640,43743,completed
229,25139,3460,1,6-12,1,0.6662105833333334,0.29986666666666667,40979,15840,44439,completed
274,30204,1703,1,2-6,1,0.3111693472222222,0.14759333333333333,41004,10800,42707,completed
326,36684,94,1,0-2,1,0.02041891666666666,0.008146666666666667,41004,4320,41098,completed
253,27340,2085,1,2-6,1,0.3799754861111111,0.1807,41020,13680,43105,completed
223,24590,1898,1,2-6,1,0.34352802777777774,0.16449333333333332,41150,16560,43048,completed
337,38721,1060,1,0-2,1,0.1875993611111111,0.09186666666666667,41601,2880,42661,completed
369,41607,1107,1,0-2,1,0.196194375,0.09594,41607,0,42714,completed
356,39481,462,1,0-2,1,0.08169330555555557,0.04004,41641,2160,42103,completed
357,39491,437,1,0-2,1,0.07721768055555556,0.037873333333333335,41651,2160,42088,completed
363,41001,173,1,0-2,1,0.03050490277777778,0.014993333333333334,41721,720,41894,completed
364,41001,205,1,0-2,1,0.0360360138888889,0.017766666666666667,41721,720,41926,completed
339,38843,136,1,0-2,1,0.02407866666666667,0.011786666666666668,41723,2880,41859,completed
340,38845,327,1,0-2,1,0.05706159722222222,0.02834,41725,2880,42052,completed
335,38128,1022,1,0-2,1,0.18001658333333334,0.08857333333333334,41728,3600,42750,completed
360,40319,141,1,0-2,1,0.024386902777777778,0.01222,41759,1440,41900,completed
341,38894,870,1,0-2,1,0.15212186111111115,0.0754,41774,2880,42644,completed
332,37535,242,1,0-2,1,0.041829027777777784,0.020973333333333333,41855,4320,42097,completed
343,39034,1058,1,0-2,1,0.18810669444444444,0.09169333333333334,41914,2880,42972,completed
333,37640,120,1,0-2,1,0.02074166666666667,0.0104,41960,4320,42080,completed
365,41312,160,1,0-2,1,0.027655555555555558,0.013866666666666666,42032,720,42192,completed
347,39155,1284,1,0-2,1,0.23280222222222222,0.11128,42035,2880,43319,completed
366,41325,150,1,0-2,1,0.025927083333333333,0.013,42045,720,42195,completed
367,41325,150,1,0-2,1,0.025927083333333333,0.013,42045,720,42195,completed
358,39886,65,1,0-2,1,0.011235069444444445,0.005633333333333333,42046,2160,42111,completed
348,39174,93,1,0-2,1,0.01607479166666667,0.00806,42054,2880,42147,completed
359,39922,780,2,0-2,2,0.2777697777777778,0.13520000000000001,42082,2160,42862,completed
350,39237,743,1,0-2,1,0.13246826388888888,0.06439333333333333,42117,2880,42860,completed
351,39247,773,1,0-2,1,0.13807923611111111,0.06699333333333334,42127,2880,42900,completed
362,40724,1134,1,0-2,1,0.20630930555555554,0.09828,42164,1440,43298,completed
361,40724,1134,1,0-2,1,0.20630930555555554,0.09828,42164,1440,43298,completed
353,39363,759,1,0-2,1,0.13674454166666666,0.06578,42243,2880,43002,completed
354,39371,409,1,0-2,1,0.0726095138888889,0.03544666666666667,42251,2880,42660,completed
355,39403,1236,1,0-2,1,0.22989444444444443,0.10712,42283,2880,43519,completed
386,44536,824,1,0-2,1,0.17617655555555556,0.07141333333333333,47416,2880,48240,completed
387,44538,185,1,0-2,1,0.041865652777777776,0.016033333333333333,47418,2880,47603,completed
407,46720,71,2,0-2,2,0.03400702777777777,0.012306666666666667,47440,720,47511,completed
393,45295,1179,1,0-2,1,0.255136375,0.10218,47455,2160,48634,completed
375,43891,155,1,0-2,1,0.03341734722222223,0.013433333333333334,47491,3600,47646,completed
376,43891,1150,2,0-2,2,0.4961673055555556,0.19933333333333333,47491,3600,48641,completed
377,43910,180,1,0-2,1,0.03811138888888889,0.015600000000000001,47510,3600,47690,completed
378,43982,171,2,0-2,2,0.07185325000000001,0.02964,47582,3600,47753,completed
403,46142,593,1,0-2,1,0.12458765277777778,0.05139333333333333,47582,1440,48175,completed
394,45498,1080,1,0-2,1,0.23388391666666666,0.0936,47658,2160,48738,completed
395,45499,847,1,0-2,1,0.18168004166666668,0.07340666666666666,47659,2160,48506,completed
388,44818,689,1,0-2,1,0.14681702777777778,0.059713333333333334,47698,2880,48387,completed
410,47700,817,1,0-2,1,0.17553127777777777,0.07080666666666667,47700,0,48517,completed
379,44138,140,1,0-2,1,0.029413611111111113,0.012133333333333333,47738,3600,47878,completed
396,45622,356,1,0-2,1,0.07479461111111112,0.030853333333333333,47782,2160,48138,completed
381,44214,1049,1,0-2,1,0.2291226388888889,0.09091333333333333,47814,3600,48863,completed
412,47824,111,1,0-2,1,0.02332079166666667,0.00962,47824,0,47935,completed
390,44963,535,1,0-2,1,0.11433593055555556,0.04636666666666667,47843,2880,48378,completed
404,46424,350,1,0-2,1,0.07353402777777779,0.030333333333333334,47864,1440,48214,completed
382,44268,198,1,0-2,1,0.041599250000000004,0.01716,47868,3600,48066,completed
398,45710,292,1,0-2,1,0.06134838888888888,0.02530666666666667,47870,2160,48162,completed
399,45711,281,1,0-2,1,0.059037319444444444,0.024353333333333334,47871,2160,48152,completed
400,45732,848,1,0-2,1,0.1851693888888889,0.07349333333333334,47892,2160,48740,completed
413,47910,61,1,0-2,1,0.012815930555555558,0.005286666666666667,47910,0,47971,completed
391,45053,472,1,0-2,1,0.10147818055555555,0.04090666666666667,47933,2880,48405,completed
408,47229,187,1,0-2,1,0.03928818055555556,0.016206666666666668,47949,720,48136,completed
383,44357,786,1,0-2,1,0.17218540277777777,0.06812,47957,3600,48743,completed
409,47241,72,1,0-2,1,0.015127,0.00624,47961,720,48033,completed
384,44409,949,1,0-2,1,0.20944423611111113,0.08224666666666666,48009,3600,48958,completed
402,45862,294,1,0-2,1,0.0628336388888889,0.02548,48022,2160,48316,completed
385,44459,1168,1,0-2,1,0.2602710138888889,0.10122666666666667,48059,3600,49227,completed
392,45193,394,1,0-2,1,0.08595945833333334,0.034146666666666665,48073,2880,48467,completed
415,48123,63,1,0-2,1,0.014170625000000003,0.0054600000000000004,52443,4320,52506,completed
416,48154,199,2,0-2,2,0.08477636111111109,0.034493333333333334,52474,4320,52673,completed
423,49616,589,3,0-2,3-4,0.3643772916666666,0.15314,52496,2880,53085,completed
420,48927,94,1,0-2,1,0.019862472222222212,0.008146666666666667,52527,3600,52621,completed
424,49690,1004,3,0-2,3-4,0.6177913333333335,0.26104,52570,2880,53574,completed
433,51206,126,4,0-2,3-4,0.102781,0.043680000000000004,52646,1440,52772,completed
308,35461,1514,1,2-6,1,0.3176610694444445,0.13121333333333335,52741,17280,54255,completed
429,50677,127,1,0-2,1,0.025899180555555554,0.011006666666666666,52837,2160,52964,completed
425,49978,169,1,0-2,1,0.03446426388888889,0.014646666666666667,52858,2880,53027,completed
430,50698,377,1,0-2,1,0.07688181944444444,0.03267333333333333,52858,2160,53235,completed
426,49982,138,1,0-2,1,0.02814241666666667,0.01196,52862,2880,53000,completed
311,35610,1576,1,2-6,1,0.33527791666666673,0.13658666666666666,52890,17280,54466,completed
314,35613,2060,1,2-6,1,0.4456625,0.17853333333333335,52893,17280,54953,completed
427,50035,126,1,0-2,1,0.02569525,0.010920000000000001,52915,2880,53041,completed
417,48606,112,1,0-2,1,0.022840222222222227,0.009706666666666667,52926,4320,53038,completed
418,48670,137,1,0-2,1,0.027938486111111112,0.011873333333333333,52990,4320,53127,completed
428,50136,123,1,0-2,1,0.025083458333333336,0.01066,53016,2880,53139,completed
421,49475,449,1,0-2,1,0.09254759722222225,0.038913333333333334,53075,3600,53524,completed
422,49515,607,3,0-2,3-4,0.3766983750000001,0.15782000000000002,53115,3600,53722,completed
319,36204,3223,1,6-12,1,0.6720186527777777,0.27932666666666667,53484,17280,56707,completed
320,36269,2678,1,2-6,1,0.5916680277777778,0.23209333333333335,53549,17280,56227,completed
322,36435,5286,1,6-12,1,0.9536915416666668,0.45812,53715,17280,59001,completed
327,36816,4714,3,6-12,3-4,2.544485833333333,1.22564,54096,17280,58810,completed
328,37065,11598,1,24-48,1,2.14446425,1.00516,54345,17280,65943,completed
329,37107,3611,1,6-12,1,0.66658,0.31295333333333336,54387,17280,57998,completed
330,37189,5415,3,6-12,3-4,2.6613238333333333,1.4079,54469,17280,59884,completed
331,37335,9897,1,12-24,1,1.8150775000000001,0.8577400000000001,54615,17280,64512,completed
334,38060,8256,2,12-24,2,2.787126777777778,1.43104,55340,17280,63596,completed
435,51572,107,3,0-2,3-4,0.07147599999999998,0.02782,55892,4320,55999,completed
436,51611,856,2,0-2,2,0.2765834166666666,0.14837333333333333,55931,4320,56787,completed
336,38669,1576,1,2-6,1,0.23739829166666668,0.13658666666666666,55949,17280,57525,completed
338,38746,2142,2,2-6,2,0.6474946666666667,0.37128,56026,17280,58168,completed
406,46681,2204,1,2-6,1,0.3330160833333334,0.19101333333333334,56041,9360,58245,completed
437,51799,92,1,0-2,1,0.016230374999999995,0.007973333333333334,56119,4320,56211,completed
370,42489,3661,1,6-12,1,0.4964138194444444,0.31728666666666666,56169,13680,59830,completed
342,38982,1575,1,2-6,1,0.2255066666666667,0.1365,56262,17280,57837,completed
371,42594,4585,1,6-12,1,0.6243599861111111,0.39736666666666665,56274,13680,60859,completed
438,52072,1154,1,0-2,1,0.16104847222222224,0.10001333333333333,56392,4320,57546,completed
344,39119,3503,1,6-12,1,0.47450751388888895,0.3035933333333333,56399,17280,59902,completed
346,39130,4834,1,6-12,1,0.6581170833333334,0.4189466666666667,56410,17280,61244,completed
345,39130,4834,1,6-12,1,0.6581170833333334,0.4189466666666667,56410,17280,61244,completed
380,44187,3610,1,6-12,1,0.4895801527777778,0.3128666666666667,56427,12240,60037,completed
452,53549,397,2,0-2,2,0.1105534722222222,0.06881333333333334,56429,2880,56826,completed
453,53555,480,1,0-2,1,0.06685277777777776,0.0416,56435,2880,56915,completed
389,44928,10297,1,12-24,1,1.8001947222222223,0.8924066666666667,56448,11520,66745,completed
372,42783,2656,1,2-6,1,0.37711677777777786,0.23018666666666668,56463,13680,59119,completed
454,53584,132,1,0-2,1,0.018379166666666665,0.01144,56464,2880,56596,completed
349,39185,2539,2,2-6,2,0.7275799722222223,0.44009333333333334,56465,17280,59004,completed
373,42786,3009,1,6-12,1,0.4147564583333334,0.26078,56466,13680,59475,completed
397,45674,2719,1,2-6,1,0.38349598611111113,0.23564666666666667,56474,10800,59193,completed
368,41387,1487,1,2-6,1,0.21710256944444445,0.12887333333333334,56507,15120,57994,completed
352,39249,1697,1,2-6,1,0.252029375,0.14707333333333333,56529,17280,58226,completed
401,45811,16642,1,24-48,1,2.6256407361111114,1.4423066666666666,56611,10800,73253,completed
440,52367,1299,1,0-2,1,0.19073006944444448,0.11258,56687,4320,57986,completed
442,52367,1348,1,0-2,1,0.19875381944444448,0.11682666666666666,56687,4320,58035,completed
448,52368,277,1,0-2,1,0.038615625,0.024006666666666666,56688,4320,56965,completed
447,52368,277,1,0-2,1,0.038615625,0.024006666666666666,56688,4320,56965,completed
405,46610,6531,4,12-24,3-4,4.112432777777778,2.26408,56690,10080,63221,completed
374,43771,4646,1,6-12,1,0.6333907638888889,0.40265333333333336,56731,12960,61377,completed
481,58787,245,1,0-2,1,0.03132597222222223,0.021233333333333333,58787,0,59032,completed
467,56645,923,1,0-2,1,0.10359647222222224,0.07999333333333333,58805,2160,59728,completed
472,57384,160,1,0-2,1,0.02045777777777778,0.013866666666666666,58824,1440,58984,completed
473,57541,91,1,0-2,1,0.010964694444444442,0.007886666666666667,58981,1440,59072,completed
474,57542,318,1,0-2,1,0.03521066666666667,0.02756,58982,1440,59300,completed
462,56158,691,1,0-2,1,0.07391173611111113,0.059886666666666664,59038,2880,59729,completed
479,58363,664,1,0-2,1,0.07098344444444446,0.05754666666666667,59083,720,59747,completed
475,57699,105,1,0-2,1,0.011224791666666668,0.0091,59139,1440,59244,completed
463,56269,731,1,0-2,1,0.08218093055555557,0.06335333333333333,59149,2880,59880,completed
480,58498,257,1,0-2,1,0.02747401388888889,0.022273333333333332,59218,720,59475,completed
482,59218,130,1,0-2,1,0.013897361111111112,0.011266666666666666,59218,0,59348,completed
476,57839,365,1,0-2,1,0.039019513888888885,0.03163333333333333,59279,1440,59644,completed
477,57840,544,1,0-2,1,0.06030711111111112,0.04714666666666667,59280,1440,59824,completed
483,59286,617,1,0-2,1,0.0707673888888889,0.05347333333333333,59286,0,59903,completed
471,57157,306,1,0-2,1,0.03271225,0.026520000000000002,59317,2160,59623,completed
465,56454,257,1,0-2,1,0.02747401388888889,0.022273333333333332,59334,2880,59591,completed
466,56456,919,1,0-2,1,0.11488802777777779,0.07964666666666667,59336,2880,60255,completed
478,57919,67,1,0-2,1,0.007162486111111112,0.005806666666666667,59359,1440,59426,completed
488,60350,751,1,0-2,1,0.10219848611111114,0.06508666666666667,60350,0,61101,completed
491,61146,137,1,0-2,1,0.019759777777777775,0.011873333333333333,61146,0,61283,completed
411,47790,2259,4,2-6,3-4,1.2751260000000002,0.78312,65070,17280,67329,completed
414,48049,1771,1,2-6,1,0.24499823611111113,0.15348666666666666,65329,17280,67100,completed
492,61158,123,1,0-2,1,0.019509000000000002,0.01066,65478,4320,65601,completed
493,61159,121,1,0-2,1,0.01917865277777778,0.010486666666666667,65479,4320,65600,completed
494,61220,427,2,0-2,2,0.1233792777777778,0.07401333333333333,65540,4320,65967,completed
495,61226,156,2,0-2,2,0.04507533333333334,0.02704,65546,4320,65702,completed
496,61312,431,1,0-2,1,0.06226752777777779,0.037353333333333336,65632,4320,66063,completed
497,61312,431,1,0-2,1,0.06226752777777779,0.037353333333333336,65632,4320,66063,completed
498,61330,712,1,0-2,1,0.10045472222222224,0.06170666666666667,65650,4320,66362,completed
434,51515,10525,1,12-24,1,1.239218472222222,0.9121666666666667,65915,14400,76440,completed
500,61602,601,1,0-2,1,0.08123855555555556,0.05208666666666667,65922,4320,66523,completed
419,48727,4357,2,6-12,2,1.001287611111111,0.7552133333333333,66007,17280,70364,completed
501,61704,641,1,0-2,1,0.08421294444444445,0.055553333333333337,66024,4320,66665,completed
439,52366,1604,1,2-6,1,0.19508844444444448,0.13901333333333332,66046,13680,67650,completed
444,52367,7298,1,12-24,1,0.9564075833333335,0.6324933333333334,66047,13680,73345,completed
441,52367,7217,1,12-24,1,0.9410895833333334,0.6254733333333333,66047,13680,73264,completed
446,52367,3941,1,6-12,1,0.45448669444444445,0.3415533333333333,66047,13680,69988,completed
443,52367,1995,1,2-6,1,0.23841475000000006,0.1729,66047,13680,68042,completed
445,52367,2313,1,2-6,1,0.27365091666666674,0.20046,66047,13680,68360,completed
502,61805,974,1,0-2,1,0.12197844444444446,0.08441333333333334,66125,4320,67099,completed
450,53223,4231,1,6-12,1,0.4805861388888889,0.36668666666666666,66183,12960,70414,completed
431,51075,2461,1,2-6,1,0.2868203611111112,0.21328666666666668,66195,15120,68656,completed
451,53310,4024,1,6-12,1,0.4557228888888889,0.34874666666666665,66270,12960,70294,completed
432,51154,1919,1,2-6,1,0.2230226944444445,0.16631333333333334,66274,15120,68193,completed
503,62001,206,1,0-2,1,0.02569277777777778,0.017853333333333332,66321,4320,66527,completed
504,62001,508,1,0-2,1,0.06335888888888888,0.044026666666666665,66321,4320,66829,completed
449,52785,5805,1,12-24,1,0.6965675,0.5031,66465,13680,72270,completed
507,62292,619,1,0-2,1,0.07374780555555557,0.05364666666666667,66612,4320,67231,completed
508,62553,389,1,0-2,1,0.04466644444444445,0.03371333333333333,66873,4320,67262,completed
509,62705,823,1,0-2,1,0.09195713888888893,0.07132666666666666,67025,4320,67848,completed
514,64516,177,1,0-2,1,0.01981908333333334,0.01534,67396,2880,67573,completed
511,63329,217,1,0-2,1,0.024080972222222233,0.018806666666666666,67649,4320,67866,completed
512,63601,281,1,0-2,1,0.03113636111111112,0.024353333333333334,67921,4320,68202,completed
513,63622,113,1,0-2,1,0.012521027777777782,0.009793333333333333,67942,4320,68055,completed
534,68348,762,1,0-2,1,0.08086516666666665,0.06604,69068,720,69830,completed
542,69150,1292,1,0-2,1,0.1372897777777778,0.11197333333333334,69150,0,70442,completed
545,69150,1256,1,0-2,1,0.13342377777777775,0.10885333333333333,69150,0,70406,completed
543,69150,1394,1,0-2,1,0.14824344444444443,0.12081333333333334,69150,0,70544,completed
549,69156,969,1,0-2,1,0.10261583333333332,0.08398,69156,0,70125,completed
548,69156,1050,1,0-2,1,0.11131433333333332,0.091,69156,0,70206,completed
536,68479,91,1,0-2,1,0.009580277777777776,0.007886666666666667,69199,720,69290,completed
527,66348,712,1,0-2,1,0.0751688888888889,0.06170666666666667,69228,2880,69940,completed
517,65675,126,1,0-2,1,0.013264999999999994,0.010920000000000001,69275,3600,69401,completed
518,65700,114,1,0-2,1,0.012001666666666664,0.00988,69300,3600,69414,completed
521,65753,459,4,0-2,3-4,0.19328999999999996,0.15912,69353,3600,69812,completed
537,68645,362,1,0-2,1,0.03811055555555555,0.031373333333333336,69365,720,69727,completed
528,66571,118,1,0-2,1,0.012422777777777772,0.010226666666666667,69451,2880,69569,completed
515,65228,557,3,0-2,3-4,0.1775975,0.14482,69548,4320,70105,completed
531,68136,77,1,0-2,1,0.008106388888888889,0.006673333333333333,69576,1440,69653,completed
532,68137,90,1,0-2,1,0.009474999999999999,0.0078000000000000005,69577,1440,69667,completed
524,66003,955,1,0-2,1,0.10205605555555554,0.08276666666666667,69603,3600,70558,completed
525,66117,85,1,0-2,1,0.008948611111111109,0.007366666666666667,69717,3600,69802,completed
533,68294,753,2,0-2,2,0.16128011111111107,0.13052,69734,1440,70487,completed
526,66143,412,1,0-2,1,0.044039444444444444,0.035706666666666664,69743,3600,70155,completed
455,55418,11702,1,24-48,1,1.812899777777778,1.0141733333333334,72698,17280,84400,completed
456,55423,11521,1,24-48,1,1.773293777777778,0.9984866666666666,72703,17280,84224,completed
460,55424,11847,1,24-48,1,1.8445618611111114,1.02674,72704,17280,84551,completed
457,55424,11442,1,12-24,1,1.7541211666666667,0.99164,72704,17280,84146,completed
459,55424,11787,1,24-48,1,1.8315268611111113,1.0215400000000001,72704,17280,84491,completed
458,55424,11868,1,24-48,1,1.8491241111111112,1.02856,72704,17280,84572,completed
461,55453,5369,1,6-12,1,0.4946415555555555,0.46531333333333336,72733,17280,78102,completed
464,56297,1553,1,2-6,1,0.1341487222222222,0.13459333333333334,73577,17280,75130,completed
489,60658,1746,1,2-6,1,0.14704722222222222,0.15132,73618,12960,75364,completed
499,61384,1609,4,2-6,3-4,0.5466526111111112,0.5577866666666667,73624,12240,75233,completed
551,70034,2646,1,2-6,1,0.21292827777777779,0.22932,73634,3600,76280,completed
470,57089,3437,3,6-12,3-4,0.8088705,0.89362,73649,16560,77086,completed
568,73653,1847,1,2-6,1,0.1533233611111111,0.16007333333333335,73653,0,75500,completed
552,70055,2597,1,2-6,1,0.20857097222222223,0.22507333333333335,73655,3600,76252,completed
519,65748,1777,1,2-6,1,0.14760009722222223,0.15400666666666668,73668,7920,75445,completed
520,65752,2528,1,2-6,1,0.20288233333333333,0.21909333333333333,73672,7920,76200,completed
522,65754,2078,1,2-6,1,0.16965494444444446,0.18009333333333333,73674,7920,75752,completed
486,59996,3954,1,6-12,1,0.30400574999999996,0.34268,73676,13680,77630,completed
553,70088,2538,1,2-6,1,0.20305002777777778,0.21996000000000002,73688,3600,76226,completed
523,65776,3221,1,6-12,1,0.252409375,0.27915333333333336,73696,7920,76917,completed
506,62191,13742,1,24-48,1,2.163548125,1.1909733333333334,73711,11520,87453,completed
487,60129,7973,1,12-24,1,0.9339630555555556,0.6909933333333333,73809,13680,81782,completed
538,68776,1500,1,2-6,1,0.12185105555555556,0.13,73816,5040,75316,completed
575,73838,2024,1,2-6,1,0.15984280555555558,0.17541333333333334,73838,0,75862,completed
550,69536,176,2,0-2,2,0.038456,0.030506666666666668,73856,4320,74032,completed
510,63097,16896,1,24-48,1,3.037777777777778,1.46432,73897,10800,90793,completed
578,73925,1940,1,2-6,1,0.15055909722222222,0.16813333333333333,73925,0,75865,completed
529,67484,2584,1,2-6,1,0.19636250000000002,0.22394666666666668,73964,6480,76548,completed
539,68928,1528,2,2-6,2,0.23722511111111114,0.26485333333333333,73968,5040,75496,completed
484,59569,5556,3,6-12,3-4,1.277243375,1.44456,73969,14400,79525,completed
579,73971,1976,1,2-6,1,0.15157540277777776,0.17125333333333334,73971,0,75947,completed
580,73972,2848,1,2-6,1,0.21521983333333336,0.24682666666666667,73972,0,76820,completed
581,73974,2462,1,2-6,1,0.18714533333333333,0.21337333333333333,73974,0,76436,completed
490,61016,1572,1,2-6,1,0.1216002777777778,0.13624,73976,12960,75548,completed
530,67621,2588,1,2-6,1,0.19162362500000002,0.22429333333333334,74101,6480,76689,completed
535,68351,3347,3,6-12,3-4,0.7340355000000001,0.87022,74111,5760,77458,completed
468,56835,3157,1,6-12,1,0.23147725000000002,0.27360666666666666,74115,17280,77272,completed
540,69143,12853,1,24-48,1,2.052748902777778,1.1139266666666667,74183,5040,87036,completed
469,56909,4358,1,6-12,1,0.3103275,0.3776933333333333,74189,17280,78547,completed
544,69150,1519,1,2-6,1,0.11122909722222224,0.13164666666666666,74190,5040,75709,completed
546,69150,1509,1,2-6,1,0.11049229166666667,0.13078,74190,5040,75699,completed
541,69150,1521,1,2-6,1,0.11137645833333334,0.13182,74190,5040,75711,completed
558,72030,1966,1,2-6,1,0.14416430555555557,0.17038666666666666,74190,2160,76156,completed
547,69152,1773,1,2-6,1,0.12994718055555557,0.15366,74192,5040,75965,completed
485,59825,3847,1,6-12,1,0.27564548611111106,0.3334066666666667,74225,14400,78072,completed
505,62004,2531,1,2-6,1,0.185362625,0.21935333333333334,74244,12240,76775,completed
516,65662,4909,1,6-12,1,0.35773909722222225,0.4254466666666667,74302,8640,79211,completed
557,71499,217,3,0-2,3-4,0.046917208333333335,0.05642,74379,2880,74596,completed
555,70789,333,2,0-2,2,0.04799825,0.05772,74389,3600,74722,completed
554,70122,686,2,0-2,2,0.09996772222222222,0.11890666666666667,74442,4320,75128,completed
556,70912,435,1,0-2,1,0.03149723611111112,0.0377,74512,3600,74947,completed
559,72338,105,1,0-2,1,0.007616875000000002,0.0091,76658,4320,76763,completed
560,72783,120,1,0-2,1,0.008235,0.0104,77103,4320,77223,completed
561,72897,671,1,0-2,1,0.04558337499999999,0.058153333333333335,77217,4320,77888,completed
562,72955,1274,1,0-2,1,0.08581683333333331,0.11041333333333334,77275,4320,78549,completed
573,73794,1014,1,0-2,1,0.06723674999999998,0.08788,77394,3600,78408,completed
574,73816,1368,1,0-2,1,0.09566855555555555,0.11856,77416,3600,78784,completed
563,73115,148,1,0-2,1,0.010156499999999999,0.012826666666666667,77435,4320,77583,completed
576,73878,649,1,0-2,1,0.04320724999999999,0.05624666666666667,77478,3600,78127,completed
594,76796,258,1,0-2,1,0.017654499999999997,0.02236,77516,720,77774,completed
577,73925,1200,1,0-2,1,0.08328569444444445,0.104,77525,3600,78725,completed
588,75379,198,1,0-2,1,0.01358775,0.01716,77539,2160,77737,completed
587,75379,692,1,0-2,1,0.04578112499999999,0.05997333333333334,77539,2160,78231,completed
582,74054,1374,1,0-2,1,0.09961152777777778,0.11908,77654,3600,79028,completed
564,73391,579,1,0-2,1,0.03781262499999999,0.05018,77711,4320,78290,completed
597,77736,118,1,0-2,1,0.007756999999999997,0.010226666666666667,77736,0,77854,completed
565,73422,1438,1,0-2,1,0.10620330555555556,0.12462666666666666,77742,4320,79180,completed
585,74877,1153,1,0-2,1,0.08273768055555555,0.09992666666666666,77757,2880,78910,completed
586,74878,946,1,0-2,1,0.06555102777777777,0.08198666666666667,77758,2880,78704,completed
583,74174,62,1,0-2,1,0.00403,0.005373333333333333,77774,3600,77836,completed
598,77778,129,1,0-2,1,0.008385,0.01118,77778,0,77907,completed
584,74275,62,1,0-2,1,0.00403,0.005373333333333333,77875,3600,77937,completed
566,73571,682,1,0-2,1,0.04601304166666666,0.05910666666666667,77891,4320,78573,completed
567,73593,472,1,0-2,1,0.03067999999999999,0.04090666666666667,77913,4320,78385,completed
569,73662,864,1,0-2,1,0.06278358333333334,0.07488,77982,4320,78846,completed
589,75854,692,1,0-2,1,0.049069972222222216,0.05997333333333334,78014,2160,78706,completed
596,77317,392,1,0-2,1,0.025479999999999992,0.033973333333333335,78037,720,78429,completed
599,78040,64,1,0-2,1,0.00416,0.005546666666666667,78040,0,78104,completed
600,78044,62,1,0-2,1,0.00403,0.005373333333333333,78044,0,78106,completed
570,73759,791,1,0-2,1,0.058472916666666666,0.06855333333333334,78079,4320,78870,completed
571,73764,1282,1,0-2,1,0.10508191666666668,0.11110666666666667,78084,4320,79366,completed
572,73770,943,1,0-2,1,0.0713027638888889,0.08172666666666667,78090,4320,79033,completed
603,78423,149,1,0-2,1,0.011349944444444447,0.012913333333333334,78423,0,78572,completed
604,78425,136,1,0-2,1,0.010305875000000003,0.011786666666666668,78425,0,78561,completed
605,78430,162,1,0-2,1,0.012556888888888892,0.01404,78430,0,78592,completed
606,78800,511,1,0-2,1,0.046286013888888894,0.04428666666666667,78800,0,79311,completed
607,78848,1058,1,0-2,1,0.11223463888888888,0.09169333333333334,78848,0,79906,completed
608,79013,1119,1,0-2,1,0.1402283472222222,0.09698,79013,0,80132,completed
609,79046,83,1,0-2,1,0.006897069444444446,0.007193333333333334,79046,0,79129,completed
610,79049,1342,1,0-2,1,0.18617705555555553,0.11630666666666667,79049,0,80391,completed
611,79067,1104,1,0-2,1,0.1431104722222222,0.09568,79067,0,80171,completed
612,79103,1369,1,0-2,1,0.19699543055555552,0.11864666666666666,79103,0,80472,completed
613,79134,409,1,0-2,1,0.04580120833333332,0.03544666666666667,79134,0,79543,completed
614,79134,320,1,0-2,1,0.035339999999999996,0.027733333333333332,79134,0,79454,completed
615,79145,1191,1,0-2,1,0.16780701388888886,0.10322,79145,0,80336,completed
616,79182,1062,1,0-2,1,0.14734824999999996,0.09204,79182,0,80244,completed
618,79555,853,1,0-2,1,0.135114375,0.07392666666666667,79555,0,80408,completed
619,80266,119,1,0-2,1,0.022486041666666665,0.010313333333333334,80266,0,80385,completed
620,80684,567,1,0-2,1,0.09908325,0.04914,85004,4320,85571,completed
621,80690,892,1,0-2,1,0.1533455833333333,0.07730666666666666,85010,4320,85902,completed
622,81007,483,1,0-2,1,0.08292188888888888,0.04186,85327,4320,85810,completed
624,81107,370,1,0-2,1,0.063323375,0.03206666666666667,85427,4320,85797,completed
626,81326,351,1,0-2,1,0.057722569444444455,0.03042,85646,4320,85997,completed
627,81444,71,3,0-2,3-4,0.034792958333333346,0.01846,85764,4320,85835,completed
628,81518,407,1,0-2,1,0.06648231944444444,0.03527333333333334,85838,4320,86245,completed
630,81838,183,1,0-2,1,0.029892541666666675,0.01586,86158,4320,86341,completed
631,81861,478,1,0-2,1,0.07463383333333334,0.04142666666666667,86181,4320,86659,completed
632,81988,229,1,0-2,1,0.03558365277777778,0.01984666666666667,86308,4320,86537,completed
633,82056,98,1,0-2,1,0.015023416666666664,0.008493333333333334,86376,4320,86474,completed
635,82448,133,1,0-2,1,0.019955541666666667,0.011526666666666668,86768,4320,86901,completed
653,85354,666,4,0-2,3-4,0.3895865555555555,0.23088,86794,1440,87460,completed
662,86074,138,1,0-2,1,0.020705750000000002,0.01196,86794,720,86932,completed
667,86819,325,2,0-2,2,0.09716975,0.05633333333333333,86819,0,87144,completed
654,85396,61,1,0-2,1,0.009152541666666666,0.005286666666666667,86836,1440,86897,completed
668,86844,231,1,0-2,1,0.034659625,0.02002,86844,0,87075,completed
655,85418,63,1,0-2,1,0.009452625,0.0054600000000000004,86858,1440,86921,completed
642,83979,199,1,0-2,1,0.02985829166666666,0.017246666666666667,86859,2880,87058,completed
646,84699,504,1,0-2,1,0.07381199999999999,0.043680000000000004,86859,2160,87363,completed
647,84705,228,2,0-2,2,0.068419,0.03952,86865,2160,87093,completed
648,84709,261,1,0-2,1,0.039086430555555565,0.02262,86869,2160,87130,completed
643,83998,80,2,0-2,2,0.024006666666666666,0.013866666666666666,86878,2880,86958,completed
649,84751,105,2,0-2,2,0.031508749999999995,0.0182,86911,2160,87016,completed
656,85495,493,1,0-2,1,0.07167765277777777,0.04272666666666667,86935,1440,87428,completed
637,82658,1329,4,0-2,3-4,0.8056284444444444,0.46072,86978,4320,88307,completed
658,85564,643,1,0-2,1,0.09255356944444443,0.05572666666666667,87004,1440,87647,completed
663,86296,125,1,0-2,1,0.018598874999999994,0.010833333333333334,87016,720,87141,completed
650,84908,76,2,0-2,2,0.022449000000000004,0.013173333333333334,87068,2160,87144,completed
669,87124,450,1,0-2,1,0.06416874999999998,0.039,87124,0,87574,completed
640,82817,197,2,0-2,2,0.05618330555555555,0.034146666666666665,87137,4320,87334,completed
672,87228,403,1,0-2,1,0.05746668055555554,0.03492666666666667,87228,0,87631,completed
664,86522,385,1,0-2,1,0.054899930555555546,0.03336666666666667,87242,720,87627,completed
641,83717,60,1,0-2,1,0.008555833333333335,0.0052,87317,3600,87377,completed
665,86604,172,1,0-2,1,0.02452672222222222,0.014906666666666667,87324,720,87496,completed
651,85178,977,4,0-2,3-4,0.6013657777777779,0.33869333333333335,87338,2160,88315,completed
644,84474,461,3,0-2,3-4,0.19721195833333324,0.11986000000000001,87354,2880,87815,completed
674,87361,700,2,0-2,2,0.2098941944444444,0.12133333333333333,87361,0,88061,completed
645,84511,517,3,0-2,3-4,0.22590279166666669,0.13442,87391,2880,87908,completed
666,86701,93,1,0-2,1,0.013261541666666666,0.00806,87421,720,87514,completed
652,85293,270,1,0-2,1,0.03850125,0.0234,87453,2160,87723,completed
675,87453,214,1,0-2,1,0.03051580555555555,0.018546666666666666,87453,0,87667,completed
678,87484,1142,1,0-2,1,0.18641911111111112,0.09897333333333333,87484,0,88626,completed
660,86045,904,1,0-2,1,0.1416492638888889,0.07834666666666666,87485,1440,88389,completed
679,87592,385,1,0-2,1,0.05807947222222222,0.03336666666666667,87592,0,87977,completed
639,82755,2160,3,2-6,3-4,0.9634349999999998,0.5616,91395,8640,93555,completed
595,77026,3433,1,6-12,1,0.4548869861111111,0.29752666666666666,91426,14400,94859,completed
659,85675,1516,1,2-6,1,0.23174844444444442,0.13138666666666668,91435,5760,92951,completed
670,87136,2757,1,2-6,1,0.38155595833333333,0.23894,91456,4320,94213,completed
634,82122,10925,1,12-24,1,2.9798770416666667,0.9468333333333333,91482,9360,102407,completed
617,79247,1523,1,2-6,1,0.23141702777777776,0.13199333333333332,91487,12240,93010,completed
671,87193,17516,1,24-48,1,5.618790333333334,1.5180533333333333,91513,4320,109029,completed
702,90818,1543,1,2-6,1,0.2330880833333333,0.13372666666666666,91538,720,93081,completed
673,87262,12102,1,24-48,1,3.566652888888889,1.04884,91582,4320,103684,completed
629,81691,5309,1,6-12,1,0.6477044166666666,0.4601133333333333,91771,10080,97080,completed
676,87483,2160,1,2-6,1,0.300993125,0.1872,91803,4320,93963,completed
677,87484,2027,1,2-6,1,0.28665387500000006,0.17567333333333335,91804,4320,93831,completed
661,86070,2649,1,2-6,1,0.35185704166666665,0.22958,91830,5760,94479,completed
623,81056,2643,4,2-6,3-4,1.399726388888889,0.91624,91856,10800,94499,completed
590,76739,3412,1,6-12,1,0.43080841666666664,0.2957066666666667,91859,15120,95271,completed
690,88984,17236,1,24-48,1,5.581029888888889,1.4937866666666666,91864,2880,109100,completed
591,76755,1813,1,2-6,1,0.2603000833333333,0.15712666666666666,91875,15120,93688,completed
592,76756,3651,1,6-12,1,0.45542744444444444,0.31642,91876,15120,95527,completed
593,76767,6078,1,12-24,1,0.8492686250000001,0.52676,91887,15120,97965,completed
698,89770,1655,1,2-6,1,0.24031208333333334,0.14343333333333333,91930,2160,93585,completed
636,82581,4259,1,6-12,1,0.5115791388888888,0.36911333333333335,91941,9360,96200,completed
625,81161,4649,1,6-12,1,0.5529196944444444,0.40291333333333335,91961,10800,96610,completed
680,87691,146,1,0-2,1,0.022593499999999996,0.012653333333333334,92011,4320,92157,completed
602,78351,4930,1,6-12,1,0.5909151944444444,0.4272666666666667,92031,13680,96961,completed
601,78351,3535,1,6-12,1,0.4355925277777778,0.3063666666666667,92031,13680,95566,completed
657,85563,9852,1,12-24,1,2.6272155416666667,0.85384,92043,6480,101895,completed
638,82710,2590,3,2-6,3-4,1.0011133333333335,0.6734,92070,9360,94660,completed
681,88122,359,1,0-2,1,0.05472755555555556,0.031113333333333333,92442,4320,92801,completed
682,88187,82,1,0-2,1,0.012500444444444444,0.0071066666666666665,92507,4320,92589,completed
683,88513,81,1,0-2,1,0.011744500000000001,0.00702,92833,4320,92914,completed
684,88524,621,1,0-2,1,0.08428425,0.05382,92844,4320,93465,completed
685,88528,107,1,0-2,1,0.014980305555555556,0.009273333333333333,92848,4320,92955,completed
686,88622,120,1,0-2,1,0.016163333333333335,0.0104,92942,4320,93062,completed
688,88704,345,1,0-2,1,0.04646958333333334,0.0299,93024,4320,93369,completed
687,88704,343,1,0-2,1,0.04620019444444445,0.02972666666666667,93024,4320,93367,completed
689,88794,245,1,0-2,1,0.03300013888888889,0.021233333333333333,93114,4320,93359,completed
691,89062,373,1,0-2,1,0.04601943055555556,0.03232666666666667,93382,4320,93755,completed
692,89169,167,3,0-2,3-4,0.06290625,0.04342,93489,4320,93656,completed
693,89170,169,3,0-2,3-4,0.06346929166666668,0.04394,93490,4320,93659,completed
694,89211,959,1,0-2,1,0.10449738888888889,0.08311333333333333,93531,4320,94490,completed
695,89564,240,2,0-2,2,0.05158,0.0416,93884,4320,94124,completed
696,89577,68,1,0-2,1,0.0073071666666666675,0.005893333333333334,93897,4320,93965,completed
697,89631,722,1,0-2,1,0.07668280555555557,0.06257333333333333,93951,4320,94673,completed
699,90614,442,1,0-2,1,0.04663791666666667,0.03830666666666667,94214,3600,94656,completed
700,90619,460,1,0-2,1,0.04851338888888889,0.03986666666666667,94219,3600,94679,completed
701,90662,67,1,0-2,1,0.007176708333333333,0.005806666666666667,94262,3600,94329,completed
703,90856,590,1,0-2,1,0.06190188888888888,0.051133333333333336,94456,3600,95046,completed
704,90966,542,1,0-2,1,0.05696213888888889,0.04697333333333333,94566,3600,95108,completed
705,91015,475,1,0-2,1,0.049905902777777775,0.041166666666666664,94615,3600,95090,completed
706,91063,1270,1,0-2,1,0.13195577777777778,0.11006666666666667,95383,4320,96653,completed
742,94690,1322,1,0-2,1,0.14007155555555556,0.11457333333333333,95410,720,96732,completed
751,95429,223,1,0-2,1,0.023737111111111105,0.019326666666666666,95429,0,95652,completed
743,94742,67,1,0-2,1,0.007131777777777779,0.005806666666666667,95462,720,95529,completed
736,94023,88,1,0-2,1,0.009367111111111113,0.007626666666666667,95463,1440,95551,completed
707,91145,833,1,0-2,1,0.0820328888888889,0.07219333333333333,95465,4320,96298,completed
752,95476,473,1,0-2,1,0.04801722222222223,0.04099333333333333,95476,0,95949,completed
710,91877,70,1,0-2,1,0.007451111111111113,0.006066666666666666,95477,3600,95547,completed
753,95513,936,3,0-2,3-4,0.27340300000000006,0.24336,95513,0,96449,completed
708,91221,711,1,0-2,1,0.069614,0.06162,95541,4320,96252,completed
709,91223,668,1,0-2,1,0.06554255555555556,0.05789333333333333,95543,4320,96211,completed
747,94835,1126,1,0-2,1,0.11754244444444445,0.09758666666666667,95555,720,96681,completed
748,94838,1175,1,0-2,1,0.1244568888888889,0.10183333333333333,95558,720,96733,completed
749,94871,518,1,0-2,1,0.050833888888888894,0.044893333333333334,95591,720,96109,completed
711,91995,87,1,0-2,1,0.009260666666666664,0.00754,95595,3600,95682,completed
755,95692,533,1,0-2,1,0.0509998888888889,0.046193333333333336,95692,0,96225,completed
737,94276,626,1,0-2,1,0.059456222222222216,0.054253333333333334,95716,1440,96342,completed
712,92117,1258,1,0-2,1,0.1411971111111111,0.10902666666666667,95717,3600,96975,completed
713,92120,627,1,0-2,1,0.059501,0.05434,95720,3600,96347,completed
715,92125,884,1,0-2,1,0.0894308888888889,0.07661333333333334,95725,3600,96609,completed
714,92125,1196,1,0-2,1,0.13283355555555554,0.10365333333333333,95725,3600,96921,completed
738,94296,93,1,0-2,1,0.009048333333333332,0.00806,95736,1440,95829,completed
756,95736,242,1,0-2,1,0.023070888888888894,0.020973333333333333,95736,0,95978,completed
716,92137,1332,1,0-2,1,0.15214466666666665,0.11544,95737,3600,97069,completed
717,92143,450,1,0-2,1,0.042559666666666676,0.039,95743,3600,96193,completed
723,92867,188,1,0-2,1,0.01785322222222222,0.016293333333333333,95747,2880,95935,completed
724,92881,481,1,0-2,1,0.04526744444444446,0.04168666666666667,95761,2880,96242,completed
730,93606,79,1,0-2,1,0.007434777777777775,0.006846666666666667,95766,2160,95845,completed
757,95816,181,1,0-2,1,0.017034111111111108,0.015686666666666668,95816,0,95997,completed
732,93778,879,1,0-2,1,0.09788866666666668,0.07618,95938,2160,96817,completed
727,93062,119,1,0-2,1,0.011199222222222222,0.010313333333333334,95942,2880,96061,completed
718,92355,459,1,0-2,1,0.043197000000000006,0.03978,95955,3600,96414,completed
734,93825,1369,1,0-2,1,0.18653047222222224,0.11864666666666666,95985,2160,97354,completed
719,92426,63,1,0-2,1,0.005928999999999998,0.0054600000000000004,96026,3600,96089,completed
758,96075,608,1,0-2,1,0.06635455555555556,0.052693333333333335,96075,0,96683,completed
728,93210,987,1,0-2,1,0.11975266666666667,0.08554,96090,2880,97077,completed
720,92515,1432,1,0-2,1,0.22415704166666667,0.12410666666666667,96115,3600,97547,completed
759,96145,118,1,0-2,1,0.01110511111111111,0.010226666666666667,96145,0,96263,completed
760,96189,64,1,0-2,1,0.006023111111111111,0.005546666666666667,96189,0,96253,completed
761,96223,545,1,0-2,1,0.06425055555555556,0.047233333333333336,96223,0,96768,completed
763,96346,73,1,0-2,1,0.006870111111111111,0.006326666666666667,96346,0,96419,completed
764,96546,64,1,0-2,1,0.008903111111111112,0.005546666666666667,96546,0,96610,completed
765,96596,1230,1,0-2,1,0.24574847222222226,0.1066,96596,0,97826,completed
766,96612,1123,1,0-2,1,0.22001309722222226,0.09732666666666667,96612,0,97735,completed
767,96624,696,1,0-2,1,0.11112966666666668,0.06032,96624,0,97320,completed
768,96632,1284,1,0-2,1,0.2639917222222223,0.11128,96632,0,97916,completed
769,96649,443,1,0-2,1,0.06162622222222222,0.038393333333333335,96649,0,97092,completed
770,96649,436,1,0-2,1,0.060652444444444446,0.03778666666666667,96649,0,97085,completed
771,96779,97,1,0-2,1,0.013493777777777778,0.008406666666666666,96779,0,96876,completed
772,96901,164,1,0-2,1,0.022814222222222222,0.014213333333333333,96901,0,97065,completed
774,97046,1052,1,0-2,1,0.2739334166666667,0.09117333333333333,97046,0,98098,completed
775,97271,313,2,0-2,2,0.16172536111111113,0.054253333333333334,97271,0,97584,completed
776,97317,1032,1,0-2,1,0.31605658333333336,0.08944,97317,0,98349,completed
779,97345,740,1,0-2,1,0.21019319444444445,0.06413333333333333,97345,0,98085,completed
777,97345,937,1,0-2,1,0.2837918472222223,0.08120666666666666,97345,0,98282,completed
778,97345,499,1,0-2,1,0.1289152638888889,0.04324666666666667,97345,0,97844,completed
780,97369,986,1,0-2,1,0.3048641111111111,0.08545333333333334,97369,0,98355,completed
781,97407,963,1,0-2,1,0.30065087500000004,0.08346,97407,0,98370,completed
782,97443,476,1,0-2,1,0.1229732777777778,0.041253333333333336,97443,0,97919,completed
783,97512,748,1,0-2,1,0.23242872222222227,0.06482666666666667,97512,0,98260,completed
784,97626,444,1,0-2,1,0.13199366666666668,0.03848,97626,0,98070,completed
785,97627,274,1,0-2,1,0.0707871388888889,0.023746666666666666,97627,0,97901,completed
786,97812,817,1,0-2,1,0.29278193055555557,0.07080666666666667,97812,0,98629,completed
787,97992,735,1,0-2,1,0.28217262499999995,0.0637,97992,0,98727,completed
788,98475,304,1,0-2,1,0.125682,0.026346666666666668,98475,0,98779,completed
789,98476,265,1,0-2,1,0.10780148611111111,0.022966666666666666,98476,0,98741,completed
790,98581,114,1,0-2,1,0.04738119444444443,0.00988,98581,0,98695,completed
791,98597,306,1,0-2,1,0.13723097222222222,0.026520000000000002,98597,0,98903,completed
792,98762,1178,1,0-2,1,0.5179386666666668,0.10209333333333334,103082,4320,104260,completed
793,98763,73,1,0-2,1,0.032827694444444444,0.006326666666666667,103083,4320,103156,completed
794,99005,64,1,0-2,1,0.028780444444444442,0.005546666666666667,103325,4320,103389,completed
795,99024,265,1,0-2,1,0.11916902777777777,0.022966666666666666,103344,4320,103609,completed
796,99205,105,1,0-2,1,0.047217916666666665,0.0091,103525,4320,103630,completed
797,99205,74,1,0-2,1,0.03327738888888889,0.006413333333333333,103525,4320,103599,completed
798,99269,143,1,0-2,1,0.06324825,0.012393333333333334,103589,4320,103732,completed
799,99269,374,1,0-2,1,0.16242745833333339,0.032413333333333336,103589,4320,103963,completed
800,99535,275,4,0-2,3-4,0.4722819444444446,0.09533333333333334,103855,4320,104130,completed
801,99612,132,1,0-2,1,0.056673833333333354,0.01144,103932,4320,104064,completed
803,99779,1078,1,0-2,1,0.40476393055555565,0.09342666666666667,104099,4320,105177,completed
807,99886,288,1,0-2,1,0.11666597222222225,0.02496,104206,4320,104494,completed
806,99886,288,1,0-2,1,0.11666597222222225,0.02496,104206,4320,104494,completed
808,100315,167,1,0-2,1,0.0592896388888889,0.014473333333333333,104635,4320,104802,completed
819,102027,150,3,0-2,3-4,0.15976250000000003,0.039,104907,2880,105057,completed
815,101325,74,1,0-2,1,0.02627205555555556,0.006413333333333333,104925,3600,104999,completed
824,102800,250,1,0-2,1,0.08824194444444444,0.021666666666666667,104960,2160,105210,completed
811,100695,77,1,0-2,1,0.02733713888888889,0.006673333333333333,105015,4320,105092,completed
825,102857,87,1,0-2,1,0.030887416666666667,0.00754,105017,2160,105104,completed
826,102886,518,1,0-2,1,0.18136372222222222,0.044893333333333334,105046,2160,105564,completed
828,102945,401,1,0-2,1,0.1401573611111111,0.03475333333333333,105105,2160,105506,completed
812,100875,84,1,0-2,1,0.029341666666666655,0.00728,105195,4320,105279,completed
817,101670,581,3,0-2,3-4,0.6121084166666665,0.15106,105270,3600,105851,completed
813,100964,63,1,0-2,1,0.022006249999999988,0.0054600000000000004,105284,4320,105347,completed
820,102501,72,1,0-2,1,0.025149999999999995,0.00624,105381,2880,105453,completed
821,102511,200,1,0-2,1,0.0698611111111111,0.017333333333333333,105391,2880,105591,completed
833,103403,593,1,0-2,1,0.19965529166666668,0.05139333333333333,107723,4320,108316,completed
834,103502,682,1,0-2,1,0.22071158333333332,0.05910666666666667,107822,4320,108504,completed
835,103631,411,2,0-2,2,0.25863325,0.07124,107951,4320,108362,completed
836,103685,642,1,0-2,1,0.19714749999999998,0.05564,108005,4320,108647,completed
837,103788,230,2,0-2,2,0.14125833333333332,0.03986666666666667,108108,4320,108338,completed
838,103830,123,1,0-2,1,0.03777125,0.01066,108150,4320,108273,completed
839,103934,922,1,0-2,1,0.24943749999999998,0.07990666666666667,108254,4320,109176,completed
840,103982,312,3,0-2,3-4,0.28742999999999996,0.08112,108302,4320,108614,completed
841,104065,99,1,0-2,1,0.030401249999999994,0.00858,108385,4320,108484,completed
842,104071,1378,2,0-2,2,0.6408743888888888,0.23885333333333333,108391,4320,109769,completed
847,104723,698,1,0-2,1,0.1397014166666667,0.060493333333333336,109043,4320,109741,completed
850,104872,77,1,0-2,1,0.017955972222222227,0.006673333333333333,109192,4320,109269,completed
851,105263,402,1,0-2,1,0.06293533333333334,0.03484,109583,4320,109985,completed
852,105263,402,1,0-2,1,0.06293533333333334,0.03484,109583,4320,109985,completed
853,105454,65,1,0-2,1,0.010176111111111113,0.005633333333333333,109774,4320,109839,completed
854,105528,602,2,0-2,2,0.16542983333333333,0.10434666666666667,109848,4320,110450,completed
855,105541,797,2,0-2,2,0.20994472222222224,0.13814666666666667,109861,4320,110658,completed
773,96962,7784,1,12-24,1,0.9150112222222222,0.6746133333333334,109922,12960,117706,completed
721,92665,5915,1,12-24,1,0.6125244444444444,0.5126333333333334,109945,17280,115860,completed
746,94826,1834,1,2-6,1,0.2026303888888889,0.15894666666666668,109946,15120,111780,completed
856,105673,104,1,0-2,1,0.01628177777777778,0.009013333333333333,109993,4320,110097,completed
762,96333,1542,1,2-6,1,0.1711817916666667,0.13364,110013,13680,111555,completed
754,95684,3830,1,6-12,1,0.3750656666666667,0.33193333333333336,110084,14400,113914,completed
722,92822,1767,1,2-6,1,0.18645876388888888,0.15314,110102,17280,111869,completed
739,94301,2072,1,2-6,1,0.21224476388888888,0.17957333333333333,110141,15840,112213,completed
740,94320,1986,1,2-6,1,0.20305875,0.17212,110160,15840,112146,completed
857,105850,85,1,0-2,1,0.009927291666666664,0.007366666666666667,110170,4320,110255,completed
750,95088,2842,1,2-6,1,0.27845358333333337,0.24630666666666667,110208,15120,113050,completed
725,92944,5964,1,12-24,1,0.6251065555555556,0.51688,110224,17280,116188,completed
731,93699,2446,1,2-6,1,0.24183380555555556,0.21198666666666666,110259,16560,112705,completed
726,92990,3894,3,6-12,3-4,1.1251694166666666,1.01244,110270,17280,114164,completed
858,105999,398,1,0-2,1,0.04648308333333334,0.034493333333333334,110319,4320,110717,completed
741,94527,2914,1,6-12,1,0.28066408333333337,0.2525466666666667,110367,15840,113281,completed
733,93815,1628,1,2-6,1,0.16469125,0.14109333333333335,110375,16560,112003,completed
859,106059,278,1,0-2,1,0.03246808333333333,0.024093333333333335,110379,4320,110657,completed
735,93850,1584,1,2-6,1,0.15976916666666668,0.13728,110410,16560,111994,completed
860,106185,90,1,0-2,1,0.01051125,0.0078000000000000005,110505,4320,110595,completed
861,106198,117,1,0-2,1,0.013664625,0.01014,110518,4320,110635,completed
729,93257,9715,1,12-24,1,1.1165162083333333,0.8419666666666666,110537,17280,120252,completed
863,106299,1215,1,0-2,1,0.12052637499999999,0.1053,110619,4320,111834,completed
744,94782,2393,1,2-6,1,0.22698106944444443,0.20739333333333335,110622,15840,113015,completed
745,94791,1603,1,2-6,1,0.15620820833333332,0.13892666666666667,110631,15840,112234,completed
864,106369,997,1,0-2,1,0.09863012500000001,0.08640666666666667,110689,4320,111686,completed
865,106375,541,1,0-2,1,0.05540173611111111,0.04688666666666667,110695,4320,111236,completed
866,106481,1161,1,0-2,1,0.11113695833333334,0.10062,110801,4320,111962,completed
867,106504,94,1,0-2,1,0.010147694444444438,0.008146666666666667,110824,4320,110918,completed
868,106720,77,1,0-2,1,0.007309652777777778,0.006673333333333333,111040,4320,111117,completed
869,106809,1064,1,0-2,1,0.09968833333333332,0.09221333333333334,111129,4320,112193,completed
870,106964,102,1,0-2,1,0.00968291666666666,0.00884,111284,4320,111386,completed
871,107138,64,1,0-2,1,0.006075555555555555,0.005546666666666667,111458,4320,111522,completed
872,107321,479,1,0-2,1,0.04440729166666667,0.04151333333333333,111641,4320,112120,completed
873,107500,119,1,0-2,1,0.011032291666666668,0.010313333333333334,111820,4320,111939,completed
875,107627,201,1,0-2,1,0.018634375,0.01742,111947,4320,112148,completed
876,107651,708,1,0-2,1,0.06425136111111111,0.06136,111971,4320,112679,completed
891,108648,456,1,0-2,1,0.040792333333333326,0.03952,112248,3600,112704,completed
877,107933,703,1,0-2,1,0.06271829166666668,0.06092666666666667,112253,4320,112956,completed
919,110105,100,1,0-2,1,0.009097083333333335,0.008666666666666666,112265,2160,112365,completed
878,107947,450,1,0-2,1,0.04018588888888888,0.039,112267,4320,112717,completed
879,107963,784,1,0-2,1,0.06982908333333332,0.06794666666666667,112283,4320,113067,completed
892,108706,1418,1,0-2,1,0.12679941666666666,0.12289333333333334,112306,3600,113724,completed
906,109456,468,1,0-2,1,0.04158049999999999,0.04056,112336,2880,112804,completed
920,110182,83,1,0-2,1,0.007374319444444445,0.007193333333333334,112342,2160,112425,completed
928,112349,550,1,0-2,1,0.04886597222222223,0.04766666666666667,112349,0,112899,completed
907,109519,74,1,0-2,1,0.006574694444444445,0.006413333333333333,112399,2880,112473,completed
880,108094,369,1,0-2,1,0.032784625000000005,0.03198,112414,4320,112783,completed
893,108817,136,1,0-2,1,0.012083222222222224,0.011786666666666668,112417,3600,112553,completed
881,108133,1275,2,0-2,2,0.2280893055555556,0.221,112453,4320,113728,completed
882,108157,75,1,0-2,1,0.006663541666666667,0.0065,112477,4320,112552,completed
883,108172,290,1,0-2,1,0.025765694444444445,0.025133333333333334,112492,4320,112782,completed
921,110362,183,1,0-2,1,0.01625904166666667,0.01586,112522,2160,112705,completed
894,108931,427,1,0-2,1,0.03793776388888889,0.03700666666666667,112531,3600,112958,completed
909,109651,78,1,0-2,1,0.006930083333333332,0.00676,112531,2880,112609,completed
884,108215,95,1,0-2,1,0.008440486111111116,0.008233333333333334,112535,4320,112630,completed
911,109655,86,1,0-2,1,0.00764086111111111,0.0074533333333333335,112535,2880,112621,completed
910,109655,66,1,0-2,1,0.005863916666666667,0.00572,112535,2880,112601,completed
885,108216,204,1,0-2,1,0.018124833333333333,0.01768,112536,4320,112740,completed
886,108220,264,1,0-2,1,0.023455666666666666,0.02288,112540,4320,112804,completed
895,108946,299,1,0-2,1,0.026565319444444447,0.025913333333333333,112546,3600,112845,completed
896,108951,562,1,0-2,1,0.05001325000000001,0.04870666666666667,112551,3600,113113,completed
899,108952,814,1,0-2,1,0.07268386111111111,0.07054666666666667,112552,3600,113366,completed
898,108952,499,1,0-2,1,0.044346986111111104,0.04324666666666667,112552,3600,113051,completed
897,108952,962,1,0-2,1,0.08599769444444444,0.08337333333333334,112552,3600,113514,completed
887,108250,1234,2,0-2,2,0.2217635,0.21389333333333332,112570,4320,113804,completed
900,109011,526,1,0-2,1,0.04684141666666666,0.045586666666666664,112611,3600,113137,completed
901,109016,586,1,0-2,1,0.05224447222222223,0.05078666666666667,112616,3600,113202,completed
929,112639,1270,3,0-2,3-4,0.34542137500000003,0.3302,112639,0,113909,completed
888,108320,75,1,0-2,1,0.006663541666666667,0.0065,112640,4320,112715,completed
913,109785,927,1,0-2,1,0.08297470833333334,0.08034,112665,2880,113592,completed
889,108373,1398,1,0-2,1,0.12835059722222222,0.12116,112693,4320,114091,completed
930,112696,1214,3,0-2,3-4,0.33052533333333334,0.31564000000000003,112696,0,113910,completed
931,112702,1114,3,0-2,3-4,0.30102375000000003,0.28964,112702,0,113816,completed
902,109119,91,1,0-2,1,0.008085097222222224,0.007886666666666667,112719,3600,112810,completed
914,109861,88,1,0-2,1,0.007818555555555556,0.007626666666666667,112741,2880,112829,completed
915,109862,278,1,0-2,1,0.02469952777777778,0.024093333333333335,112742,2880,113020,completed
890,108435,742,1,0-2,1,0.06643241666666666,0.06430666666666666,112755,4320,113497,completed
923,110601,105,1,0-2,1,0.009328958333333333,0.0091,112761,2160,112866,completed
916,109884,87,1,0-2,1,0.007729708333333332,0.00754,112764,2880,112851,completed
933,112811,720,1,0-2,1,0.06451555555555556,0.062400000000000004,112811,0,113531,completed
925,111374,402,1,0-2,1,0.03591213888888889,0.03484,112814,1440,113216,completed
917,109965,505,1,0-2,1,0.04521229166666667,0.04376666666666667,112845,2880,113350,completed
924,110703,72,1,0-2,1,0.006397000000000001,0.00624,112863,2160,112935,completed
935,112900,116,1,0-2,1,0.010306277777777779,0.010053333333333334,112900,0,113016,completed
903,109316,1186,1,0-2,1,0.10962605555555556,0.10278666666666667,112916,3600,114102,completed
904,109316,79,1,0-2,1,0.007018930555555554,0.006846666666666667,112916,3600,112995,completed
936,113017,70,4,0-2,3-4,0.025086111111111115,0.024266666666666666,113017,0,113087,completed
937,113040,148,2,0-2,2,0.026627666666666668,0.025653333333333334,113040,0,113188,completed
938,113060,103,1,0-2,1,0.009265708333333329,0.008926666666666666,113060,0,113163,completed
939,113238,83,1,0-2,1,0.007466541666666667,0.007193333333333334,113238,0,113321,completed
940,113302,958,1,0-2,1,0.09067313888888891,0.08302666666666667,113302,0,114260,completed
941,113340,102,1,0-2,1,0.009175749999999996,0.00884,113340,0,113442,completed
942,113354,165,1,0-2,1,0.014843125000000002,0.0143,113354,0,113519,completed
943,113357,320,1,0-2,1,0.02878666666666667,0.027733333333333332,113357,0,113677,completed
944,113364,850,1,0-2,1,0.08054427777777778,0.07366666666666667,113364,0,114214,completed
945,113465,754,1,0-2,1,0.07195320833333334,0.06534666666666666,113465,0,114219,completed
946,113465,826,1,0-2,1,0.07907720833333334,0.07158666666666667,113465,0,114291,completed
947,113514,81,1,0-2,1,0.007286625000000001,0.00702,113514,0,113595,completed
948,113564,877,1,0-2,1,0.085013,0.07600666666666667,113564,0,114441,completed
949,113700,451,1,0-2,1,0.04408477777777778,0.039086666666666665,113700,0,114151,completed
950,113809,235,1,0-2,1,0.02325194444444445,0.02036666666666667,113809,0,114044,completed
951,114110,479,1,0-2,1,0.04748825,0.04151333333333333,114110,0,114589,completed
952,114424,1265,1,0-2,1,0.1424786388888889,0.10963333333333333,114424,0,115689,completed
954,114786,108,1,0-2,1,0.010778999999999999,0.00936,114786,0,114894,completed
955,114816,210,1,0-2,1,0.02095916666666666,0.0182,114816,0,115026,completed
802,99736,3345,1,6-12,1,0.39352705555555556,0.2899,117016,17280,120361,completed
804,99871,2133,1,2-6,1,0.26458488888888887,0.18486,117151,17280,119284,completed
805,99879,11989,1,24-48,1,0.8508105,1.0390466666666667,117159,17280,129148,completed
809,100423,3848,3,6-12,3-4,1.04699625,1.00048,117703,17280,121551,completed
810,100455,1951,3,2-6,3-4,0.66135325,0.50726,117735,17280,119686,completed
814,101263,2033,1,2-6,1,0.19697405555555558,0.17619333333333334,118543,17280,120576,completed
816,101398,1705,1,2-6,1,0.17276016666666671,0.14776666666666666,118678,17280,120383,completed
818,101850,2230,1,2-6,1,0.17346041666666667,0.19326666666666667,119130,17280,121360,completed
956,115124,605,1,0-2,1,0.0632972638888889,0.05243333333333333,119444,4320,120049,completed
822,102513,7578,2,12-24,2,0.8543679166666667,1.31352,119793,17280,127371,completed
823,102651,1877,1,2-6,1,0.11206926388888891,0.16267333333333334,119931,17280,121808,completed
827,102904,9634,1,12-24,1,0.5358890000000001,0.8349466666666667,120184,17280,129818,completed
990,120214,1767,1,2-6,1,0.09178094444444446,0.15314,120214,0,121981,completed
905,109421,28542,1,24-48,1,1.8600123888888889,2.47364,120221,10800,148763,completed
971,118075,3567,1,6-12,1,0.1860488472222222,0.30914,120235,2160,123802,completed
844,104413,4683,1,6-12,1,0.24416883333333333,0.40586,120253,15840,124936,completed
982,119581,439,1,0-2,1,0.02182805555555556,0.038046666666666666,120301,720,120740,completed
993,120305,98,1,0-2,1,0.004872777777777778,0.008493333333333334,120305,0,120403,completed
926,111690,1963,1,2-6,1,0.10119319444444445,0.17012666666666668,120330,8640,122293,completed
994,120358,97,1,0-2,1,0.004823055555555556,0.008406666666666666,120358,0,120455,completed
908,109597,3814,1,6-12,1,0.1985488472222222,0.33054666666666666,120397,10800,124211,completed
953,114680,4967,1,6-12,1,0.2610680694444445,0.4304733333333333,120440,5760,125407,completed
846,104607,1538,1,2-6,1,0.07899180555555556,0.13329333333333335,120447,15840,121985,completed
845,104607,1694,1,2-6,1,0.0872901388888889,0.14681333333333332,120447,15840,122141,completed
968,116852,77,1,0-2,1,0.003828611111111111,0.006673333333333333,120452,3600,120529,completed
995,120458,63,1,0-2,1,0.0031325000000000003,0.0054600000000000004,120458,0,120521,completed
960,116147,3921,2,6-12,2,0.40816600000000003,0.67964,120467,4320,124388,completed
976,119044,492,1,0-2,1,0.024495777777777783,0.04264,120484,1440,120976,completed
961,116179,107,1,0-2,1,0.005320277777777778,0.009273333333333333,120499,4320,120606,completed
983,119818,1083,1,0-2,1,0.055189527777777775,0.09386,120538,720,121621,completed
912,109740,1933,1,2-6,1,0.10044718055555557,0.16752666666666666,120540,10800,122473,completed
969,116940,82,1,0-2,1,0.004077222222222222,0.0071066666666666665,120540,3600,120622,completed
984,119826,435,1,0-2,1,0.021671750000000004,0.0377,120546,720,120981,completed
874,107593,2632,2,2-6,2,0.27718402777777773,0.45621333333333336,120553,12960,123185,completed
848,104727,3812,1,6-12,1,0.1986524027777778,0.33037333333333335,120567,15840,124379,completed
922,110491,1462,1,2-6,1,0.07537958333333333,0.12670666666666666,120571,10080,122033,completed
977,119133,1301,1,0-2,1,0.06682222222222223,0.11275333333333333,120573,1440,121874,completed
972,118415,524,3,0-2,3-4,0.07900891666666669,0.13624,120575,2160,121099,completed
978,119139,19842,2,24-48,2,2.381594833333333,3.43928,120579,1440,140421,completed
979,119140,19848,2,24-48,2,2.382404222222222,3.4403200000000003,120580,1440,140428,completed
973,118433,4988,1,6-12,1,0.26342448611111113,0.43229333333333336,120593,2160,125581,completed
974,118440,4831,1,6-12,1,0.2544868472222222,0.41868666666666665,120600,2160,125431,completed
980,119164,1395,1,0-2,1,0.07193013888888888,0.12090000000000001,120604,1440,121999,completed
927,111967,3919,2,6-12,2,0.40830061111111116,0.6792933333333333,120607,8640,124526,completed
932,112707,2483,1,2-6,1,0.13105902777777778,0.21519333333333335,120627,7920,123110,completed
862,106229,9481,1,12-24,1,0.5301780555555556,0.8216866666666667,120629,14400,130110,completed
849,104793,9929,1,12-24,1,0.5598604166666667,0.8605133333333334,120633,15840,130562,completed
958,115594,3997,1,6-12,1,0.20844543055555556,0.3464066666666667,120634,5040,124631,completed
957,115594,3865,1,6-12,1,0.20143268055555555,0.3349666666666667,120634,5040,124499,completed
996,120649,227,1,0-2,1,0.011286944444444447,0.019673333333333334,120649,0,120876,completed
829,103379,3038,1,6-12,1,0.1593552361111111,0.2632933333333333,120659,17280,123697,completed
830,103380,4649,1,6-12,1,0.24451731944444444,0.40291333333333335,120660,17280,125309,completed
831,103381,4862,1,6-12,1,0.2567220694444444,0.4213733333333333,120661,17280,125523,completed
832,103381,4792,1,6-12,1,0.2527135972222222,0.41530666666666666,120661,17280,125453,completed
997,120665,67,1,0-2,1,0.003331388888888889,0.005806666666666667,120665,0,120732,completed
998,120678,132,1,0-2,1,0.006563333333333333,0.01144,120678,0,120810,completed
985,119964,7669,1,12-24,1,0.41664333333333337,0.6646466666666667,120684,720,128353,completed
962,116366,422,1,0-2,1,0.021282888888888893,0.03657333333333333,120686,4320,121108,completed
986,119977,90,1,0-2,1,0.004475,0.0078000000000000005,120697,720,120787,completed
963,116384,504,1,0-2,1,0.025562888888888895,0.043680000000000004,120704,4320,121208,completed
964,116389,860,1,0-2,1,0.04399602777777778,0.07453333333333334,120709,4320,121569,completed
965,116391,166,1,0-2,1,0.008253888888888887,0.014386666666666667,120711,4320,120877,completed
966,116396,529,1,0-2,1,0.026880972222222223,0.04584666666666667,120716,4320,121245,completed
934,112813,10423,1,12-24,1,0.5941368888888889,0.9033266666666667,120733,7920,131156,completed
967,116425,3654,1,6-12,1,0.19082045833333333,0.31668,120745,4320,124399,completed
918,109971,6135,3,12-24,3-4,0.9850235,1.5951,120771,10800,126906,completed
959,115742,5054,1,6-12,1,0.2686292777777778,0.43801333333333337,120782,5040,125836,completed
970,117908,197,4,0-2,3-4,0.03938388888888889,0.06829333333333333,120788,2880,120985,completed
843,104279,4580,2,6-12,2,0.4838321388888889,0.7938666666666667,120839,16560,125419,completed
975,118737,60,1,0-2,1,0.003290833333333334,0.0052,123057,4320,123117,completed
999,120951,272,1,0-2,1,0.01386644444444444,0.023573333333333335,123111,2160,123383,completed
987,120082,406,1,0-2,1,0.020664638888888892,0.035186666666666665,123682,3600,124088,completed
988,120092,80,1,0-2,1,0.004067777777777777,0.006933333333333333,123692,3600,123772,completed
981,119416,800,1,0-2,1,0.04073577777777779,0.06933333333333333,123736,4320,124536,completed
989,120141,428,1,0-2,1,0.021790027777777783,0.03709333333333333,123741,3600,124169,completed
991,120215,1337,1,0-2,1,0.07050940277777779,0.11587333333333334,123815,3600,125152,completed
992,120215,1221,1,0-2,1,0.06412779166666668,0.10582,123815,3600,125036,completed
-1,0,0,0,0,0,0.0,0.0,0,0,0,0
