ID,arrival_time,length,cpus,length_class,resource_class,carbon_cost,dollar_cost,start_time,waiting_time,exit_time,reason
0,0,1260,1,0-2,1,0.17048750000000001,0.1092,0,0,1260,completed
1,13,200,1,0-2,1,0.02670555555555556,0.017333333333333333,13,0,213,completed
2,92,314,3,0-2,3-4,0.12578316666666667,0.08164,92,0,406,completed
4,397,133,1,0-2,1,0.017759194444444446,0.011526666666666668,397,0,530,completed
5,523,125,2,0-2,2,0.03338194444444444,0.021666666666666667,523,0,648,completed
6,523,125,2,0-2,2,0.03338194444444444,0.021666666666666667,523,0,648,completed
10,958,350,2,0-2,2,0.06758888888888889,0.06066666666666667,5040,4082,5390,completed
11,1159,565,1,0-2,1,0.05455388888888889,0.048966666666666665,5040,3881,5605,completed
3,167,4709,1,6-12,1,0.5443295833333334,0.40811333333333333,5760,5593,10469,completed
7,587,10992,1,12-24,1,2.4732999999999996,0.95264,5760,5173,16752,completed
8,601,10569,1,12-24,1,2.321322333333333,0.91598,5760,5159,16329,completed
9,810,4732,3,6-12,3-4,1.647335,1.23032,5760,4950,10492,completed
12,1284,5424,1,6-12,1,0.7061686666666667,0.47008,5760,4476,11184,completed
13,1389,2434,2,2-6,2,0.4159552777777778,0.42189333333333334,5760,4371,8194,completed
14,1515,408,1,0-2,1,0.03178433333333333,0.03536,5760,4245,6168,completed
15,1725,222,1,0-2,1,0.017294416666666663,0.01924,5760,4035,5982,completed
16,1725,222,1,0-2,1,0.017294416666666663,0.01924,5760,4035,5982,completed
17,1997,1667,1,2-6,1,0.13811970833333334,0.14447333333333334,5760,3763,7427,completed
18,2096,83,1,0-2,1,0.006465930555555554,0.007193333333333334,5760,3664,5843,completed
19,2253,494,1,0-2,1,0.03848397222222222,0.042813333333333335,5760,3507,6254,completed
20,2299,112,1,0-2,1,0.00872511111111111,0.009706666666666667,5760,3461,5872,completed
21,2555,3388,1,6-12,1,0.31129988888888893,0.29362666666666665,5760,3205,9148,completed
22,2660,97,1,0-2,1,0.007556569444444443,0.008406666666666666,5760,3100,5857,completed
23,2887,183,4,0-2,3-4,0.057024833333333316,0.06344,5760,2873,5943,completed
24,3055,65,1,0-2,1,0.005063680555555555,0.005633333333333333,5760,2705,5825,completed
25,3134,34571,2,48+,2,22.867604333333333,5.992306666666667,5760,2626,40331,completed
26,3178,74,1,0-2,1,0.005764805555555554,0.006413333333333333,5760,2582,5834,completed
27,3179,68,1,0-2,1,0.005297388888888887,0.005893333333333334,5760,2581,5828,completed
28,3284,2472,1,2-6,1,0.21145833333333336,0.21424,5760,2476,8232,completed
29,3291,95,2,0-2,2,0.014801527777777771,0.016466666666666668,5760,2469,5855,completed
30,3349,704,1,0-2,1,0.05484355555555555,0.061013333333333336,5760,2411,6464,completed
31,3487,285,3,0-2,3-4,0.06660687499999998,0.0741,5760,2273,6045,completed
32,3505,2215,1,2-6,1,0.1879178472222222,0.19196666666666667,5760,2255,7975,completed
33,4268,61,1,0-2,1,0.0047520694444444424,0.005286666666666667,5760,1492,5821,completed
34,4465,709,1,0-2,1,0.055233069444444435,0.06144666666666667,5760,1295,6469,completed
35,4543,2548,1,2-6,1,0.21841972222222222,0.22082666666666667,5760,1217,8308,completed
36,4712,5939,1,12-24,1,0.8464882916666666,0.5147133333333334,5760,1048,11699,completed
37,4901,471,2,0-2,2,0.07338441666666666,0.08164,5760,859,6231,completed
39,5372,118,2,0-2,2,0.01838505555555555,0.020453333333333334,5760,388,5878,completed
38,5372,118,2,0-2,2,0.01838505555555555,0.020453333333333334,5760,388,5878,completed
40,5375,67,4,0-2,3-4,0.02087794444444444,0.023226666666666666,5760,385,5827,completed
41,5540,4093,1,6-12,1,0.4236997777777778,0.3547266666666667,5760,220,9853,completed
42,6242,427,1,0-2,1,0.03466361111111111,0.03700666666666667,6242,0,6669,completed
43,6624,320,2,0-2,2,0.05459555555555557,0.055466666666666664,6624,0,6944,completed
44,6646,707,1,0-2,1,0.06115040277777779,0.06127333333333333,6646,0,7353,completed
45,6666,2386,1,2-6,1,0.22753772222222224,0.20678666666666667,6666,0,9052,completed
46,6676,4359,1,6-12,1,0.5972655972222223,0.37778,6676,0,11035,completed
47,6699,67,2,0-2,2,0.011430944444444447,0.011613333333333333,6699,0,6766,completed
48,6819,3748,1,6-12,1,0.47969683333333335,0.32482666666666665,6819,0,10567,completed
49,6921,77,1,0-2,1,0.006568527777777779,0.006673333333333333,6921,0,6998,completed
50,7474,11448,4,12-24,3-4,12.576638666666668,3.96864,7474,0,18922,completed
51,7487,296,1,0-2,1,0.026874333333333333,0.025653333333333334,7487,0,7783,completed
52,7691,88,3,0-2,3-4,0.023969000000000004,0.02288,7691,0,7779,completed
53,7879,4327,1,6-12,1,0.8342393749999999,0.37500666666666665,7879,0,12206,completed
54,7991,77,1,0-2,1,0.00705298611111111,0.006673333333333333,7991,0,8068,completed
55,8059,7351,1,12-24,1,1.8267035416666664,0.6370866666666667,8059,0,15410,completed
56,8115,6930,1,12-24,1,1.7209520833333334,0.6006,8115,0,15045,completed
57,8139,2558,1,2-6,1,0.38879479166666664,0.22169333333333333,8139,0,10697,completed
58,8157,6180,1,12-24,1,1.5298733333333334,0.5356,8157,0,14337,completed
59,8170,69,1,0-2,1,0.006320208333333332,0.00598,8170,0,8239,completed
60,8215,254,1,0-2,1,0.023265694444444443,0.022013333333333333,8215,0,8469,completed
61,8229,2321,1,2-6,1,0.34998729166666664,0.20115333333333332,8229,0,10550,completed
62,8277,7144,1,12-24,1,1.8098129027777776,0.6191466666666666,8277,0,15421,completed
63,8304,7286,1,12-24,1,1.854622222222222,0.6314533333333333,8304,0,15590,completed
64,8680,4991,1,6-12,1,1.272725236111111,0.43255333333333335,8680,0,13671,completed
65,8791,2081,1,2-6,1,0.3631921944444444,0.18035333333333334,8791,0,10872,completed
66,9037,6248,1,12-24,1,1.6896933611111111,0.5414933333333334,9037,0,15285,completed
67,9049,4386,1,6-12,1,1.146429986111111,0.38012,9049,0,13435,completed
68,9224,9360,1,12-24,1,2.821795333333333,0.8112,9224,0,18584,completed
69,9287,328,1,0-2,1,0.05363030555555555,0.028426666666666666,9287,0,9615,completed
70,9317,9595,1,12-24,1,2.9498898055555554,0.8315666666666667,9317,0,18912,completed
71,9334,10055,1,12-24,1,3.1660069027777773,0.8714333333333334,9334,0,19389,completed
72,9366,756,1,0-2,1,0.1337618333333333,0.06552,9366,0,10122,completed
74,9486,131,1,0-2,1,0.022939555555555553,0.011353333333333333,9486,0,9617,completed
76,9583,85,1,0-2,1,0.01488444444444444,0.007366666666666667,9583,0,9668,completed
77,9585,69,1,0-2,1,0.012082666666666662,0.00598,9585,0,9654,completed
78,9614,117,1,0-2,1,0.020488000000000003,0.01014,9614,0,9731,completed
80,9670,1169,3,0-2,3-4,0.6928282916666666,0.30394,9670,0,10839,completed
85,10387,1318,2,0-2,2,0.6423662499999999,0.22845333333333334,10387,0,11705,completed
89,11103,302,1,0-2,1,0.07315530555555554,0.026173333333333333,11103,0,11405,completed
90,11213,175,1,0-2,1,0.04239131944444443,0.015166666666666667,11213,0,11388,completed
91,11404,79,1,0-2,1,0.019136652777777766,0.006846666666666667,11404,0,11483,completed
92,11435,465,1,0-2,1,0.1456892361111111,0.0403,11435,0,11900,completed
93,11821,91,1,0-2,1,0.023643569444444443,0.007886666666666667,14400,2579,14491,completed
94,11855,68,1,0-2,1,0.01766772222222222,0.005893333333333334,14400,2545,14468,completed
95,11860,1379,3,0-2,3-4,1.1143306666666666,0.35854,14400,2540,15779,completed
96,11952,277,1,0-2,1,0.0719699861111111,0.024006666666666666,14400,2448,14677,completed
97,11979,62,1,0-2,1,0.016108805555555553,0.005373333333333333,14400,2421,14462,completed
99,12477,220,1,0-2,1,0.057160277777777775,0.019066666666666666,14400,1923,14620,completed
110,12955,1388,3,0-2,3-4,1.1218846666666664,0.36088,14400,1445,15788,completed
111,13242,189,1,0-2,1,0.04910587499999999,0.01638,14400,1158,14589,completed
112,13597,1366,3,0-2,3-4,1.103419333333333,0.35516000000000003,14400,803,15766,completed
114,13823,61,1,0-2,1,0.01584898611111111,0.005286666666666667,14400,577,14461,completed
116,14272,471,2,0-2,2,0.24474991666666662,0.08164,14400,128,14871,completed
117,14363,970,1,0-2,1,0.25701444444444443,0.08406666666666666,14400,37,15370,completed
118,14370,67,1,0-2,1,0.017407902777777776,0.005806666666666667,14400,30,14467,completed
119,14525,96,1,0-2,1,0.024942666666666665,0.008320000000000001,14525,0,14621,completed
121,14823,81,3,0-2,3-4,0.06313612499999999,0.02106,14823,0,14904,completed
123,15017,98,1,0-2,1,0.025462305555555554,0.008493333333333334,15017,0,15115,completed
124,15068,1330,1,0-2,1,0.41886861111111107,0.11526666666666667,15068,0,16398,completed
126,15263,125,1,0-2,1,0.0349722222222222,0.010833333333333334,15263,0,15388,completed
127,15338,105,1,0-2,1,0.02937666666666666,0.0091,15338,0,15443,completed
132,15766,67,1,0-2,1,0.018745111111111108,0.005806666666666667,15766,0,15833,completed
134,16100,884,1,0-2,1,0.31287972222222227,0.07661333333333334,16560,460,17444,completed
136,16330,104,1,0-2,1,0.03659500000000001,0.009013333333333333,16560,230,16664,completed
137,16372,415,1,0-2,1,0.14602812500000006,0.03596666666666667,16560,188,16975,completed
138,16667,292,1,0-2,1,0.10274750000000003,0.02530666666666667,16667,0,16959,completed
139,16918,91,1,0-2,1,0.03202062500000001,0.007886666666666667,16918,0,17009,completed
140,16919,621,1,0-2,1,0.22140326388888895,0.05382,16919,0,17540,completed
142,16963,60,1,0-2,1,0.02111250000000001,0.0052,16963,0,17023,completed
143,17338,1175,1,0-2,1,0.3798213888888889,0.10183333333333333,21600,4262,22775,completed
144,17338,1163,1,0-2,1,0.3766140555555556,0.10079333333333333,21600,4262,22763,completed
145,17338,1168,1,0-2,1,0.3779504444444444,0.10122666666666667,21600,4262,22768,completed
147,17682,861,3,0-2,3-4,0.8876885000000001,0.22386,21600,3918,22461,completed
148,17703,378,1,0-2,1,0.13556025,0.03276,21600,3897,21978,completed
151,17888,69,1,0-2,1,0.024745125000000007,0.00598,21600,3712,21669,completed
152,17930,62,1,0-2,1,0.022234750000000008,0.005373333333333333,21600,3670,21662,completed
156,18145,949,1,0-2,1,0.24318894444444444,0.08224666666666666,22320,4175,23269,completed
155,18145,1322,1,0-2,1,0.32584988888888894,0.11457333333333333,22320,4175,23642,completed
153,18145,1319,1,0-2,1,0.3251850555555556,0.11431333333333334,22320,4175,23639,completed
154,18145,1347,1,0-2,1,0.3313901666666667,0.11674,22320,4175,23667,completed
158,18145,1042,1,0-2,1,0.2637987777777778,0.09030666666666667,22320,4175,23362,completed
159,18145,358,1,0-2,1,0.09568544444444446,0.031026666666666668,22320,4175,22678,completed
164,18222,581,1,0-2,1,0.1552883888888889,0.05035333333333333,22320,4098,22901,completed
167,18357,1426,1,0-2,1,0.3488974444444445,0.12358666666666666,22320,3963,23746,completed
168,18471,374,2,0-2,2,0.1999237777777778,0.06482666666666667,22320,3849,22694,completed
169,18508,193,4,0-2,3-4,0.20633844444444444,0.06690666666666667,22320,3812,22513,completed
171,18888,157,4,0-2,3-4,0.13917177777777778,0.054426666666666665,23040,4152,23197,completed
172,18909,195,1,0-2,1,0.04321416666666668,0.016900000000000002,23040,4131,23235,completed
173,19019,327,1,0-2,1,0.07246683333333334,0.02834,23040,4021,23367,completed
174,19063,71,1,0-2,1,0.015734388888888895,0.006153333333333334,23040,3977,23111,completed
175,19128,880,4,0-2,3-4,0.759857777777778,0.30506666666666665,23040,3912,23920,completed
176,19151,156,4,0-2,3-4,0.13828533333333337,0.05408,23040,3889,23196,completed
177,19153,64,1,0-2,1,0.014183111111111115,0.005546666666666667,23040,3887,23104,completed
178,19312,230,2,0-2,2,0.10194111111111114,0.03986666666666667,23040,3728,23270,completed
179,19580,255,4,0-2,3-4,0.19382833333333332,0.0884,23760,4180,24015,completed
180,19717,80,1,0-2,1,0.015202222222222221,0.006933333333333333,23760,4043,23840,completed
181,19736,176,1,0-2,1,0.033444888888888885,0.015253333333333334,23760,4024,23936,completed
182,19900,375,1,0-2,1,0.07126041666666666,0.0325,23760,3860,24135,completed
183,19962,388,1,0-2,1,0.07373077777777777,0.033626666666666666,23760,3798,24148,completed
184,19996,103,1,0-2,1,0.019572861111111114,0.008926666666666666,23760,3764,23863,completed
186,20149,440,1,0-2,1,0.0836122222222222,0.03813333333333333,23760,3611,24200,completed
187,20173,261,1,0-2,1,0.0442105,0.02262,24480,4307,24741,completed
188,20527,93,1,0-2,1,0.015753166666666665,0.00806,24480,3953,24573,completed
189,20538,884,1,0-2,1,0.14679005555555558,0.07661333333333334,24480,3942,25364,completed
194,21484,69,1,0-2,1,0.010446791666666668,0.00598,25200,3716,25269,completed
195,21563,745,1,0-2,1,0.11264611111111114,0.06456666666666666,25200,3637,25945,completed
196,21591,610,1,0-2,1,0.09235569444444447,0.052866666666666666,25200,3609,25810,completed
73,9461,6613,1,12-24,1,1.919991333333333,0.5731266666666667,25920,16459,32533,completed
75,9489,7096,1,12-24,1,2.1273593333333336,0.6149866666666667,25920,16431,33016,completed
79,9665,4987,1,6-12,1,1.3122573194444445,0.4322066666666667,25920,16255,30907,completed
81,9793,5813,1,12-24,1,1.6143305972222224,0.5037933333333333,25920,16127,31733,completed
82,9840,6355,1,12-24,1,1.8163084027777776,0.5507666666666666,25920,16080,32275,completed
83,10187,8318,1,12-24,1,2.7383847222222224,0.7208933333333334,25920,15733,34238,completed
84,10348,2954,1,6-12,1,0.5136636666666667,0.2560133333333333,25920,15572,28874,completed
86,10396,9304,1,12-24,1,3.267149888888889,0.8063466666666667,25920,15524,35224,completed
87,10457,7078,1,12-24,1,2.1196313333333334,0.6134266666666667,25920,15463,32998,completed
88,10477,12607,1,24-48,1,5.093842,1.0926066666666667,25920,15443,38527,completed
98,12054,2661,1,2-6,1,0.43918766666666664,0.23062,25920,13866,28581,completed
100,12539,3768,1,6-12,1,0.8230546666666667,0.32656,25920,13381,29688,completed
101,12539,3275,1,6-12,1,0.6320591666666666,0.2838333333333333,25920,13381,29195,completed
103,12549,1730,1,2-6,1,0.2592369444444444,0.14993333333333334,25920,13371,27650,completed
102,12549,1730,1,2-6,1,0.2592369444444444,0.14993333333333334,25920,13371,27650,completed
104,12664,5781,1,12-24,1,1.6024057083333334,0.50102,25920,13256,31701,completed
106,12851,4743,1,6-12,1,1.218788375,0.41106,25920,13069,30663,completed
105,12851,4752,1,6-12,1,1.222236,0.41184,25920,13069,30672,completed
107,12852,4772,1,6-12,1,1.2298973888888889,0.41357333333333335,25920,13068,30692,completed
108,12857,4809,1,6-12,1,1.2440709583333334,0.41678,25920,13063,30729,completed
109,12877,3134,1,6-12,1,0.5800536666666667,0.2716133333333333,25920,13043,29054,completed
113,13795,1553,1,2-6,1,0.22959436111111106,0.13459333333333334,25920,12125,27473,completed
115,14245,4271,2,6-12,2,2.0720106111111107,0.7403066666666667,25920,11675,30191,completed
120,14545,4946,1,6-12,1,1.2965514722222222,0.42865333333333333,25920,11375,30866,completed
122,14830,1875,1,2-6,1,0.28352041666666666,0.1625,25920,11090,27795,completed
125,15128,3727,2,6-12,2,1.611393722222222,0.6460133333333333,25920,10792,29647,completed
128,15562,1740,1,2-6,1,0.26091166666666665,0.1508,25920,10358,27660,completed
129,15565,1927,1,2-6,1,0.2922289722222222,0.16700666666666666,25920,10355,27847,completed
130,15724,3285,1,6-12,1,0.6357474999999999,0.2847,25920,10196,29205,completed
131,15730,3684,1,6-12,1,0.7874923333333333,0.31928,25920,10190,29604,completed
133,15873,22293,1,24-48,1,7.513247375000001,1.93206,25920,10047,48213,completed
135,16234,2495,1,2-6,1,0.4034238888888889,0.21623333333333333,25920,9686,28415,completed
141,16929,6422,2,12-24,2,3.682552277777778,1.1131466666666667,25920,8991,32342,completed
146,17611,2681,1,2-6,1,0.44349655555555556,0.23235333333333333,25920,8309,28601,completed
149,17795,1518,1,2-6,1,0.22373283333333327,0.13156,25920,8125,27438,completed
150,17871,2813,1,2-6,1,0.4719352222222223,0.24379333333333333,25920,8049,28733,completed
157,18145,1479,1,2-6,1,0.21720141666666662,0.12818,25920,7775,27399,completed
160,18146,1686,1,2-6,1,0.2518681666666666,0.14612,25920,7774,27606,completed
161,18146,1643,1,2-6,1,0.24466686111111105,0.14239333333333334,25920,7774,27563,completed
162,18172,1862,1,2-6,1,0.2813432777777778,0.16137333333333334,25920,7748,27782,completed
163,18178,1994,1,2-6,1,0.303449611111111,0.17281333333333335,25920,7742,27914,completed
165,18273,1440,1,2-6,1,0.21066999999999997,0.12480000000000001,25920,7647,27360,completed
166,18309,1759,1,2-6,1,0.2640936388888888,0.15244666666666667,25920,7611,27679,completed
170,18652,9340,3,12-24,3-4,9.861274166666668,2.4284,25920,7268,35260,completed
185,20036,11017,1,12-24,1,4.205016569444444,0.9548066666666667,25920,5884,36937,completed
190,20543,1531,1,2-6,1,0.2259099722222222,0.13268666666666667,25920,5377,27451,completed
191,20566,1466,1,2-6,1,0.21502427777777774,0.12705333333333332,25920,5354,27386,completed
192,20837,10936,1,12-24,1,4.158071444444445,0.9477866666666667,25920,5083,36856,completed
193,21039,31269,2,24-48,2,18.915611250000005,5.41996,25920,4881,57189,completed
197,21637,784,1,0-2,1,0.11413777777777774,0.06794666666666667,25920,4283,26704,completed
198,21673,782,1,0-2,1,0.11384347222222219,0.06777333333333334,25920,4247,26702,completed
199,21778,1145,1,0-2,1,0.16725993055555555,0.09923333333333334,25920,4142,27065,completed
200,21946,611,1,0-2,1,0.08886655555555555,0.05295333333333333,25920,3974,26531,completed
201,22124,84,1,0-2,1,0.012217333333333332,0.00728,25920,3796,26004,completed
202,22438,277,1,0-2,1,0.04028811111111111,0.024006666666666666,25920,3482,26197,completed
203,22509,78,1,0-2,1,0.011344666666666666,0.00676,25920,3411,25998,completed
204,22509,122,1,0-2,1,0.01774422222222222,0.010573333333333334,25920,3411,26042,completed
205,22647,224,1,0-2,1,0.03257955555555555,0.019413333333333335,25920,3273,26144,completed
206,22818,61,1,0-2,1,0.008872111111111112,0.005286666666666667,25920,3102,25981,completed
207,22888,1607,1,2-6,1,0.23863786111111107,0.13927333333333333,25920,3032,27527,completed
208,22931,197,1,0-2,1,0.02865255555555555,0.017073333333333333,25920,2989,26117,completed
209,22988,199,1,0-2,1,0.02894344444444444,0.017246666666666667,25920,2932,26119,completed
210,23087,542,1,0-2,1,0.07883088888888887,0.04697333333333333,25920,2833,26462,completed
211,23227,2388,1,2-6,1,0.38037133333333334,0.20696,25920,2693,28308,completed
212,23478,251,1,0-2,1,0.036506555555555556,0.021753333333333333,25920,2442,26171,completed
213,23710,897,1,0-2,1,0.13076604166666667,0.07774,25920,2210,26817,completed
214,23725,67,1,0-2,1,0.009744777777777778,0.005806666666666667,25920,2195,25987,completed
215,23773,3220,4,6-12,3-4,2.4470933333333336,1.1162666666666667,25920,2147,29140,completed
216,23810,879,1,0-2,1,0.12811729166666663,0.07618,25920,2110,26799,completed
217,23906,337,1,0-2,1,0.04901477777777777,0.029206666666666665,25920,2014,26257,completed
218,24058,65,1,0-2,1,0.009453888888888888,0.005633333333333333,25920,1862,25985,completed
219,24289,203,1,0-2,1,0.029525222222222217,0.017593333333333332,25920,1631,26123,completed
220,24359,96,1,0-2,1,0.013962666666666663,0.008320000000000001,25920,1561,26016,completed
221,24363,87,1,0-2,1,0.012653666666666665,0.00754,25920,1557,26007,completed
222,24481,378,1,0-2,1,0.054977999999999985,0.03276,25920,1439,26298,completed
223,24590,1898,1,2-6,1,0.28737227777777774,0.16449333333333332,25920,1330,27818,completed
224,24763,42957,1,48+,1,11.397990375000001,3.72294,25920,1157,68877,completed
225,24890,103,1,0-2,1,0.014980777777777775,0.008926666666666666,25920,1030,26023,completed
226,25081,67,1,0-2,1,0.009744777777777778,0.005806666666666667,25920,839,25987,completed
227,25100,12719,1,24-48,1,5.149394,1.1023133333333333,25920,820,38639,completed
228,25104,11168,1,12-24,1,4.292531555555556,0.9678933333333334,25920,816,37088,completed
229,25139,3460,1,6-12,1,0.7002933333333333,0.29986666666666667,25920,781,29380,completed
230,25585,1313,1,0-2,1,0.1919815972222222,0.11379333333333333,25920,335,27233,completed
231,25598,189,2,0-2,2,0.054977999999999985,0.03276,25920,322,26109,completed
232,25598,189,2,0-2,2,0.054977999999999985,0.03276,25920,322,26109,completed
233,25676,3049,1,6-12,1,0.5487028333333334,0.2642466666666667,25920,244,28969,completed
234,25678,125,1,0-2,1,0.018180555555555554,0.010833333333333334,25920,242,26045,completed
235,25725,83,2,0-2,2,0.024143777777777774,0.014386666666666667,25920,195,26003,completed
236,26334,88,1,0-2,1,0.012799111111111108,0.007626666666666667,26334,0,26422,completed
237,26539,534,1,0-2,1,0.07840704166666665,0.04628,26539,0,27073,completed
238,26542,5113,1,6-12,1,1.4950156388888889,0.44312666666666667,26542,0,31655,completed
239,26559,592,1,0-2,1,0.08697606944444444,0.05130666666666667,26559,0,27151,completed
240,26611,73,1,0-2,1,0.01069261111111111,0.006326666666666667,26611,0,26684,completed
241,26639,197,1,0-2,1,0.028987388888888882,0.017073333333333333,26639,0,26836,completed
242,26777,143,1,0-2,1,0.021042847222222216,0.012393333333333334,26777,0,26920,completed
243,26797,231,1,0-2,1,0.03399229166666666,0.02002,26797,0,27028,completed
244,26884,67,1,0-2,1,0.009859236111111109,0.005806666666666667,26884,0,26951,completed
245,26885,65,1,0-2,1,0.009564930555555554,0.005633333333333333,26885,0,26950,completed
246,26889,283,1,0-2,1,0.04164423611111111,0.024526666666666665,26889,0,27172,completed
247,26892,107,1,0-2,1,0.01574534722222222,0.009273333333333333,26892,0,26999,completed
248,26993,784,1,0-2,1,0.12384098611111112,0.06794666666666667,26993,0,27777,completed
249,27169,459,1,0-2,1,0.0729887361111111,0.03978,27169,0,27628,completed
250,27246,67,1,0-2,1,0.009859236111111109,0.005806666666666667,27246,0,27313,completed
251,27251,114,1,0-2,1,0.016877013888888886,0.00988,27251,0,27365,completed
252,27321,949,1,0-2,1,0.16725340277777778,0.08224666666666666,27321,0,28270,completed
253,27340,2085,1,2-6,1,0.5091638888888887,0.1807,27340,0,29425,completed
254,27826,1840,2,2-6,2,1.0500573333333332,0.31893333333333335,27826,0,29666,completed
255,27921,1215,1,0-2,1,0.30567608333333335,0.1053,27921,0,29136,completed
256,28282,798,1,0-2,1,0.21487355555555557,0.06916,28282,0,29080,completed
257,28287,753,1,0-2,1,0.19904300000000003,0.06526,28287,0,29040,completed
258,28360,133,1,0-2,1,0.02865411111111112,0.011526666666666668,28360,0,28493,completed
259,28672,1075,1,0-2,1,0.3892398611111111,0.09316666666666666,28672,0,29747,completed
260,28863,317,1,0-2,1,0.1153615833333333,0.027473333333333332,30960,2097,31277,completed
262,29069,1100,4,0-2,3-4,1.6145122222222221,0.38133333333333336,30960,1891,32060,completed
263,29169,160,1,0-2,1,0.05822666666666665,0.013866666666666666,30960,1791,31120,completed
264,29282,1011,3,0-2,3-4,1.1113858750000003,0.26286,30960,1678,31971,completed
265,29298,70,1,0-2,1,0.025474166666666652,0.006066666666666666,30960,1662,31030,completed
266,29466,77,1,0-2,1,0.02802158333333332,0.006673333333333333,30960,1494,31037,completed
268,29728,247,1,0-2,1,0.08988741666666666,0.021406666666666668,30960,1232,31207,completed
270,29934,288,1,0-2,1,0.10480799999999997,0.02496,30960,1026,31248,completed
271,29949,186,1,0-2,1,0.06768849999999998,0.01612,30960,1011,31146,completed
272,30024,284,1,0-2,1,0.1033523333333333,0.024613333333333334,30960,936,31244,completed
273,30093,457,1,0-2,1,0.16630991666666667,0.039606666666666665,30960,867,31417,completed
275,30345,124,1,0-2,1,0.04512566666666666,0.010746666666666667,30960,615,31084,completed
276,30346,324,1,0-2,1,0.11790899999999996,0.02808,30960,614,31284,completed
277,30347,142,1,0-2,1,0.05167616666666665,0.012306666666666667,30960,613,31102,completed
278,30349,123,1,0-2,1,0.044761749999999996,0.01066,30960,611,31083,completed
279,30353,370,1,0-2,1,0.13464916666666665,0.03206666666666667,30960,607,31330,completed
280,30629,586,1,0-2,1,0.2132551666666666,0.05078666666666667,30960,331,31546,completed
282,31235,110,1,0-2,1,0.04003083333333332,0.009533333333333333,31235,0,31345,completed
283,31921,268,1,0-2,1,0.09987094444444447,0.023226666666666666,31921,0,32189,completed
284,32262,1421,1,0-2,1,0.6478559305555556,0.12315333333333334,32262,0,33683,completed
285,32302,67,1,0-2,1,0.02496773611111111,0.005806666666666667,32302,0,32369,completed
287,32401,403,1,0-2,1,0.17302133333333333,0.03492666666666667,32401,0,32804,completed
288,32442,68,1,0-2,1,0.029194666666666664,0.005893333333333334,32442,0,32510,completed
289,32572,127,2,0-2,2,0.10905066666666664,0.022013333333333333,32572,0,32699,completed
291,32694,108,1,0-2,1,0.04636799999999999,0.00936,32694,0,32802,completed
292,33074,95,2,0-2,2,0.08950997222222216,0.016466666666666668,33074,0,33169,completed
293,33083,95,2,0-2,2,0.09096772222222217,0.016466666666666668,33083,0,33178,completed
294,33652,190,1,0-2,1,0.09497361111111108,0.016466666666666668,33840,188,34030,completed
295,33694,82,1,0-2,1,0.0409886111111111,0.0071066666666666665,33840,146,33922,completed
296,33771,77,1,0-2,1,0.03848930555555555,0.006673333333333333,33840,69,33917,completed
297,33838,68,4,0-2,3-4,0.1359622222222222,0.023573333333333335,33840,2,33908,completed
298,33978,91,3,0-2,3-4,0.13540800000000003,0.02366,38160,4182,38251,completed
300,34153,65,1,0-2,1,0.032240000000000005,0.005633333333333333,38160,4007,38225,completed
301,34156,83,2,0-2,2,0.08233600000000002,0.014386666666666667,38160,4004,38243,completed
302,34382,133,1,0-2,1,0.06596800000000003,0.011526666666666668,38160,3778,38293,completed
304,34486,1338,1,0-2,1,0.5763383333333334,0.11596000000000001,38160,3674,39498,completed
305,34840,62,1,0-2,1,0.021992777777777778,0.005373333333333333,38880,4040,38942,completed
306,35170,62,1,0-2,1,0.021992777777777778,0.005373333333333333,38880,3710,38942,completed
307,35197,67,1,0-2,1,0.023766388888888892,0.005806666666666667,38880,3683,38947,completed
309,35609,1228,1,0-2,1,0.4405801111111112,0.10642666666666667,38880,3271,40108,completed
310,35609,1047,1,0-2,1,0.37460058333333346,0.09074,38880,3271,39927,completed
313,35610,1108,1,0-2,1,0.39683677777777787,0.09602666666666666,38880,3270,39988,completed
312,35610,1122,1,0-2,1,0.40194016666666676,0.09724000000000001,38880,3270,40002,completed
315,35760,69,1,0-2,1,0.024475833333333336,0.00598,38880,3120,38949,completed
316,35765,721,1,0-2,1,0.25576452777777786,0.06248666666666667,38880,3115,39601,completed
317,36083,192,1,0-2,1,0.05065600000000001,0.016640000000000002,40320,4237,40512,completed
318,36201,63,1,0-2,1,0.016621500000000004,0.0054600000000000004,40320,4119,40383,completed
321,36280,801,1,0-2,1,0.205211625,0.06942,40320,4040,41121,completed
323,36471,658,4,0-2,3-4,0.6944093333333334,0.22810666666666668,40320,3849,40978,completed
324,36530,282,1,0-2,1,0.07440100000000001,0.02444,40320,3790,40602,completed
325,36581,217,2,0-2,2,0.11450366666666668,0.03761333333333333,40320,3739,40537,completed
326,36684,94,1,0-2,1,0.024800333333333344,0.008146666666666667,40320,3636,40414,completed
261,28962,4050,1,6-12,1,0.8315475000000001,0.351,41760,12798,45810,completed
267,29723,23537,1,24-48,1,4.833879875,2.0398733333333334,41760,12037,65297,completed
269,29797,1819,2,2-6,2,0.6645620833333334,0.3152933333333333,41760,11963,43579,completed
274,30204,1703,1,2-6,1,0.3091052083333334,0.14759333333333333,41760,11556,43463,completed
281,30697,3049,4,6-12,3-4,2.3923202222222226,1.0569866666666667,41760,11063,44809,completed
286,32304,2799,1,2-6,1,0.54093675,0.24258000000000002,41760,9456,44559,completed
290,32670,2561,4,2-6,3-4,1.9543863333333333,0.8878133333333333,41760,9090,44321,completed
299,34091,2289,1,2-6,1,0.42877925,0.19838,41760,7669,44049,completed
303,34398,23251,2,24-48,2,9.56143925,4.030173333333334,41760,7362,65011,completed
308,35461,1514,1,2-6,1,0.27134458333333333,0.13121333333333335,41760,6299,43274,completed
311,35610,1576,1,2-6,1,0.28373166666666666,0.13658666666666666,41760,6150,43336,completed
314,35613,2060,1,2-6,1,0.3804308333333334,0.17853333333333335,41760,6147,43820,completed
319,36204,3223,1,6-12,1,0.6385737222222223,0.27932666666666667,41760,5556,44983,completed
320,36269,2678,1,2-6,1,0.5143268333333333,0.23209333333333335,41760,5491,44438,completed
322,36435,5286,1,6-12,1,1.1418135833333334,0.45812,41760,5325,47046,completed
327,36816,4714,3,6-12,3-4,2.9930480833333335,1.22564,41760,4944,46474,completed
328,37065,11598,1,24-48,1,2.5799807500000003,1.00516,41760,4695,53358,completed
329,37107,3611,1,6-12,1,0.7288824722222224,0.31295333333333336,41760,4653,45371,completed
330,37189,5415,3,6-12,3-4,3.5181218750000003,1.4079,41760,4571,47175,completed
331,37335,9897,1,12-24,1,2.2118123333333335,0.8577400000000001,41760,4425,51657,completed
332,37535,242,1,0-2,1,0.041829027777777784,0.020973333333333333,41760,4225,42002,completed
333,37640,120,1,0-2,1,0.02074166666666667,0.0104,41760,4120,41880,completed
334,38060,8256,2,12-24,2,3.6246080000000007,1.43104,41760,3700,50016,completed
335,38128,1022,1,0-2,1,0.17986280555555556,0.08857333333333334,41760,3632,42782,completed
336,38669,1576,1,2-6,1,0.28373166666666666,0.13658666666666666,41760,3091,43336,completed
337,38721,1060,1,0-2,1,0.18683527777777778,0.09186666666666667,41760,3039,42820,completed
338,38746,2142,2,2-6,2,0.7936274999999999,0.37128,41760,3014,43902,completed
339,38843,136,1,0-2,1,0.023507222222222224,0.011786666666666668,41760,2917,41896,completed
340,38845,327,1,0-2,1,0.05652104166666667,0.02834,41760,2915,42087,completed
341,38894,870,1,0-2,1,0.15197291666666668,0.0754,41760,2866,42630,completed
343,39034,1058,1,0-2,1,0.18646830555555557,0.09169333333333334,41760,2726,42818,completed
347,39155,1284,1,0-2,1,0.22793616666666666,0.11128,41760,2605,43044,completed
348,39174,93,1,0-2,1,0.01607479166666667,0.00806,41760,2586,41853,completed
350,39237,743,1,0-2,1,0.12867018055555557,0.06439333333333333,41760,2523,42503,completed
351,39247,773,1,0-2,1,0.13417476388888888,0.06699333333333334,41760,2513,42533,completed
353,39363,759,1,0-2,1,0.13160595833333333,0.06578,41760,2397,42519,completed
354,39371,409,1,0-2,1,0.0706945138888889,0.03544666666666667,41760,2389,42169,completed
355,39403,1236,1,0-2,1,0.21912883333333333,0.10712,41760,2357,42996,completed
356,39481,462,1,0-2,1,0.07985541666666668,0.04004,41760,2279,42222,completed
357,39491,437,1,0-2,1,0.07553423611111112,0.037873333333333335,41760,2269,42197,completed
358,39886,65,1,0-2,1,0.011235069444444445,0.005633333333333333,41760,1874,41825,completed
359,39922,780,2,0-2,2,0.27091833333333337,0.13520000000000001,41760,1838,42540,completed
360,40319,141,1,0-2,1,0.024371458333333332,0.01222,41760,1441,41901,completed
362,40724,1134,1,0-2,1,0.20041325000000001,0.09828,41760,1036,42894,completed
361,40724,1134,1,0-2,1,0.20041325000000001,0.09828,41760,1036,42894,completed
364,41001,205,1,0-2,1,0.03543368055555557,0.017766666666666667,41760,759,41965,completed
363,41001,173,1,0-2,1,0.02990256944444445,0.014993333333333334,41760,759,41933,completed
365,41312,160,1,0-2,1,0.027655555555555558,0.013866666666666666,41760,448,41920,completed
366,41325,150,1,0-2,1,0.025927083333333333,0.013,41760,435,41910,completed
367,41325,150,1,0-2,1,0.025927083333333333,0.013,41760,435,41910,completed
369,41607,1107,1,0-2,1,0.195459125,0.09594,41760,153,42867,completed
376,43891,1150,2,0-2,2,0.514911138888889,0.19933333333333333,43891,0,45041,completed
375,43891,155,1,0-2,1,0.03350345833333333,0.013433333333333334,43891,0,44046,completed
377,43910,180,1,0-2,1,0.03938375000000001,0.015600000000000001,43910,0,44090,completed
378,43982,171,2,0-2,2,0.07185325000000001,0.02964,47520,3538,47691,completed
379,44138,140,1,0-2,1,0.029413611111111113,0.012133333333333333,47520,3382,47660,completed
381,44214,1049,1,0-2,1,0.22500255555555554,0.09091333333333333,47520,3306,48569,completed
382,44268,198,1,0-2,1,0.041599250000000004,0.01716,47520,3252,47718,completed
383,44357,786,1,0-2,1,0.16606133333333334,0.06812,47520,3163,48306,completed
384,44409,949,1,0-2,1,0.20259144444444444,0.08224666666666666,47520,3111,48469,completed
385,44459,1168,1,0-2,1,0.25167177777777777,0.10122666666666667,47520,3061,48688,completed
386,44536,824,1,0-2,1,0.17457755555555554,0.07141333333333333,47520,2984,48344,completed
387,44538,185,1,0-2,1,0.038867986111111114,0.016033333333333333,47520,2982,47705,completed
388,44818,689,1,0-2,1,0.1447569861111111,0.059713333333333334,47520,2702,48209,completed
390,44963,535,1,0-2,1,0.11240201388888889,0.04636666666666667,47520,2557,48055,completed
391,45053,472,1,0-2,1,0.09916588888888889,0.04090666666666667,47520,2467,47992,completed
392,45193,394,1,0-2,1,0.08277830555555557,0.034146666666666665,47520,2327,47914,completed
393,45295,1179,1,0-2,1,0.254137,0.10218,47520,2225,48699,completed
394,45498,1080,1,0-2,1,0.23195,0.0936,47520,2022,48600,completed
395,45499,847,1,0-2,1,0.17973211111111112,0.07340666666666666,47520,2021,48367,completed
396,45622,356,1,0-2,1,0.07479461111111112,0.030853333333333333,47520,1898,47876,completed
398,45710,292,1,0-2,1,0.06134838888888888,0.02530666666666667,47520,1810,47812,completed
399,45711,281,1,0-2,1,0.059037319444444444,0.024353333333333334,47520,1809,47801,completed
400,45732,848,1,0-2,1,0.17995622222222224,0.07349333333333334,47520,1788,48368,completed
402,45862,294,1,0-2,1,0.061768583333333335,0.02548,47520,1658,47814,completed
403,46142,593,1,0-2,1,0.12458765277777778,0.05139333333333333,47520,1378,48113,completed
404,46424,350,1,0-2,1,0.07353402777777779,0.030333333333333334,47520,1096,47870,completed
407,46720,71,2,0-2,2,0.02983380555555556,0.012306666666666667,47520,800,47591,completed
408,47229,187,1,0-2,1,0.03928818055555556,0.016206666666666668,47520,291,47707,completed
409,47241,72,1,0-2,1,0.015127,0.00624,47520,279,47592,completed
410,47700,817,1,0-2,1,0.17553127777777777,0.07080666666666667,47700,0,48517,completed
412,47824,111,1,0-2,1,0.02332079166666667,0.00962,47824,0,47935,completed
413,47910,61,1,0-2,1,0.012815930555555558,0.005286666666666667,47910,0,47971,completed
415,48123,63,1,0-2,1,0.013236125000000003,0.0054600000000000004,48123,0,48186,completed
416,48154,199,2,0-2,2,0.08678583333333335,0.034493333333333334,48154,0,48353,completed
417,48606,112,1,0-2,1,0.022840222222222227,0.009706666666666667,52560,3954,52672,completed
418,48670,137,1,0-2,1,0.027938486111111112,0.011873333333333333,52560,3890,52697,completed
420,48927,94,1,0-2,1,0.019169472222222216,0.008146666666666667,52560,3633,52654,completed
421,49475,449,1,0-2,1,0.09156481944444446,0.038913333333333334,52560,3085,53009,completed
422,49515,607,3,0-2,3-4,0.3713575416666667,0.15782000000000002,52560,3045,53167,completed
423,49616,589,3,0-2,3-4,0.3603452916666666,0.15314,52560,2944,53149,completed
424,49690,1004,3,0-2,3-4,0.6176705000000001,0.26104,52560,2870,53564,completed
425,49978,169,1,0-2,1,0.03446426388888889,0.014646666666666667,52560,2582,52729,completed
426,49982,138,1,0-2,1,0.02814241666666667,0.01196,52560,2578,52698,completed
427,50035,126,1,0-2,1,0.02569525,0.010920000000000001,52560,2525,52686,completed
428,50136,123,1,0-2,1,0.025083458333333336,0.01066,52560,2424,52683,completed
429,50677,127,1,0-2,1,0.025899180555555554,0.011006666666666666,52560,1883,52687,completed
430,50698,377,1,0-2,1,0.07688181944444444,0.03267333333333333,52560,1862,52937,completed
433,51206,126,4,0-2,3-4,0.102781,0.043680000000000004,52560,1354,52686,completed
435,51572,107,3,0-2,3-4,0.06546170833333334,0.02782,52560,988,52667,completed
436,51611,856,2,0-2,2,0.35022466666666674,0.14837333333333333,52560,949,53416,completed
437,51799,92,1,0-2,1,0.018761611111111107,0.007973333333333334,52560,761,52652,completed
342,38982,1575,1,2-6,1,0.22300625000000002,0.1365,56160,17178,57735,completed
344,39119,3503,1,6-12,1,0.4774604305555556,0.3035933333333333,56160,17041,59663,completed
345,39130,4834,1,6-12,1,0.6584785277777778,0.4189466666666667,56160,17030,60994,completed
346,39130,4834,1,6-12,1,0.6584785277777778,0.4189466666666667,56160,17030,60994,completed
349,39185,2539,2,2-6,2,0.7345187222222223,0.44009333333333334,56160,16975,58699,completed
352,39249,1697,1,2-6,1,0.24298375,0.14707333333333333,56160,16911,57857,completed
438,52072,1154,1,0-2,1,0.16091958333333334,0.10001333333333333,56160,4088,57314,completed
442,52367,1348,1,0-2,1,0.18803916666666667,0.11682666666666666,56160,3793,57508,completed
440,52367,1299,1,0-2,1,0.181189375,0.11258,56160,3793,57459,completed
448,52368,277,1,0-2,1,0.038568402777777774,0.024006666666666666,56160,3792,56437,completed
447,52368,277,1,0-2,1,0.038568402777777774,0.024006666666666666,56160,3792,56437,completed
452,53549,397,2,0-2,2,0.1105534722222222,0.06881333333333334,56160,2611,56557,completed
453,53555,480,1,0-2,1,0.06683333333333331,0.0416,56160,2605,56640,completed
454,53584,132,1,0-2,1,0.018379166666666665,0.01144,56160,2576,56292,completed
368,41387,1487,1,2-6,1,0.17563480555555558,0.12887333333333334,58320,16933,59807,completed
370,42489,3661,1,6-12,1,0.5523766666666667,0.31728666666666666,59040,16551,62701,completed
371,42594,4585,1,6-12,1,0.8083240277777779,0.39736666666666665,59040,16446,63625,completed
372,42783,2656,1,2-6,1,0.34992888888888896,0.23018666666666668,59040,16257,61696,completed
373,42786,3009,1,6-12,1,0.410891875,0.26078,59040,16254,62049,completed
374,43771,4646,1,6-12,1,0.826788388888889,0.40265333333333336,59040,15269,63686,completed
380,44187,3610,1,6-12,1,0.5387766666666667,0.3128666666666667,59040,14853,62650,completed
389,44928,10297,1,12-24,1,1.7242052777777779,0.8924066666666667,59040,14112,69337,completed
397,45674,2719,1,2-6,1,0.3593876388888889,0.23564666666666667,59040,13366,61759,completed
401,45811,16642,1,24-48,1,2.503001805555556,1.4423066666666666,59040,13229,75682,completed
405,46610,6531,4,12-24,3-4,5.079192333333333,2.26408,59040,12430,65571,completed
406,46681,2204,1,2-6,1,0.28206611111111113,0.19101333333333334,59040,12359,61244,completed
411,47790,2259,4,2-6,3-4,1.161295,0.78312,59040,11250,61299,completed
414,48049,1771,1,2-6,1,0.2228855694444445,0.15348666666666666,59040,10991,60811,completed
419,48727,4357,2,6-12,2,1.4786193888888892,0.7552133333333333,59040,10313,63397,completed
431,51075,2461,1,2-6,1,0.3206518055555556,0.21328666666666668,59040,7965,61501,completed
432,51154,1919,1,2-6,1,0.2428881805555556,0.16631333333333334,59040,7886,60959,completed
434,51515,10525,1,12-24,1,1.748208611111111,0.9121666666666667,59040,7525,69565,completed
462,56158,691,1,0-2,1,0.07386981944444446,0.059886666666666664,59040,2882,59731,completed
463,56269,731,1,0-2,1,0.07851580555555557,0.06335333333333333,59040,2771,59771,completed
465,56454,257,1,0-2,1,0.02747401388888889,0.022273333333333332,59040,2586,59297,completed
466,56456,919,1,0-2,1,0.1049350277777778,0.07964666666666667,59040,2584,59959,completed
467,56645,923,1,0-2,1,0.10549713888888891,0.07999333333333333,59040,2395,59963,completed
471,57157,306,1,0-2,1,0.03271225,0.026520000000000002,59040,1883,59346,completed
472,57384,160,1,0-2,1,0.017104444444444446,0.013866666666666666,59040,1656,59200,completed
473,57541,91,1,0-2,1,0.009728152777777777,0.007886666666666667,59040,1499,59131,completed
474,57542,318,1,0-2,1,0.03399508333333333,0.02756,59040,1498,59358,completed
475,57699,105,1,0-2,1,0.011224791666666668,0.0091,59040,1341,59145,completed
476,57839,365,1,0-2,1,0.039019513888888885,0.03163333333333333,59040,1201,59405,completed
477,57840,544,1,0-2,1,0.058155111111111116,0.04714666666666667,59040,1200,59584,completed
478,57919,67,1,0-2,1,0.007162486111111112,0.005806666666666667,59040,1121,59107,completed
479,58363,664,1,0-2,1,0.07098344444444446,0.05754666666666667,59040,677,59704,completed
480,58498,257,1,0-2,1,0.02747401388888889,0.022273333333333332,59040,542,59297,completed
481,58787,245,1,0-2,1,0.026191180555555554,0.021233333333333333,59040,253,59285,completed
482,59218,130,1,0-2,1,0.013897361111111112,0.011266666666666666,59218,0,59348,completed
483,59286,617,1,0-2,1,0.0707673888888889,0.05347333333333333,59286,0,59903,completed
488,60350,751,1,0-2,1,0.10196430555555558,0.06508666666666667,60480,130,61231,completed
491,61146,137,1,0-2,1,0.019759777777777775,0.011873333333333333,61146,0,61283,completed
492,61158,123,1,0-2,1,0.01783766666666666,0.01066,61158,0,61281,completed
493,61159,121,1,0-2,1,0.017552375,0.010486666666666667,61159,0,61280,completed
494,61220,427,2,0-2,2,0.1233792777777778,0.07401333333333333,65520,4300,65947,completed
495,61226,156,2,0-2,2,0.04507533333333334,0.02704,65520,4294,65676,completed
497,61312,431,1,0-2,1,0.06226752777777779,0.037353333333333336,65520,4208,65951,completed
496,61312,431,1,0-2,1,0.06226752777777779,0.037353333333333336,65520,4208,65951,completed
498,61330,712,1,0-2,1,0.10286422222222225,0.06170666666666667,65520,4190,66232,completed
500,61602,601,1,0-2,1,0.08682780555555557,0.05208666666666667,65520,3918,66121,completed
501,61704,641,1,0-2,1,0.09260669444444447,0.055553333333333337,65520,3816,66161,completed
502,61805,974,1,0-2,1,0.13569944444444446,0.08441333333333334,65520,3715,66494,completed
503,62001,206,1,0-2,1,0.02569277777777778,0.017853333333333332,66240,4239,66446,completed
504,62001,508,1,0-2,1,0.06335888888888888,0.044026666666666665,66240,4239,66748,completed
507,62292,619,1,0-2,1,0.07720305555555557,0.05364666666666667,66240,3948,66859,completed
508,62553,389,1,0-2,1,0.048516944444444446,0.03371333333333333,66240,3687,66629,completed
509,62705,823,1,0-2,1,0.09203297222222226,0.07132666666666666,66960,4255,67783,completed
511,63329,217,1,0-2,1,0.024297972222222235,0.018806666666666666,66960,3631,67177,completed
512,63601,281,1,0-2,1,0.03113636111111112,0.024353333333333334,67680,4079,67961,completed
513,63622,113,1,0-2,1,0.012521027777777782,0.009793333333333333,67680,4058,67793,completed
514,64516,177,1,0-2,1,0.01961258333333334,0.01534,67680,3164,67857,completed
439,52366,1604,1,2-6,1,0.17177044444444445,0.13901333333333332,69120,16754,70724,completed
445,52367,2313,1,2-6,1,0.25695124999999996,0.20046,69120,16753,71433,completed
441,52367,7217,1,12-24,1,0.8498832083333333,0.6254733333333333,69120,16753,76337,completed
443,52367,1995,1,2-6,1,0.21623583333333332,0.1729,69120,16753,71115,completed
444,52367,7298,1,12-24,1,0.8557590833333334,0.6324933333333334,69120,16753,76418,completed
446,52367,3941,1,6-12,1,0.5399068888888889,0.3415533333333333,69120,16753,73061,completed
449,52785,5805,1,12-24,1,0.745471875,0.5031,69120,16335,74925,completed
450,53223,4231,1,6-12,1,0.5947491111111112,0.36668666666666666,69120,15897,73351,completed
451,53310,4024,1,6-12,1,0.555603111111111,0.34874666666666665,69120,15810,73144,completed
455,55418,11702,1,24-48,1,1.324738,1.0141733333333334,69120,13702,80822,completed
456,55423,11521,1,24-48,1,1.2778589999999999,0.9984866666666666,69120,13697,80641,completed
460,55424,11847,1,24-48,1,1.362293,1.02674,69120,13696,80967,completed
458,55424,11868,1,24-48,1,1.367732,1.02856,69120,13696,80988,completed
457,55424,11442,1,12-24,1,1.2628612499999998,0.99164,69120,13696,80562,completed
459,55424,11787,1,24-48,1,1.346753,1.0215400000000001,69120,13696,80907,completed
461,55453,5369,1,6-12,1,0.7139508472222222,0.46531333333333336,69120,13667,74489,completed
464,56297,1553,1,2-6,1,0.1659706111111111,0.13459333333333334,69120,12823,70673,completed
468,56835,3157,1,6-12,1,0.3910531111111111,0.27360666666666666,69120,12285,72277,completed
515,65228,557,3,0-2,3-4,0.17591916666666668,0.14482,69120,3892,69677,completed
517,65675,126,1,0-2,1,0.013264999999999994,0.010920000000000001,69120,3445,69246,completed
518,65700,114,1,0-2,1,0.012001666666666664,0.00988,69120,3420,69234,completed
521,65753,459,4,0-2,3-4,0.19328999999999996,0.15912,69120,3367,69579,completed
524,66003,955,1,0-2,1,0.10103638888888887,0.08276666666666667,69120,3117,70075,completed
525,66117,85,1,0-2,1,0.008948611111111109,0.007366666666666667,69120,3003,69205,completed
526,66143,412,1,0-2,1,0.04337444444444444,0.035706666666666664,69120,2977,69532,completed
527,66348,712,1,0-2,1,0.07495777777777779,0.06170666666666667,69120,2772,69832,completed
528,66571,118,1,0-2,1,0.012422777777777772,0.010226666666666667,69120,2549,69238,completed
531,68136,77,1,0-2,1,0.008106388888888889,0.006673333333333333,69120,984,69197,completed
532,68137,90,1,0-2,1,0.009474999999999999,0.0078000000000000005,69120,983,69210,completed
533,68294,753,2,0-2,2,0.15868766666666667,0.13052,69120,826,69873,completed
534,68348,762,1,0-2,1,0.08031033333333333,0.06604,69120,772,69882,completed
536,68479,91,1,0-2,1,0.009580277777777776,0.007886666666666667,69120,641,69211,completed
537,68645,362,1,0-2,1,0.03811055555555555,0.031373333333333336,69120,475,69482,completed
543,69150,1394,1,0-2,1,0.14824344444444443,0.12081333333333334,69150,0,70544,completed
542,69150,1292,1,0-2,1,0.1372897777777778,0.11197333333333334,69150,0,70442,completed
545,69150,1256,1,0-2,1,0.13342377777777775,0.10885333333333333,69150,0,70406,completed
548,69156,1050,1,0-2,1,0.11131433333333332,0.091,69156,0,70206,completed
549,69156,969,1,0-2,1,0.10261583333333332,0.08398,69156,0,70125,completed
550,69536,176,2,0-2,2,0.03705777777777778,0.030506666666666668,69536,0,69712,completed
469,56909,4358,1,6-12,1,0.3100076944444444,0.3776933333333333,74160,17251,78518,completed
470,57089,3437,3,6-12,3-4,0.7465923750000001,0.89362,74160,17071,77597,completed
484,59569,5556,3,6-12,3-4,1.2819945,1.44456,74160,14591,79716,completed
554,70122,686,2,0-2,2,0.09887927777777777,0.11890666666666667,74160,4038,74846,completed
555,70789,333,2,0-2,2,0.04799825,0.05772,74160,3371,74493,completed
556,70912,435,1,0-2,1,0.03135020833333334,0.0377,74160,3248,74595,completed
557,71499,217,3,0-2,3-4,0.046917208333333335,0.05642,74160,2661,74377,completed
559,72338,105,1,0-2,1,0.0075672916666666675,0.0091,74160,1822,74265,completed
485,59825,3847,1,6-12,1,0.440693,0.3334066666666667,77040,17215,80887,completed
486,59996,3954,1,6-12,1,0.468406,0.34268,77040,17044,80994,completed
487,60129,7973,1,12-24,1,1.5141717500000003,0.6909933333333333,77040,16911,85013,completed
560,72783,120,1,0-2,1,0.008235,0.0104,77040,4257,77160,completed
561,72897,671,1,0-2,1,0.04604737499999999,0.058153333333333335,77040,4143,77711,completed
562,72955,1274,1,0-2,1,0.08542,0.11041333333333334,77040,4085,78314,completed
563,73115,148,1,0-2,1,0.010156499999999999,0.012826666666666667,77040,3925,77188,completed
564,73391,579,1,0-2,1,0.039733874999999995,0.05018,77040,3649,77619,completed
565,73422,1438,1,0-2,1,0.09607999999999997,0.12462666666666666,77040,3618,78478,completed
489,60658,1746,1,2-6,1,0.14259774999999997,0.15132,77760,17102,79506,completed
490,61016,1572,1,2-6,1,0.12214549999999999,0.13624,77760,16744,79332,completed
499,61384,1609,4,2-6,3-4,0.5059781666666666,0.5577866666666667,77760,16376,79369,completed
505,62004,2531,1,2-6,1,0.26136354166666664,0.21935333333333334,77760,15756,80291,completed
506,62191,13742,1,24-48,1,2.8886545000000003,1.1909733333333334,77760,15569,91502,completed
510,63097,16896,1,24-48,1,3.3098373333333337,1.46432,77760,14663,94656,completed
516,65662,4909,1,6-12,1,0.8920427777777779,0.4254466666666667,77760,12098,82669,completed
519,65748,1777,1,2-6,1,0.14624154166666664,0.15400666666666668,77760,12012,79537,completed
520,65752,2528,1,2-6,1,0.2607966666666667,0.21909333333333333,77760,12008,80288,completed
522,65754,2078,1,2-6,1,0.1816215833333333,0.18009333333333333,77760,12006,79838,completed
523,65776,3221,1,6-12,1,0.415629,0.27915333333333336,77760,11984,80981,completed
529,67484,2584,1,2-6,1,0.27137833333333333,0.22394666666666668,77760,10276,80344,completed
530,67621,2588,1,2-6,1,0.2721341666666667,0.22429333333333334,77760,10139,80348,completed
535,68351,3347,3,6-12,3-4,1.344789,0.87022,77760,9409,81107,completed
538,68776,1500,1,2-6,1,0.11368249999999999,0.13,77760,8984,79260,completed
539,68928,1528,2,2-6,2,0.23394733333333334,0.26485333333333333,77760,8832,79288,completed
540,69143,12853,1,24-48,1,2.6975387500000005,1.1139266666666667,77760,8617,90613,completed
546,69150,1509,1,2-6,1,0.11474037499999998,0.13078,77760,8610,79269,completed
541,69150,1521,1,2-6,1,0.11615087500000001,0.13182,77760,8610,79281,completed
544,69150,1519,1,2-6,1,0.11591579166666666,0.13164666666666666,77760,8610,79279,completed
547,69152,1773,1,2-6,1,0.14577137499999998,0.15366,77760,8608,79533,completed
551,70034,2646,1,2-6,1,0.28309375,0.22932,77760,7726,80406,completed
552,70055,2597,1,2-6,1,0.2738347916666667,0.22507333333333335,77760,7705,80357,completed
553,70088,2538,1,2-6,1,0.26268625,0.21996000000000002,77760,7672,80298,completed
558,72030,1966,1,2-6,1,0.16845691666666665,0.17038666666666666,77760,5730,79726,completed
566,73571,682,1,0-2,1,0.044329999999999994,0.05910666666666667,77760,4189,78442,completed
567,73593,472,1,0-2,1,0.03067999999999999,0.04090666666666667,77760,4167,78232,completed
568,73653,1847,1,2-6,1,0.1544694583333333,0.16007333333333335,77760,4107,79607,completed
569,73662,864,1,0-2,1,0.058765999999999985,0.07488,77760,4098,78624,completed
570,73759,791,1,0-2,1,0.052699902777777766,0.06855333333333334,77760,4001,78551,completed
571,73764,1282,1,0-2,1,0.09350063888888889,0.11110666666666667,77760,3996,79042,completed
572,73770,943,1,0-2,1,0.06533068055555555,0.08172666666666667,77760,3990,78703,completed
573,73794,1014,1,0-2,1,0.07123058333333332,0.08788,77760,3966,78774,completed
574,73816,1368,1,0-2,1,0.100647,0.11856,77760,3944,79128,completed
575,73838,2024,1,2-6,1,0.1752743333333333,0.17541333333333334,77760,3922,79784,completed
576,73878,649,1,0-2,1,0.042184999999999986,0.05624666666666667,77760,3882,78409,completed
577,73925,1200,1,0-2,1,0.08668666666666666,0.104,77760,3835,78960,completed
578,73925,1940,1,2-6,1,0.16540083333333333,0.16813333333333333,77760,3835,79700,completed
579,73971,1976,1,2-6,1,0.16963233333333333,0.17125333333333334,77760,3789,79736,completed
580,73972,2848,1,2-6,1,0.32126333333333335,0.24682666666666667,77760,3788,80608,completed
581,73974,2462,1,2-6,1,0.2483254166666667,0.21337333333333333,77760,3786,80222,completed
582,74054,1374,1,0-2,1,0.10114558333333334,0.11908,77760,3706,79134,completed
583,74174,62,1,0-2,1,0.00403,0.005373333333333333,77760,3586,77822,completed
584,74275,62,1,0-2,1,0.00403,0.005373333333333333,77760,3485,77822,completed
585,74877,1153,1,0-2,1,0.08278109722222221,0.09992666666666666,77760,2883,78913,completed
586,74878,946,1,0-2,1,0.06557997222222221,0.08198666666666667,77760,2882,78706,completed
588,75379,198,1,0-2,1,0.012869999999999996,0.01716,77760,2381,77958,completed
587,75379,692,1,0-2,1,0.04497999999999999,0.05997333333333334,77760,2381,78452,completed
589,75854,692,1,0-2,1,0.04497999999999999,0.05997333333333334,77760,1906,78452,completed
590,76739,3412,1,6-12,1,0.46509799999999996,0.2957066666666667,77760,1021,81172,completed
591,76755,1813,1,2-6,1,0.15047304166666664,0.15712666666666666,77760,1005,79573,completed
592,76756,3651,1,6-12,1,0.5285070416666666,0.31642,77760,1004,81411,completed
593,76767,6078,1,12-24,1,1.2012488333333335,0.52676,77760,993,83838,completed
594,76796,258,1,0-2,1,0.016769999999999997,0.02236,77760,964,78018,completed
595,77026,3433,1,6-12,1,0.470537,0.29752666666666666,77760,734,81193,completed
596,77317,392,1,0-2,1,0.025479999999999992,0.033973333333333335,77760,443,78152,completed
597,77736,118,1,0-2,1,0.007669999999999997,0.010226666666666667,77760,24,77878,completed
598,77778,129,1,0-2,1,0.008385,0.01118,77778,0,77907,completed
599,78040,64,1,0-2,1,0.00416,0.005546666666666667,78040,0,78104,completed
600,78044,62,1,0-2,1,0.00403,0.005373333333333333,78044,0,78106,completed
601,78351,3535,1,6-12,1,0.6271625277777778,0.3063666666666667,78351,0,81886,completed
602,78351,4930,1,6-12,1,1.0210809722222223,0.4272666666666667,78351,0,83281,completed
603,78423,149,1,0-2,1,0.011349944444444447,0.012913333333333334,78423,0,78572,completed
604,78425,136,1,0-2,1,0.010305875000000003,0.011786666666666668,78425,0,78561,completed
605,78430,162,1,0-2,1,0.012556888888888892,0.01404,78430,0,78592,completed
606,78800,511,1,0-2,1,0.046286013888888894,0.04428666666666667,78800,0,79311,completed
607,78848,1058,1,0-2,1,0.11223463888888888,0.09169333333333334,78848,0,79906,completed
608,79013,1119,1,0-2,1,0.1402283472222222,0.09698,79013,0,80132,completed
609,79046,83,1,0-2,1,0.006897069444444446,0.007193333333333334,79046,0,79129,completed
610,79049,1342,1,0-2,1,0.18617705555555553,0.11630666666666667,79049,0,80391,completed
611,79067,1104,1,0-2,1,0.1431104722222222,0.09568,79067,0,80171,completed
612,79103,1369,1,0-2,1,0.19699543055555552,0.11864666666666666,79103,0,80472,completed
613,79134,409,1,0-2,1,0.04580120833333332,0.03544666666666667,79134,0,79543,completed
614,79134,320,1,0-2,1,0.035339999999999996,0.027733333333333332,79134,0,79454,completed
615,79145,1191,1,0-2,1,0.16780701388888886,0.10322,79145,0,80336,completed
616,79182,1062,1,0-2,1,0.14734824999999996,0.09204,79182,0,80244,completed
618,79555,853,1,0-2,1,0.135114375,0.07392666666666667,79555,0,80408,completed
619,80266,119,1,0-2,1,0.022486041666666665,0.010313333333333334,80266,0,80385,completed
620,80684,567,1,0-2,1,0.09908325,0.04914,84960,4276,85527,completed
621,80690,892,1,0-2,1,0.15391572222222222,0.07730666666666666,84960,4270,85852,completed
622,81007,483,1,0-2,1,0.08440425,0.04186,84960,3953,85443,completed
624,81107,370,1,0-2,1,0.0646575,0.03206666666666667,84960,3853,85330,completed
626,81326,351,1,0-2,1,0.061337249999999996,0.03042,84960,3634,85311,completed
627,81444,71,3,0-2,3-4,0.034792958333333346,0.01846,85680,4236,85751,completed
628,81518,407,1,0-2,1,0.06648231944444444,0.03527333333333334,85680,4162,86087,completed
630,81838,183,1,0-2,1,0.029892541666666675,0.01586,85680,3842,85863,completed
631,81861,478,1,0-2,1,0.07807997222222222,0.04142666666666667,85680,3819,86158,completed
632,81988,229,1,0-2,1,0.03740651388888889,0.01984666666666667,85680,3692,85909,completed
633,82056,98,1,0-2,1,0.016008027777777777,0.008493333333333334,85680,3624,85778,completed
635,82448,133,1,0-2,1,0.019955541666666667,0.011526666666666668,86400,3952,86533,completed
637,82658,1329,4,0-2,3-4,0.7794868333333334,0.46072,86400,3742,87729,completed
640,82817,197,2,0-2,2,0.05618330555555555,0.034146666666666665,87120,4303,87317,completed
641,83717,60,1,0-2,1,0.008555833333333335,0.0052,87120,3403,87180,completed
642,83979,199,1,0-2,1,0.028376847222222217,0.017246666666666667,87120,3141,87319,completed
643,83998,80,2,0-2,2,0.02281555555555555,0.013866666666666666,87120,3122,87200,completed
644,84474,461,3,0-2,3-4,0.19721195833333324,0.11986000000000001,87120,2646,87581,completed
645,84511,517,3,0-2,3-4,0.22116829166666663,0.13442,87120,2609,87637,completed
646,84699,504,1,0-2,1,0.07186899999999999,0.043680000000000004,87120,2421,87624,completed
647,84705,228,2,0-2,2,0.06502433333333331,0.03952,87120,2415,87348,completed
648,84709,261,1,0-2,1,0.037217875,0.02262,87120,2411,87381,completed
649,84751,105,2,0-2,2,0.02994541666666666,0.0182,87120,2369,87225,completed
650,84908,76,2,0-2,2,0.02167477777777778,0.013173333333333334,87120,2212,87196,completed
651,85178,977,4,0-2,3-4,0.5811281111111111,0.33869333333333335,87120,1942,88097,completed
652,85293,270,1,0-2,1,0.03850125,0.0234,87120,1827,87390,completed
653,85354,666,4,0-2,3-4,0.3798789999999999,0.23088,87120,1766,87786,completed
654,85396,61,1,0-2,1,0.008698430555555558,0.005286666666666667,87120,1724,87181,completed
655,85418,63,1,0-2,1,0.008983625000000004,0.0054600000000000004,87120,1702,87183,completed
656,85495,493,1,0-2,1,0.07030043055555554,0.04272666666666667,87120,1625,87613,completed
658,85564,643,1,0-2,1,0.09169001388888887,0.05572666666666667,87120,1556,87763,completed
660,86045,904,1,0-2,1,0.1331782222222222,0.07834666666666666,87120,1075,88024,completed
662,86074,138,1,0-2,1,0.019678416666666664,0.01196,87120,1046,87258,completed
663,86296,125,1,0-2,1,0.01782465277777777,0.010833333333333334,87120,824,87245,completed
664,86522,385,1,0-2,1,0.054899930555555546,0.03336666666666667,87120,598,87505,completed
665,86604,172,1,0-2,1,0.02452672222222222,0.014906666666666667,87120,516,87292,completed
666,86701,93,1,0-2,1,0.013261541666666666,0.00806,87120,419,87213,completed
667,86819,325,2,0-2,2,0.09268819444444443,0.05633333333333333,87120,301,87445,completed
668,86844,231,1,0-2,1,0.03293995833333332,0.02002,87120,276,87351,completed
669,87124,450,1,0-2,1,0.06416874999999998,0.039,87124,0,87574,completed
672,87228,403,1,0-2,1,0.05746668055555554,0.03492666666666667,87228,0,87631,completed
674,87361,700,2,0-2,2,0.2098941944444444,0.12133333333333333,87361,0,88061,completed
675,87453,214,1,0-2,1,0.03051580555555555,0.018546666666666666,87453,0,87667,completed
678,87484,1142,1,0-2,1,0.18641911111111112,0.09897333333333333,87484,0,88626,completed
679,87592,385,1,0-2,1,0.05807947222222222,0.03336666666666667,87592,0,87977,completed
680,87691,146,1,0-2,1,0.020819194444444442,0.012653333333333334,87691,0,87837,completed
681,88122,359,1,0-2,1,0.05472755555555556,0.031113333333333333,92160,4038,92519,completed
682,88187,82,1,0-2,1,0.012500444444444444,0.0071066666666666665,92160,3973,92242,completed
683,88513,81,1,0-2,1,0.012348,0.00702,92160,3647,92241,completed
684,88524,621,1,0-2,1,0.094668,0.05382,92160,3636,92781,completed
685,88528,107,1,0-2,1,0.016311555555555555,0.009273333333333333,92160,3632,92267,completed
686,88622,120,1,0-2,1,0.016163333333333335,0.0104,92880,4258,93000,completed
688,88704,345,1,0-2,1,0.04646958333333334,0.0299,92880,4176,93225,completed
687,88704,343,1,0-2,1,0.04620019444444445,0.02972666666666667,92880,4176,93223,completed
689,88794,245,1,0-2,1,0.03300013888888889,0.021233333333333333,92880,4086,93125,completed
691,89062,373,1,0-2,1,0.05024102777777778,0.03232666666666667,92880,3818,93253,completed
692,89169,167,3,0-2,3-4,0.06748191666666667,0.04342,92880,3711,93047,completed
693,89170,169,3,0-2,3-4,0.06829008333333335,0.04394,92880,3710,93049,completed
694,89211,959,1,0-2,1,0.12266254166666668,0.08311333333333333,92880,3669,93839,completed
695,89564,240,2,0-2,2,0.05158,0.0416,93600,4036,93840,completed
696,89577,68,1,0-2,1,0.0073071666666666675,0.005893333333333334,93600,4023,93668,completed
697,89631,722,1,0-2,1,0.07757980555555556,0.06257333333333333,93600,3969,94322,completed
699,90614,442,1,0-2,1,0.04636702777777778,0.03830666666666667,94320,3706,94762,completed
700,90619,460,1,0-2,1,0.048255277777777786,0.03986666666666667,94320,3701,94780,completed
701,90662,67,1,0-2,1,0.00702848611111111,0.005806666666666667,94320,3658,94387,completed
703,90856,590,1,0-2,1,0.06189263888888889,0.051133333333333336,94320,3464,94910,completed
704,90966,542,1,0-2,1,0.05685730555555556,0.04697333333333333,94320,3354,94862,completed
705,91015,475,1,0-2,1,0.04982881944444445,0.041166666666666664,94320,3305,94795,completed
706,91063,1270,1,0-2,1,0.13407444444444444,0.11006666666666667,94320,3257,95590,completed
707,91145,833,1,0-2,1,0.08755822222222223,0.07219333333333333,94320,3175,95153,completed
708,91221,711,1,0-2,1,0.07458587500000001,0.06162,94320,3099,95031,completed
709,91223,668,1,0-2,1,0.07007505555555557,0.05789333333333333,94320,3097,94988,completed
617,79247,1523,1,2-6,1,0.18936281944444444,0.13199333333333332,95760,16513,97283,completed
623,81056,2643,4,2-6,3-4,2.1375098333333336,0.91624,95760,14704,98403,completed
625,81161,4649,1,6-12,1,1.439323152777778,0.40291333333333335,95760,14599,100409,completed
629,81691,5309,1,6-12,1,1.7505254166666666,0.4601133333333333,95760,14069,101069,completed
634,82122,10925,1,12-24,1,4.238040416666667,0.9468333333333333,95760,13638,106685,completed
636,82581,4259,1,6-12,1,1.2615684027777776,0.36911333333333335,95760,13179,100019,completed
638,82710,2590,3,2-6,3-4,1.543730416666667,0.6734,95760,13050,98350,completed
639,82755,2160,3,2-6,3-4,1.06179,0.5616,95760,13005,97920,completed
657,85563,9852,1,12-24,1,3.7758183333333335,0.85384,95760,10197,105612,completed
659,85675,1516,1,2-6,1,0.1875543888888889,0.13138666666666668,95760,10085,97276,completed
661,86070,2649,1,2-6,1,0.5366190416666667,0.22958,95760,9690,98409,completed
670,87136,2757,1,2-6,1,0.5769675416666668,0.23894,95760,8624,98517,completed
671,87193,17516,1,24-48,1,5.5953401666666664,1.5180533333333333,95760,8567,113276,completed
673,87262,12102,1,24-48,1,4.73810675,1.04884,95760,8498,107862,completed
676,87483,2160,1,2-6,1,0.35393,0.1872,95760,8277,97920,completed
677,87484,2027,1,2-6,1,0.3195698194444445,0.17567333333333335,95760,8276,97787,completed
690,88984,17236,1,24-48,1,5.570200722222222,1.4937866666666666,95760,6776,112996,completed
698,89770,1655,1,2-6,1,0.22346465277777777,0.14343333333333333,95760,5990,97415,completed
702,90818,1543,1,2-6,1,0.1945297638888889,0.13372666666666666,95760,4942,97303,completed
710,91877,70,1,0-2,1,0.006587777777777776,0.006066666666666666,95760,3883,95830,completed
711,91995,87,1,0-2,1,0.008187666666666664,0.00754,95760,3765,95847,completed
712,92117,1258,1,0-2,1,0.14260177777777777,0.10902666666666667,95760,3643,97018,completed
713,92120,627,1,0-2,1,0.05900766666666667,0.05434,95760,3640,96387,completed
714,92125,1196,1,0-2,1,0.1339768888888889,0.10365333333333333,95760,3635,96956,completed
715,92125,884,1,0-2,1,0.09057422222222224,0.07661333333333334,95760,3635,96644,completed
716,92137,1332,1,0-2,1,0.152896,0.11544,95760,3623,97092,completed
717,92143,450,1,0-2,1,0.042350000000000006,0.039,95760,3617,96210,completed
718,92355,459,1,0-2,1,0.043197000000000006,0.03978,95760,3405,96219,completed
719,92426,63,1,0-2,1,0.005928999999999998,0.0054600000000000004,95760,3334,95823,completed
720,92515,1432,1,0-2,1,0.1668071111111111,0.12410666666666667,95760,3245,97192,completed
721,92665,5915,1,12-24,1,2.056599513888889,0.5126333333333334,95760,3095,101675,completed
722,92822,1767,1,2-6,1,0.2523995416666667,0.15314,95760,2938,97527,completed
723,92867,188,1,0-2,1,0.017692888888888886,0.016293333333333333,95760,2893,95948,completed
724,92881,481,1,0-2,1,0.04526744444444446,0.04168666666666667,95760,2879,96241,completed
725,92944,5964,1,12-24,1,2.0824871666666667,0.51688,95760,2816,101724,completed
726,92990,3894,3,6-12,3-4,3.2746937499999995,1.01244,95760,2770,99654,completed
727,93062,119,1,0-2,1,0.011199222222222222,0.010313333333333334,95760,2698,95879,completed
728,93210,987,1,0-2,1,0.10490266666666667,0.08554,95760,2550,96747,completed
729,93257,9715,1,12-24,1,3.7279634722222226,0.8419666666666666,95760,2503,105475,completed
730,93606,79,1,0-2,1,0.007434777777777775,0.006846666666666667,95760,2154,95839,completed
731,93699,2446,1,2-6,1,0.46077880555555556,0.21198666666666666,95760,2061,98206,completed
732,93778,879,1,0-2,1,0.08987866666666666,0.07618,95760,1982,96639,completed
733,93815,1628,1,2-6,1,0.2164892777777778,0.14109333333333335,95760,1945,97388,completed
734,93825,1369,1,0-2,1,0.1580431111111111,0.11864666666666666,95760,1935,97129,completed
735,93850,1584,1,2-6,1,0.20512200000000003,0.13728,95760,1910,97344,completed
736,94023,88,1,0-2,1,0.008281777777777777,0.007626666666666667,95760,1737,95848,completed
737,94276,626,1,0-2,1,0.05891355555555555,0.054253333333333334,95760,1484,96386,completed
738,94296,93,1,0-2,1,0.00875233333333333,0.00806,95760,1464,95853,completed
739,94301,2072,1,2-6,1,0.3311954444444445,0.17957333333333333,95760,1459,97832,completed
742,94690,1322,1,0-2,1,0.1515048888888889,0.11457333333333333,95760,1070,97082,completed
743,94742,67,1,0-2,1,0.006305444444444443,0.005806666666666667,95760,1018,95827,completed
747,94835,1126,1,0-2,1,0.12423911111111112,0.09758666666666667,95760,925,96886,completed
748,94838,1175,1,0-2,1,0.13105555555555556,0.10183333333333333,95760,922,96935,completed
749,94871,518,1,0-2,1,0.04874955555555556,0.044893333333333334,95760,889,96278,completed
751,95429,223,1,0-2,1,0.020986777777777778,0.019326666666666666,95760,331,95983,completed
752,95476,473,1,0-2,1,0.044514555555555564,0.04099333333333333,95760,284,96233,completed
753,95513,936,3,0-2,3-4,0.293424,0.24336,95760,247,96696,completed
755,95692,533,1,0-2,1,0.05016122222222223,0.046193333333333336,95760,68,96293,completed
756,95736,242,1,0-2,1,0.022774888888888893,0.020973333333333333,95760,24,96002,completed
757,95816,181,1,0-2,1,0.017034111111111108,0.015686666666666668,95816,0,95997,completed
758,96075,608,1,0-2,1,0.06635455555555556,0.052693333333333335,96075,0,96683,completed
759,96145,118,1,0-2,1,0.01110511111111111,0.010226666666666667,96145,0,96263,completed
760,96189,64,1,0-2,1,0.006023111111111111,0.005546666666666667,96189,0,96253,completed
761,96223,545,1,0-2,1,0.06425055555555556,0.047233333333333336,96223,0,96768,completed
763,96346,73,1,0-2,1,0.006870111111111111,0.006326666666666667,96346,0,96419,completed
764,96546,64,1,0-2,1,0.008903111111111112,0.005546666666666667,96546,0,96610,completed
765,96596,1230,1,0-2,1,0.24574847222222226,0.1066,96596,0,97826,completed
766,96612,1123,1,0-2,1,0.22001309722222226,0.09732666666666667,96612,0,97735,completed
767,96624,696,1,0-2,1,0.11112966666666668,0.06032,96624,0,97320,completed
768,96632,1284,1,0-2,1,0.2639917222222223,0.11128,96632,0,97916,completed
770,96649,436,1,0-2,1,0.060652444444444446,0.03778666666666667,96649,0,97085,completed
769,96649,443,1,0-2,1,0.06162622222222222,0.038393333333333335,96649,0,97092,completed
771,96779,97,1,0-2,1,0.013493777777777778,0.008406666666666666,96779,0,96876,completed
772,96901,164,1,0-2,1,0.022814222222222222,0.014213333333333333,96901,0,97065,completed
774,97046,1052,1,0-2,1,0.2739334166666667,0.09117333333333333,97046,0,98098,completed
775,97271,313,2,0-2,2,0.16172536111111113,0.054253333333333334,97271,0,97584,completed
776,97317,1032,1,0-2,1,0.31605658333333336,0.08944,97317,0,98349,completed
778,97345,499,1,0-2,1,0.1289152638888889,0.04324666666666667,97345,0,97844,completed
779,97345,740,1,0-2,1,0.21019319444444445,0.06413333333333333,97345,0,98085,completed
777,97345,937,1,0-2,1,0.2837918472222223,0.08120666666666666,97345,0,98282,completed
780,97369,986,1,0-2,1,0.3048641111111111,0.08545333333333334,97369,0,98355,completed
781,97407,963,1,0-2,1,0.30065087500000004,0.08346,97407,0,98370,completed
782,97443,476,1,0-2,1,0.1229732777777778,0.041253333333333336,97443,0,97919,completed
783,97512,748,1,0-2,1,0.23242872222222227,0.06482666666666667,97512,0,98260,completed
784,97626,444,1,0-2,1,0.13199366666666668,0.03848,97626,0,98070,completed
785,97627,274,1,0-2,1,0.0707871388888889,0.023746666666666666,97627,0,97901,completed
786,97812,817,1,0-2,1,0.29278193055555557,0.07080666666666667,97812,0,98629,completed
787,97992,735,1,0-2,1,0.28217262499999995,0.0637,97992,0,98727,completed
788,98475,304,1,0-2,1,0.125682,0.026346666666666668,98475,0,98779,completed
789,98476,265,1,0-2,1,0.10780148611111111,0.022966666666666666,98476,0,98741,completed
790,98581,114,1,0-2,1,0.04738119444444443,0.00988,98581,0,98695,completed
791,98597,306,1,0-2,1,0.13723097222222222,0.026520000000000002,98597,0,98903,completed
792,98762,1178,1,0-2,1,0.5204210277777779,0.10209333333333334,102960,4198,104138,completed
793,98763,73,1,0-2,1,0.032827694444444444,0.006326666666666667,102960,4197,103033,completed
794,99005,64,1,0-2,1,0.028780444444444442,0.005546666666666667,102960,3955,103024,completed
795,99024,265,1,0-2,1,0.11916902777777777,0.022966666666666666,102960,3936,103225,completed
797,99205,74,1,0-2,1,0.03327738888888889,0.006413333333333333,102960,3755,103034,completed
796,99205,105,1,0-2,1,0.047217916666666665,0.0091,102960,3755,103065,completed
799,99269,374,1,0-2,1,0.16818572222222222,0.032413333333333336,102960,3691,103334,completed
798,99269,143,1,0-2,1,0.06430630555555557,0.012393333333333334,102960,3691,103103,completed
800,99535,275,4,0-2,3-4,0.4722819444444446,0.09533333333333334,103680,4145,103955,completed
801,99612,132,1,0-2,1,0.056673833333333354,0.01144,103680,4068,103812,completed
803,99779,1078,1,0-2,1,0.4362299444444446,0.09342666666666667,103680,3901,104758,completed
807,99886,288,1,0-2,1,0.12365200000000004,0.02496,103680,3794,103968,completed
806,99886,288,1,0-2,1,0.12365200000000004,0.02496,103680,3794,103968,completed
808,100315,167,1,0-2,1,0.0592896388888889,0.014473333333333333,104400,4085,104567,completed
811,100695,77,1,0-2,1,0.02733713888888889,0.006673333333333333,104400,3705,104477,completed
812,100875,84,1,0-2,1,0.029341666666666655,0.00728,105120,4245,105204,completed
813,100964,63,1,0-2,1,0.022006249999999988,0.0054600000000000004,105120,4156,105183,completed
815,101325,74,1,0-2,1,0.025848611111111103,0.006413333333333333,105120,3795,105194,completed
817,101670,581,3,0-2,3-4,0.6088395833333331,0.15106,105120,3450,105701,completed
819,102027,150,3,0-2,3-4,0.15718749999999995,0.039,105120,3093,105270,completed
820,102501,72,1,0-2,1,0.025149999999999995,0.00624,105120,2619,105192,completed
821,102511,200,1,0-2,1,0.0698611111111111,0.017333333333333333,105120,2609,105320,completed
824,102800,250,1,0-2,1,0.08732638888888888,0.021666666666666667,105120,2320,105370,completed
825,102857,87,1,0-2,1,0.030389583333333317,0.00754,105120,2263,105207,completed
826,102886,518,1,0-2,1,0.18094027777777777,0.044893333333333334,105120,2234,105638,completed
828,102945,401,1,0-2,1,0.14007152777777776,0.03475333333333333,105120,2175,105521,completed
833,103403,593,1,0-2,1,0.2071381944444444,0.05139333333333333,105120,1717,105713,completed
834,103502,682,1,0-2,1,0.23822638888888886,0.05910666666666667,105120,1618,105802,completed
835,103631,411,2,0-2,2,0.2871291666666666,0.07124,105120,1489,105531,completed
836,103685,642,1,0-2,1,0.19714749999999998,0.05564,108000,4315,108642,completed
837,103788,230,2,0-2,2,0.14125833333333332,0.03986666666666667,108000,4212,108230,completed
838,103830,123,1,0-2,1,0.03777125,0.01066,108000,4170,108123,completed
839,103934,922,1,0-2,1,0.26820527777777775,0.07990666666666667,108000,4066,108922,completed
840,103982,312,3,0-2,3-4,0.28742999999999996,0.08112,108000,4018,108312,completed
841,104065,99,1,0-2,1,0.030401249999999994,0.00858,108000,3935,108099,completed
842,104071,1378,2,0-2,2,0.7490838888888888,0.23885333333333333,108000,3929,109378,completed
847,104723,698,1,0-2,1,0.1627697222222222,0.060493333333333336,108720,3997,109418,completed
850,104872,77,1,0-2,1,0.017955972222222227,0.006673333333333333,108720,3848,108797,completed
851,105263,402,1,0-2,1,0.06293533333333334,0.03484,109440,4177,109842,completed
852,105263,402,1,0-2,1,0.06293533333333334,0.03484,109440,4177,109842,completed
853,105454,65,1,0-2,1,0.010176111111111113,0.005633333333333333,109440,3986,109505,completed
854,105528,602,2,0-2,2,0.18849288888888893,0.10434666666666667,109440,3912,110042,completed
855,105541,797,2,0-2,2,0.2434259166666667,0.13814666666666667,109440,3899,110237,completed
856,105673,104,1,0-2,1,0.01628177777777778,0.009013333333333333,109440,3767,109544,completed
857,105850,85,1,0-2,1,0.009927291666666664,0.007366666666666667,110160,4310,110245,completed
858,105999,398,1,0-2,1,0.04648308333333334,0.034493333333333334,110160,4161,110558,completed
859,106059,278,1,0-2,1,0.03246808333333333,0.024093333333333335,110160,4101,110438,completed
860,106185,90,1,0-2,1,0.01051125,0.0078000000000000005,110160,3975,110250,completed
861,106198,117,1,0-2,1,0.013664625,0.01014,110160,3962,110277,completed
863,106299,1215,1,0-2,1,0.131080625,0.1053,110160,3861,111375,completed
864,106369,997,1,0-2,1,0.1103857638888889,0.08640666666666667,110160,3791,111157,completed
865,106375,541,1,0-2,1,0.06318429166666666,0.04688666666666667,110160,3785,110701,completed
866,106481,1161,1,0-2,1,0.125954375,0.10062,110160,3679,111321,completed
867,106504,94,1,0-2,1,0.010978416666666664,0.008146666666666667,110160,3656,110254,completed
868,106720,77,1,0-2,1,0.007309652777777778,0.006673333333333333,110880,4160,110957,completed
869,106809,1064,1,0-2,1,0.10024166666666667,0.09221333333333334,110880,4071,111944,completed
870,106964,102,1,0-2,1,0.00968291666666666,0.00884,110880,3916,110982,completed
871,107138,64,1,0-2,1,0.006075555555555555,0.005546666666666667,110880,3742,110944,completed
740,94320,1986,1,2-6,1,0.17983725,0.17212,111600,17280,113586,completed
741,94527,2914,1,6-12,1,0.2701233888888889,0.2525466666666667,111600,17073,114514,completed
744,94782,2393,1,2-6,1,0.21854405555555556,0.20739333333333335,111600,16818,113993,completed
745,94791,1603,1,2-6,1,0.14538320833333332,0.13892666666666667,111600,16809,113203,completed
746,94826,1834,1,2-6,1,0.1661635833333333,0.15894666666666668,111600,16774,113434,completed
872,107321,479,1,0-2,1,0.04440729166666667,0.04151333333333333,111600,4279,112079,completed
873,107500,119,1,0-2,1,0.011032291666666668,0.010313333333333334,111600,4100,111719,completed
875,107627,201,1,0-2,1,0.018634375,0.01742,111600,3973,111801,completed
876,107651,708,1,0-2,1,0.0656375,0.06136,111600,3949,112308,completed
877,107933,703,1,0-2,1,0.06517395833333334,0.06092666666666667,111600,3667,112303,completed
878,107947,450,1,0-2,1,0.04171875,0.039,111600,3653,112050,completed
879,107963,784,1,0-2,1,0.07243622222222222,0.06794666666666667,111600,3637,112384,completed
750,95088,2842,1,2-6,1,0.2680473888888889,0.24630666666666667,112320,17232,115162,completed
754,95684,3830,1,6-12,1,0.4069069444444444,0.33193333333333336,112320,16636,116150,completed
762,96333,1542,1,2-6,1,0.13883233333333334,0.13364,112320,15987,113862,completed
773,96962,7784,1,12-24,1,0.9265876666666666,0.6746133333333334,112320,15358,120104,completed
802,99736,3345,1,6-12,1,0.33372375,0.2899,112320,12584,115665,completed
804,99871,2133,1,2-6,1,0.1973085,0.18486,112320,12449,114453,completed
805,99879,11989,1,24-48,1,1.1521064305555555,1.0390466666666667,112320,12441,124309,completed
809,100423,3848,3,6-12,3-4,1.2299353333333332,1.00048,112320,11897,116168,completed
810,100455,1951,3,2-6,3-4,0.5379018333333334,0.50726,112320,11865,114271,completed
814,101263,2033,1,2-6,1,0.18741405555555557,0.17619333333333334,112320,11057,114353,completed
816,101398,1705,1,2-6,1,0.15496027777777777,0.14776666666666666,112320,10922,114025,completed
818,101850,2230,1,2-6,1,0.2069663888888889,0.19326666666666667,112320,10470,114550,completed
822,102513,7578,2,12-24,2,1.8102415,1.31352,112320,9807,119898,completed
823,102651,1877,1,2-6,1,0.1719787222222222,0.16267333333333334,112320,9669,114197,completed
827,102904,9634,1,12-24,1,1.0283952777777776,0.8349466666666667,112320,9416,121954,completed
880,108094,369,1,0-2,1,0.032784625000000005,0.03198,112320,4226,112689,completed
881,108133,1275,2,0-2,2,0.22779375000000002,0.221,112320,4187,113595,completed
882,108157,75,1,0-2,1,0.006663541666666667,0.0065,112320,4163,112395,completed
883,108172,290,1,0-2,1,0.025765694444444445,0.025133333333333334,112320,4148,112610,completed
884,108215,95,1,0-2,1,0.008440486111111116,0.008233333333333334,112320,4105,112415,completed
885,108216,204,1,0-2,1,0.018124833333333333,0.01768,112320,4104,112524,completed
886,108220,264,1,0-2,1,0.023455666666666666,0.02288,112320,4100,112584,completed
887,108250,1234,2,0-2,2,0.2204171666666667,0.21389333333333332,112320,4070,113554,completed
888,108320,75,1,0-2,1,0.006663541666666667,0.0065,112320,4000,112395,completed
889,108373,1398,1,0-2,1,0.12496175000000001,0.12116,112320,3947,113718,completed
890,108435,742,1,0-2,1,0.06594908333333334,0.06430666666666666,112320,3885,113062,completed
891,108648,456,1,0-2,1,0.040514333333333326,0.03952,112320,3672,112776,completed
892,108706,1418,1,0-2,1,0.12676091666666667,0.12289333333333334,112320,3614,113738,completed
893,108817,136,1,0-2,1,0.012083222222222224,0.011786666666666668,112320,3503,112456,completed
894,108931,427,1,0-2,1,0.03793776388888889,0.03700666666666667,112320,3389,112747,completed
895,108946,299,1,0-2,1,0.026565319444444447,0.025913333333333333,112320,3374,112619,completed
896,108951,562,1,0-2,1,0.049932138888888894,0.04870666666666667,112320,3369,112882,completed
899,108952,814,1,0-2,1,0.07242608333333332,0.07054666666666667,112320,3368,113134,completed
897,108952,962,1,0-2,1,0.08573991666666667,0.08337333333333334,112320,3368,113282,completed
898,108952,499,1,0-2,1,0.044334763888888885,0.04324666666666667,112320,3368,112819,completed
900,109011,526,1,0-2,1,0.04673363888888888,0.045586666666666664,112320,3309,112846,completed
901,109016,586,1,0-2,1,0.05206447222222223,0.05078666666666667,112320,3304,112906,completed
902,109119,91,1,0-2,1,0.008085097222222224,0.007886666666666667,112320,3201,112411,completed
903,109316,1186,1,0-2,1,0.10589058333333334,0.10278666666666667,112320,3004,113506,completed
904,109316,79,1,0-2,1,0.007018930555555554,0.006846666666666667,112320,3004,112399,completed
906,109456,468,1,0-2,1,0.04158049999999999,0.04056,112320,2864,112788,completed
907,109519,74,1,0-2,1,0.006574694444444445,0.006413333333333333,112320,2801,112394,completed
909,109651,78,1,0-2,1,0.006930083333333332,0.00676,112320,2669,112398,completed
910,109655,66,1,0-2,1,0.005863916666666667,0.00572,112320,2665,112386,completed
911,109655,86,1,0-2,1,0.00764086111111111,0.0074533333333333335,112320,2665,112406,completed
913,109785,927,1,0-2,1,0.082591375,0.08034,112320,2535,113247,completed
914,109861,88,1,0-2,1,0.007818555555555556,0.007626666666666667,112320,2459,112408,completed
915,109862,278,1,0-2,1,0.02469952777777778,0.024093333333333335,112320,2458,112598,completed
916,109884,87,1,0-2,1,0.007729708333333332,0.00754,112320,2436,112407,completed
917,109965,505,1,0-2,1,0.044867847222222215,0.04376666666666667,112320,2355,112825,completed
919,110105,100,1,0-2,1,0.008884722222222224,0.008666666666666666,112320,2215,112420,completed
920,110182,83,1,0-2,1,0.007374319444444445,0.007193333333333334,112320,2138,112403,completed
921,110362,183,1,0-2,1,0.01625904166666667,0.01586,112320,1958,112503,completed
923,110601,105,1,0-2,1,0.009328958333333333,0.0091,112320,1719,112425,completed
924,110703,72,1,0-2,1,0.006397000000000001,0.00624,112320,1617,112392,completed
925,111374,402,1,0-2,1,0.03571658333333333,0.03484,112320,946,112722,completed
928,112349,550,1,0-2,1,0.04886597222222223,0.04766666666666667,112349,0,112899,completed
929,112639,1270,3,0-2,3-4,0.34542137500000003,0.3302,112639,0,113909,completed
930,112696,1214,3,0-2,3-4,0.33052533333333334,0.31564000000000003,112696,0,113910,completed
931,112702,1114,3,0-2,3-4,0.30102375000000003,0.28964,112702,0,113816,completed
933,112811,720,1,0-2,1,0.06451555555555556,0.062400000000000004,112811,0,113531,completed
935,112900,116,1,0-2,1,0.010306277777777779,0.010053333333333334,112900,0,113016,completed
936,113017,70,4,0-2,3-4,0.025086111111111115,0.024266666666666666,113017,0,113087,completed
937,113040,148,2,0-2,2,0.026627666666666668,0.025653333333333334,113040,0,113188,completed
938,113060,103,1,0-2,1,0.009265708333333329,0.008926666666666666,113060,0,113163,completed
939,113238,83,1,0-2,1,0.007466541666666667,0.007193333333333334,113238,0,113321,completed
940,113302,958,1,0-2,1,0.09067313888888891,0.08302666666666667,113302,0,114260,completed
941,113340,102,1,0-2,1,0.009175749999999996,0.00884,113340,0,113442,completed
942,113354,165,1,0-2,1,0.014843125000000002,0.0143,113354,0,113519,completed
943,113357,320,1,0-2,1,0.02878666666666667,0.027733333333333332,113357,0,113677,completed
944,113364,850,1,0-2,1,0.08054427777777778,0.07366666666666667,113364,0,114214,completed
946,113465,826,1,0-2,1,0.07907720833333334,0.07158666666666667,113465,0,114291,completed
945,113465,754,1,0-2,1,0.07195320833333334,0.06534666666666666,113465,0,114219,completed
947,113514,81,1,0-2,1,0.007286625000000001,0.00702,113514,0,113595,completed
948,113564,877,1,0-2,1,0.085013,0.07600666666666667,113564,0,114441,completed
949,113700,451,1,0-2,1,0.04408477777777778,0.039086666666666665,113700,0,114151,completed
950,113809,235,1,0-2,1,0.02325194444444445,0.02036666666666667,113809,0,114044,completed
951,114110,479,1,0-2,1,0.04748825,0.04151333333333333,114110,0,114589,completed
952,114424,1265,1,0-2,1,0.1424786388888889,0.10963333333333333,114424,0,115689,completed
954,114786,108,1,0-2,1,0.010778999999999999,0.00936,114786,0,114894,completed
955,114816,210,1,0-2,1,0.02095916666666666,0.0182,114816,0,115026,completed
956,115124,605,1,0-2,1,0.07798630555555555,0.05243333333333333,115124,0,115729,completed
829,103379,3038,1,6-12,1,0.15888386111111108,0.2632933333333333,120240,16861,123278,completed
830,103380,4649,1,6-12,1,0.24222956944444446,0.40291333333333335,120240,16860,124889,completed
832,103381,4792,1,6-12,1,0.25009655555555554,0.41530666666666666,120240,16859,125032,completed
831,103381,4862,1,6-12,1,0.25394752777777774,0.4213733333333333,120240,16859,125102,completed
843,104279,4580,2,6-12,2,0.4768672222222222,0.7938666666666667,120240,15961,124820,completed
844,104413,4683,1,6-12,1,0.24410004166666668,0.40586,120240,15827,124923,completed
845,104607,1694,1,2-6,1,0.08657138888888889,0.14681333333333332,120240,15633,121934,completed
846,104607,1538,1,2-6,1,0.07827305555555555,0.13329333333333335,120240,15633,121778,completed
848,104727,3812,1,6-12,1,0.19825727777777777,0.33037333333333335,120240,15513,124052,completed
849,104793,9929,1,12-24,1,0.5534533333333334,0.8605133333333334,120240,15447,130169,completed
862,106229,9481,1,12-24,1,0.5235866666666666,0.8216866666666667,120240,14011,129721,completed
874,107593,2632,2,2-6,2,0.2744957777777777,0.45621333333333336,120240,12647,122872,completed
905,109421,28542,1,24-48,1,1.8595220833333332,2.47364,120240,10819,148782,completed
908,109597,3814,1,6-12,1,0.1983591388888889,0.33054666666666666,120240,10643,124054,completed
912,109740,1933,1,2-6,1,0.09928486111111112,0.16752666666666666,120240,10500,122173,completed
918,109971,6135,3,12-24,3-4,0.9765193750000001,1.5951,120240,10269,126375,completed
922,110491,1462,1,2-6,1,0.07423027777777778,0.12670666666666666,120240,9749,121702,completed
926,111690,1963,1,2-6,1,0.10088069444444446,0.17012666666666668,120240,8550,122203,completed
927,111967,3919,2,6-12,2,0.4074136944444445,0.6792933333333333,120240,8273,124159,completed
932,112707,2483,1,2-6,1,0.12907565277777777,0.21519333333333335,120240,7533,122723,completed
934,112813,10423,1,12-24,1,0.5860293750000001,0.9033266666666667,120240,7427,130663,completed
953,114680,4967,1,6-12,1,0.2597239861111111,0.4304733333333333,120240,5560,125207,completed
958,115594,3997,1,6-12,1,0.20767943055555554,0.3464066666666667,120240,4646,124237,completed
957,115594,3865,1,6-12,1,0.20095659722222223,0.3349666666666667,120240,4646,124105,completed
959,115742,5054,1,6-12,1,0.2645416944444444,0.43801333333333337,120240,4498,125294,completed
960,116147,3921,2,6-12,2,0.4076174166666667,0.67964,120240,4093,124161,completed
961,116179,107,1,0-2,1,0.005320277777777778,0.009273333333333333,120240,4061,120347,completed
962,116366,422,1,0-2,1,0.02098277777777778,0.03657333333333333,120240,3874,120662,completed
963,116384,504,1,0-2,1,0.02506000000000001,0.043680000000000004,120240,3856,120744,completed
964,116389,860,1,0-2,1,0.043045000000000014,0.07453333333333334,120240,3851,121100,completed
965,116391,166,1,0-2,1,0.008253888888888887,0.014386666666666667,120240,3849,120406,completed
966,116396,529,1,0-2,1,0.02630305555555556,0.04584666666666667,120240,3844,120769,completed
967,116425,3654,1,6-12,1,0.19021025000000003,0.31668,120240,3815,123894,completed
968,116852,77,1,0-2,1,0.003828611111111111,0.006673333333333333,120240,3388,120317,completed
969,116940,82,1,0-2,1,0.004077222222222222,0.0071066666666666665,120240,3300,120322,completed
970,117908,197,4,0-2,3-4,0.03918111111111111,0.06829333333333333,120240,2332,120437,completed
971,118075,3567,1,6-12,1,0.18578204166666665,0.30914,120240,2165,123807,completed
972,118415,524,3,0-2,3-4,0.07816333333333335,0.13624,120240,1825,120764,completed
973,118433,4988,1,6-12,1,0.26087927777777775,0.43229333333333336,120240,1807,125228,completed
974,118440,4831,1,6-12,1,0.25224209722222224,0.41868666666666665,120240,1800,125071,completed
975,118737,60,1,0-2,1,0.0029833333333333335,0.0052,120240,1503,120300,completed
976,119044,492,1,0-2,1,0.02446333333333334,0.04264,120240,1196,120732,completed
977,119133,1301,1,0-2,1,0.06586675,0.11275333333333333,120240,1107,121541,completed
978,119139,19842,2,24-48,2,2.3796228333333334,3.43928,120240,1101,140082,completed
979,119140,19848,2,24-48,2,2.3802446666666666,3.4403200000000003,120240,1100,140088,completed
980,119164,1395,1,0-2,1,0.07073125000000001,0.12090000000000001,120240,1076,121635,completed
981,119416,800,1,0-2,1,0.03994000000000001,0.06933333333333333,120240,824,121040,completed
982,119581,439,1,0-2,1,0.02182805555555556,0.038046666666666666,120240,659,120679,completed
983,119818,1083,1,0-2,1,0.05458525,0.09386,120240,422,121323,completed
984,119826,435,1,0-2,1,0.02162916666666667,0.0377,120240,414,120675,completed
985,119964,7669,1,12-24,1,0.4122543055555556,0.6646466666666667,120240,276,127909,completed
986,119977,90,1,0-2,1,0.004475,0.0078000000000000005,120240,263,120330,completed
987,120082,406,1,0-2,1,0.020187222222222224,0.035186666666666665,120240,158,120646,completed
988,120092,80,1,0-2,1,0.003977777777777778,0.006933333333333333,120240,148,120320,completed
989,120141,428,1,0-2,1,0.021281111111111115,0.03709333333333333,120240,99,120668,completed
990,120214,1767,1,2-6,1,0.09045458333333334,0.15314,120240,26,122007,completed
991,120215,1337,1,0-2,1,0.06772975,0.11587333333333334,120240,25,121577,completed
992,120215,1221,1,0-2,1,0.06172675,0.10582,120240,25,121461,completed
993,120305,98,1,0-2,1,0.004872777777777778,0.008493333333333334,120305,0,120403,completed
994,120358,97,1,0-2,1,0.004823055555555556,0.008406666666666666,120358,0,120455,completed
995,120458,63,1,0-2,1,0.0031325000000000003,0.0054600000000000004,120458,0,120521,completed
996,120649,227,1,0-2,1,0.011286944444444447,0.019673333333333334,120649,0,120876,completed
997,120665,67,1,0-2,1,0.003331388888888889,0.005806666666666667,120665,0,120732,completed
998,120678,132,1,0-2,1,0.006563333333333333,0.01144,120678,0,120810,completed
999,120951,272,1,0-2,1,0.014057749999999999,0.023573333333333335,120951,0,121223,completed
-1,0,0,0,0,0,0.0,0.0,0,0,0,0
